,date,name_en,deaths,cases,cumsum,color
0,2020-03-03,Andorra,0,1,1,"rgb(102, 197, 204)"
1,2020-03-14,Andorra,0,1,2,"rgb(102, 197, 204)"
2,2020-03-16,Andorra,0,3,5,"rgb(102, 197, 204)"
3,2020-03-17,Andorra,0,9,14,"rgb(102, 197, 204)"
4,2020-03-18,Andorra,0,0,14,"rgb(102, 197, 204)"
5,2020-03-19,Andorra,0,39,53,"rgb(102, 197, 204)"
6,2020-03-20,Andorra,0,22,75,"rgb(102, 197, 204)"
7,2020-03-21,Andorra,0,0,75,"rgb(102, 197, 204)"
8,2020-03-22,Andorra,0,13,88,"rgb(102, 197, 204)"
9,2020-03-23,Andorra,0,25,113,"rgb(102, 197, 204)"
10,2020-03-24,Andorra,0,20,133,"rgb(102, 197, 204)"
11,2020-03-25,Andorra,0,31,164,"rgb(102, 197, 204)"
12,2020-03-26,Andorra,0,24,188,"rgb(102, 197, 204)"
13,2020-03-27,Andorra,3,36,224,"rgb(102, 197, 204)"
14,2020-03-28,Andorra,0,43,267,"rgb(102, 197, 204)"
15,2020-03-29,Andorra,1,41,308,"rgb(102, 197, 204)"
16,2020-03-30,Andorra,2,26,334,"rgb(102, 197, 204)"
17,2020-03-31,Andorra,2,36,370,"rgb(102, 197, 204)"
18,2020-04-01,Andorra,4,6,376,"rgb(102, 197, 204)"
19,2020-04-02,Andorra,2,14,390,"rgb(102, 197, 204)"
20,2020-04-03,Andorra,1,38,428,"rgb(102, 197, 204)"
21,2020-04-04,Andorra,1,11,439,"rgb(102, 197, 204)"
22,2020-04-05,Andorra,1,27,466,"rgb(102, 197, 204)"
23,2020-04-06,Andorra,1,35,501,"rgb(102, 197, 204)"
24,2020-04-07,Andorra,3,25,526,"rgb(102, 197, 204)"
25,2020-04-08,Andorra,1,19,545,"rgb(102, 197, 204)"
26,2020-04-09,Andorra,1,19,564,"rgb(102, 197, 204)"
27,2020-04-10,Andorra,2,19,583,"rgb(102, 197, 204)"
28,2020-04-11,Andorra,1,18,601,"rgb(102, 197, 204)"
29,2020-04-12,Andorra,2,21,622,"rgb(102, 197, 204)"
30,2020-04-13,Andorra,1,16,638,"rgb(102, 197, 204)"
31,2020-04-14,Andorra,0,8,646,"rgb(102, 197, 204)"
32,2020-04-15,Andorra,2,13,659,"rgb(102, 197, 204)"
33,2020-04-16,Andorra,2,14,673,"rgb(102, 197, 204)"
34,2020-04-17,Andorra,0,9,682,"rgb(102, 197, 204)"
35,2020-04-18,Andorra,2,14,696,"rgb(102, 197, 204)"
36,2020-04-19,Andorra,0,8,704,"rgb(102, 197, 204)"
37,2020-04-20,Andorra,1,9,713,"rgb(102, 197, 204)"
38,2020-04-21,Andorra,0,4,717,"rgb(102, 197, 204)"
39,2020-04-22,Andorra,1,0,717,"rgb(102, 197, 204)"
40,2020-04-23,Andorra,0,6,723,"rgb(102, 197, 204)"
41,2020-04-24,Andorra,0,1,724,"rgb(102, 197, 204)"
42,2020-04-25,Andorra,3,7,731,"rgb(102, 197, 204)"
43,2020-04-26,Andorra,0,2,733,"rgb(102, 197, 204)"
44,2020-04-27,Andorra,0,7,740,"rgb(102, 197, 204)"
45,2020-04-28,Andorra,0,3,743,"rgb(102, 197, 204)"
46,2020-04-29,Andorra,1,0,743,"rgb(102, 197, 204)"
47,2020-04-30,Andorra,1,0,743,"rgb(102, 197, 204)"
48,2020-05-01,Andorra,0,2,745,"rgb(102, 197, 204)"
49,2020-05-02,Andorra,1,1,746,"rgb(102, 197, 204)"
50,2020-05-03,Andorra,1,1,747,"rgb(102, 197, 204)"
51,2020-05-04,Andorra,1,1,748,"rgb(102, 197, 204)"
52,2020-05-05,Andorra,0,2,750,"rgb(102, 197, 204)"
53,2020-05-06,Andorra,1,1,751,"rgb(102, 197, 204)"
54,2020-05-07,Andorra,0,0,751,"rgb(102, 197, 204)"
55,2020-05-08,Andorra,1,1,752,"rgb(102, 197, 204)"
56,2020-05-09,Andorra,0,0,752,"rgb(102, 197, 204)"
57,2020-05-10,Andorra,1,2,754,"rgb(102, 197, 204)"
58,2020-05-11,Andorra,0,1,755,"rgb(102, 197, 204)"
59,2020-05-12,Andorra,0,1,756,"rgb(102, 197, 204)"
60,2020-05-13,Andorra,0,2,758,"rgb(102, 197, 204)"
61,2020-05-14,Andorra,1,2,760,"rgb(102, 197, 204)"
62,2020-05-15,Andorra,0,1,761,"rgb(102, 197, 204)"
63,2020-05-16,Andorra,0,0,761,"rgb(102, 197, 204)"
64,2020-05-17,Andorra,2,0,761,"rgb(102, 197, 204)"
65,2020-05-18,Andorra,0,0,761,"rgb(102, 197, 204)"
66,2020-05-19,Andorra,0,0,761,"rgb(102, 197, 204)"
67,2020-05-20,Andorra,0,0,761,"rgb(102, 197, 204)"
68,2020-05-21,Andorra,0,1,762,"rgb(102, 197, 204)"
69,2020-05-22,Andorra,0,0,762,"rgb(102, 197, 204)"
70,2020-05-23,Andorra,0,0,762,"rgb(102, 197, 204)"
71,2020-05-24,Andorra,0,0,762,"rgb(102, 197, 204)"
72,2020-05-25,Andorra,0,1,763,"rgb(102, 197, 204)"
73,2020-05-26,Andorra,0,0,763,"rgb(102, 197, 204)"
74,2020-05-27,Andorra,0,0,763,"rgb(102, 197, 204)"
75,2020-05-28,Andorra,0,0,763,"rgb(102, 197, 204)"
76,2020-05-29,Andorra,0,0,763,"rgb(102, 197, 204)"
77,2020-05-30,Andorra,0,1,764,"rgb(102, 197, 204)"
78,2020-05-31,Andorra,0,0,764,"rgb(102, 197, 204)"
79,2020-06-01,Andorra,0,0,764,"rgb(102, 197, 204)"
80,2020-06-02,Andorra,0,1,765,"rgb(102, 197, 204)"
81,2020-06-03,Andorra,0,79,844,"rgb(102, 197, 204)"
82,2020-06-04,Andorra,0,7,851,"rgb(102, 197, 204)"
83,2020-06-05,Andorra,0,1,852,"rgb(102, 197, 204)"
84,2020-06-06,Andorra,0,0,852,"rgb(102, 197, 204)"
85,2020-06-07,Andorra,0,0,852,"rgb(102, 197, 204)"
86,2020-06-08,Andorra,0,0,852,"rgb(102, 197, 204)"
87,2020-06-09,Andorra,0,0,852,"rgb(102, 197, 204)"
88,2020-06-10,Andorra,0,0,852,"rgb(102, 197, 204)"
89,2020-06-11,Andorra,0,0,852,"rgb(102, 197, 204)"
90,2020-06-12,Andorra,0,0,852,"rgb(102, 197, 204)"
91,2020-06-13,Andorra,0,1,853,"rgb(102, 197, 204)"
92,2020-06-14,Andorra,0,0,853,"rgb(102, 197, 204)"
93,2020-06-15,Andorra,0,0,853,"rgb(102, 197, 204)"
94,2020-06-16,Andorra,0,0,853,"rgb(102, 197, 204)"
95,2020-06-17,Andorra,1,1,854,"rgb(102, 197, 204)"
96,2020-06-18,Andorra,0,0,854,"rgb(102, 197, 204)"
97,2020-06-19,Andorra,0,1,855,"rgb(102, 197, 204)"
98,2020-06-20,Andorra,0,0,855,"rgb(102, 197, 204)"
99,2020-06-21,Andorra,0,0,855,"rgb(102, 197, 204)"
100,2020-06-22,Andorra,0,0,855,"rgb(102, 197, 204)"
101,2020-06-23,Andorra,0,0,855,"rgb(102, 197, 204)"
102,2020-06-24,Andorra,0,0,855,"rgb(102, 197, 204)"
103,2020-06-25,Andorra,0,0,855,"rgb(102, 197, 204)"
104,2020-06-26,Andorra,0,0,855,"rgb(102, 197, 204)"
105,2020-06-27,Andorra,0,0,855,"rgb(102, 197, 204)"
106,2020-06-28,Andorra,0,0,855,"rgb(102, 197, 204)"
107,2020-06-29,Andorra,0,0,855,"rgb(102, 197, 204)"
108,2020-06-30,Andorra,0,0,855,"rgb(102, 197, 204)"
109,2020-07-01,Andorra,0,0,855,"rgb(102, 197, 204)"
110,2020-07-02,Andorra,0,0,855,"rgb(102, 197, 204)"
111,2020-07-03,Andorra,0,0,855,"rgb(102, 197, 204)"
112,2020-07-04,Andorra,0,0,855,"rgb(102, 197, 204)"
113,2020-07-05,Andorra,0,0,855,"rgb(102, 197, 204)"
114,2020-07-06,Andorra,0,0,855,"rgb(102, 197, 204)"
115,2020-07-07,Andorra,0,0,855,"rgb(102, 197, 204)"
116,2020-07-08,Andorra,0,0,855,"rgb(102, 197, 204)"
117,2020-07-09,Andorra,0,0,855,"rgb(102, 197, 204)"
118,2020-07-10,Andorra,0,0,855,"rgb(102, 197, 204)"
119,2020-07-11,Andorra,0,0,855,"rgb(102, 197, 204)"
120,2020-07-12,Andorra,0,0,855,"rgb(102, 197, 204)"
121,2020-07-13,Andorra,0,0,855,"rgb(102, 197, 204)"
122,2019-12-31,United Arab Emirates,0,0,0,"rgb(246, 207, 113)"
123,2020-01-01,United Arab Emirates,0,0,0,"rgb(246, 207, 113)"
124,2020-01-02,United Arab Emirates,0,0,0,"rgb(246, 207, 113)"
125,2020-01-03,United Arab Emirates,0,0,0,"rgb(246, 207, 113)"
126,2020-01-04,United Arab Emirates,0,0,0,"rgb(246, 207, 113)"
127,2020-01-05,United Arab Emirates,0,0,0,"rgb(246, 207, 113)"
128,2020-01-06,United Arab Emirates,0,0,0,"rgb(246, 207, 113)"
129,2020-01-07,United Arab Emirates,0,0,0,"rgb(246, 207, 113)"
130,2020-01-08,United Arab Emirates,0,0,0,"rgb(246, 207, 113)"
131,2020-01-09,United Arab Emirates,0,0,0,"rgb(246, 207, 113)"
132,2020-01-10,United Arab Emirates,0,0,0,"rgb(246, 207, 113)"
133,2020-01-11,United Arab Emirates,0,0,0,"rgb(246, 207, 113)"
134,2020-01-12,United Arab Emirates,0,0,0,"rgb(246, 207, 113)"
135,2020-01-13,United Arab Emirates,0,0,0,"rgb(246, 207, 113)"
136,2020-01-14,United Arab Emirates,0,0,0,"rgb(246, 207, 113)"
137,2020-01-15,United Arab Emirates,0,0,0,"rgb(246, 207, 113)"
138,2020-01-16,United Arab Emirates,0,0,0,"rgb(246, 207, 113)"
139,2020-01-17,United Arab Emirates,0,0,0,"rgb(246, 207, 113)"
140,2020-01-18,United Arab Emirates,0,0,0,"rgb(246, 207, 113)"
141,2020-01-19,United Arab Emirates,0,0,0,"rgb(246, 207, 113)"
142,2020-01-20,United Arab Emirates,0,0,0,"rgb(246, 207, 113)"
143,2020-01-21,United Arab Emirates,0,0,0,"rgb(246, 207, 113)"
144,2020-01-22,United Arab Emirates,0,0,0,"rgb(246, 207, 113)"
145,2020-01-23,United Arab Emirates,0,0,0,"rgb(246, 207, 113)"
146,2020-01-24,United Arab Emirates,0,0,0,"rgb(246, 207, 113)"
147,2020-01-25,United Arab Emirates,0,0,0,"rgb(246, 207, 113)"
148,2020-01-26,United Arab Emirates,0,0,0,"rgb(246, 207, 113)"
149,2020-01-27,United Arab Emirates,0,1,1,"rgb(246, 207, 113)"
150,2020-01-28,United Arab Emirates,0,0,1,"rgb(246, 207, 113)"
151,2020-01-29,United Arab Emirates,0,0,1,"rgb(246, 207, 113)"
152,2020-01-30,United Arab Emirates,0,3,4,"rgb(246, 207, 113)"
153,2020-01-31,United Arab Emirates,0,0,4,"rgb(246, 207, 113)"
154,2020-02-01,United Arab Emirates,0,0,4,"rgb(246, 207, 113)"
155,2020-02-02,United Arab Emirates,0,1,5,"rgb(246, 207, 113)"
156,2020-02-03,United Arab Emirates,0,0,5,"rgb(246, 207, 113)"
157,2020-02-04,United Arab Emirates,0,0,5,"rgb(246, 207, 113)"
158,2020-02-05,United Arab Emirates,0,0,5,"rgb(246, 207, 113)"
159,2020-02-06,United Arab Emirates,0,0,5,"rgb(246, 207, 113)"
160,2020-02-07,United Arab Emirates,0,0,5,"rgb(246, 207, 113)"
161,2020-02-08,United Arab Emirates,0,2,7,"rgb(246, 207, 113)"
162,2020-02-09,United Arab Emirates,0,0,7,"rgb(246, 207, 113)"
163,2020-02-10,United Arab Emirates,0,0,7,"rgb(246, 207, 113)"
164,2020-02-11,United Arab Emirates,0,1,8,"rgb(246, 207, 113)"
165,2020-02-12,United Arab Emirates,0,0,8,"rgb(246, 207, 113)"
166,2020-02-13,United Arab Emirates,0,0,8,"rgb(246, 207, 113)"
167,2020-02-14,United Arab Emirates,0,0,8,"rgb(246, 207, 113)"
168,2020-02-15,United Arab Emirates,0,0,8,"rgb(246, 207, 113)"
169,2020-02-16,United Arab Emirates,0,0,8,"rgb(246, 207, 113)"
170,2020-02-17,United Arab Emirates,0,1,9,"rgb(246, 207, 113)"
171,2020-02-18,United Arab Emirates,0,0,9,"rgb(246, 207, 113)"
172,2020-02-19,United Arab Emirates,0,0,9,"rgb(246, 207, 113)"
173,2020-02-20,United Arab Emirates,0,0,9,"rgb(246, 207, 113)"
174,2020-02-21,United Arab Emirates,0,0,9,"rgb(246, 207, 113)"
175,2020-02-22,United Arab Emirates,0,2,11,"rgb(246, 207, 113)"
176,2020-02-23,United Arab Emirates,0,2,13,"rgb(246, 207, 113)"
177,2020-02-24,United Arab Emirates,0,0,13,"rgb(246, 207, 113)"
178,2020-02-25,United Arab Emirates,0,0,13,"rgb(246, 207, 113)"
179,2020-02-26,United Arab Emirates,0,0,13,"rgb(246, 207, 113)"
180,2020-02-27,United Arab Emirates,0,0,13,"rgb(246, 207, 113)"
181,2020-02-28,United Arab Emirates,0,6,19,"rgb(246, 207, 113)"
182,2020-02-29,United Arab Emirates,0,0,19,"rgb(246, 207, 113)"
183,2020-03-01,United Arab Emirates,0,2,21,"rgb(246, 207, 113)"
184,2020-03-02,United Arab Emirates,0,0,21,"rgb(246, 207, 113)"
185,2020-03-04,United Arab Emirates,0,6,27,"rgb(246, 207, 113)"
186,2020-03-06,United Arab Emirates,0,2,29,"rgb(246, 207, 113)"
187,2020-03-08,United Arab Emirates,0,16,45,"rgb(246, 207, 113)"
188,2020-03-10,United Arab Emirates,0,14,59,"rgb(246, 207, 113)"
189,2020-03-11,United Arab Emirates,0,15,74,"rgb(246, 207, 113)"
190,2020-03-13,United Arab Emirates,0,11,85,"rgb(246, 207, 113)"
191,2020-03-15,United Arab Emirates,0,0,85,"rgb(246, 207, 113)"
192,2020-03-16,United Arab Emirates,0,1,86,"rgb(246, 207, 113)"
193,2020-03-17,United Arab Emirates,0,12,98,"rgb(246, 207, 113)"
194,2020-03-18,United Arab Emirates,0,15,113,"rgb(246, 207, 113)"
195,2020-03-19,United Arab Emirates,0,0,113,"rgb(246, 207, 113)"
196,2020-03-20,United Arab Emirates,0,27,140,"rgb(246, 207, 113)"
197,2020-03-21,United Arab Emirates,0,0,140,"rgb(246, 207, 113)"
198,2020-03-22,United Arab Emirates,2,13,153,"rgb(246, 207, 113)"
199,2020-03-23,United Arab Emirates,0,0,153,"rgb(246, 207, 113)"
200,2020-03-24,United Arab Emirates,0,45,198,"rgb(246, 207, 113)"
201,2020-03-25,United Arab Emirates,0,50,248,"rgb(246, 207, 113)"
202,2020-03-26,United Arab Emirates,0,85,333,"rgb(246, 207, 113)"
203,2020-03-27,United Arab Emirates,0,0,333,"rgb(246, 207, 113)"
204,2020-03-28,United Arab Emirates,0,72,405,"rgb(246, 207, 113)"
205,2020-03-29,United Arab Emirates,0,63,468,"rgb(246, 207, 113)"
206,2020-03-30,United Arab Emirates,0,0,468,"rgb(246, 207, 113)"
207,2020-03-31,United Arab Emirates,3,143,611,"rgb(246, 207, 113)"
208,2020-04-01,United Arab Emirates,1,53,664,"rgb(246, 207, 113)"
209,2020-04-02,United Arab Emirates,0,0,664,"rgb(246, 207, 113)"
210,2020-04-03,United Arab Emirates,2,360,1024,"rgb(246, 207, 113)"
211,2020-04-04,United Arab Emirates,0,0,1024,"rgb(246, 207, 113)"
212,2020-04-05,United Arab Emirates,2,481,1505,"rgb(246, 207, 113)"
213,2020-04-06,United Arab Emirates,0,294,1799,"rgb(246, 207, 113)"
214,2020-04-07,United Arab Emirates,1,277,2076,"rgb(246, 207, 113)"
215,2020-04-08,United Arab Emirates,1,283,2359,"rgb(246, 207, 113)"
216,2020-04-09,United Arab Emirates,0,300,2659,"rgb(246, 207, 113)"
217,2020-04-10,United Arab Emirates,2,331,2990,"rgb(246, 207, 113)"
218,2020-04-11,United Arab Emirates,2,370,3360,"rgb(246, 207, 113)"
219,2020-04-12,United Arab Emirates,4,376,3736,"rgb(246, 207, 113)"
220,2020-04-13,United Arab Emirates,2,387,4123,"rgb(246, 207, 113)"
221,2020-04-14,United Arab Emirates,3,398,4521,"rgb(246, 207, 113)"
222,2020-04-15,United Arab Emirates,3,412,4933,"rgb(246, 207, 113)"
223,2020-04-16,United Arab Emirates,5,432,5365,"rgb(246, 207, 113)"
224,2020-04-17,United Arab Emirates,0,460,5825,"rgb(246, 207, 113)"
225,2020-04-18,United Arab Emirates,2,0,5825,"rgb(246, 207, 113)"
226,2020-04-19,United Arab Emirates,2,477,6302,"rgb(246, 207, 113)"
227,2020-04-20,United Arab Emirates,4,479,6781,"rgb(246, 207, 113)"
228,2020-04-21,United Arab Emirates,2,484,7265,"rgb(246, 207, 113)"
229,2020-04-22,United Arab Emirates,3,490,7755,"rgb(246, 207, 113)"
230,2020-04-23,United Arab Emirates,6,483,8238,"rgb(246, 207, 113)"
231,2020-04-24,United Arab Emirates,4,518,8756,"rgb(246, 207, 113)"
232,2020-04-25,United Arab Emirates,8,525,9281,"rgb(246, 207, 113)"
233,2020-04-26,United Arab Emirates,0,532,9813,"rgb(246, 207, 113)"
234,2020-04-27,United Arab Emirates,12,536,10349,"rgb(246, 207, 113)"
235,2020-04-28,United Arab Emirates,6,490,10839,"rgb(246, 207, 113)"
236,2020-04-29,United Arab Emirates,7,541,11380,"rgb(246, 207, 113)"
237,2020-04-30,United Arab Emirates,9,549,11929,"rgb(246, 207, 113)"
238,2020-05-01,United Arab Emirates,7,552,12481,"rgb(246, 207, 113)"
239,2020-05-02,United Arab Emirates,6,557,13038,"rgb(246, 207, 113)"
240,2020-05-03,United Arab Emirates,8,561,13599,"rgb(246, 207, 113)"
241,2020-05-04,United Arab Emirates,7,564,14163,"rgb(246, 207, 113)"
242,2020-05-05,United Arab Emirates,11,567,14730,"rgb(246, 207, 113)"
243,2020-05-06,United Arab Emirates,9,462,15192,"rgb(246, 207, 113)"
244,2020-05-07,United Arab Emirates,11,546,15738,"rgb(246, 207, 113)"
245,2020-05-08,United Arab Emirates,8,502,16240,"rgb(246, 207, 113)"
246,2020-05-09,United Arab Emirates,9,553,16793,"rgb(246, 207, 113)"
247,2020-05-10,United Arab Emirates,11,624,17417,"rgb(246, 207, 113)"
248,2020-05-11,United Arab Emirates,13,781,18198,"rgb(246, 207, 113)"
249,2020-05-12,United Arab Emirates,3,680,18878,"rgb(246, 207, 113)"
250,2020-05-13,United Arab Emirates,2,783,19661,"rgb(246, 207, 113)"
251,2020-05-14,United Arab Emirates,3,725,20386,"rgb(246, 207, 113)"
252,2020-05-15,United Arab Emirates,2,698,21084,"rgb(246, 207, 113)"
253,2020-05-16,United Arab Emirates,2,747,21831,"rgb(246, 207, 113)"
254,2020-05-17,United Arab Emirates,4,796,22627,"rgb(246, 207, 113)"
255,2020-05-18,United Arab Emirates,6,731,23358,"rgb(246, 207, 113)"
256,2020-05-19,United Arab Emirates,4,832,24190,"rgb(246, 207, 113)"
257,2020-05-20,United Arab Emirates,3,873,25063,"rgb(246, 207, 113)"
258,2020-05-21,United Arab Emirates,6,941,26004,"rgb(246, 207, 113)"
259,2020-05-22,United Arab Emirates,4,894,26898,"rgb(246, 207, 113)"
260,2020-05-23,United Arab Emirates,4,994,27892,"rgb(246, 207, 113)"
261,2020-05-24,United Arab Emirates,3,812,28704,"rgb(246, 207, 113)"
262,2020-05-25,United Arab Emirates,1,781,29485,"rgb(246, 207, 113)"
263,2020-05-26,United Arab Emirates,3,822,30307,"rgb(246, 207, 113)"
264,2020-05-27,United Arab Emirates,5,779,31086,"rgb(246, 207, 113)"
265,2020-05-28,United Arab Emirates,2,883,31969,"rgb(246, 207, 113)"
266,2020-05-29,United Arab Emirates,3,563,32532,"rgb(246, 207, 113)"
267,2020-05-30,United Arab Emirates,2,638,33170,"rgb(246, 207, 113)"
268,2020-05-31,United Arab Emirates,2,726,33896,"rgb(246, 207, 113)"
269,2020-06-01,United Arab Emirates,2,661,34557,"rgb(246, 207, 113)"
270,2020-06-02,United Arab Emirates,2,635,35192,"rgb(246, 207, 113)"
271,2020-06-03,United Arab Emirates,3,596,35788,"rgb(246, 207, 113)"
272,2020-06-04,United Arab Emirates,1,571,36359,"rgb(246, 207, 113)"
273,2020-06-05,United Arab Emirates,3,659,37018,"rgb(246, 207, 113)"
274,2020-06-06,United Arab Emirates,1,624,37642,"rgb(246, 207, 113)"
275,2020-06-07,United Arab Emirates,1,626,38268,"rgb(246, 207, 113)"
276,2020-06-08,United Arab Emirates,1,540,38808,"rgb(246, 207, 113)"
277,2020-06-09,United Arab Emirates,5,568,39376,"rgb(246, 207, 113)"
278,2020-06-10,United Arab Emirates,2,528,39904,"rgb(246, 207, 113)"
279,2020-06-11,United Arab Emirates,1,603,40507,"rgb(246, 207, 113)"
280,2020-06-12,United Arab Emirates,2,479,40986,"rgb(246, 207, 113)"
281,2020-06-13,United Arab Emirates,1,513,41499,"rgb(246, 207, 113)"
282,2020-06-14,United Arab Emirates,1,401,41900,"rgb(246, 207, 113)"
283,2020-06-15,United Arab Emirates,1,394,42294,"rgb(246, 207, 113)"
284,2020-06-16,United Arab Emirates,2,342,42636,"rgb(246, 207, 113)"
285,2020-06-17,United Arab Emirates,2,346,42982,"rgb(246, 207, 113)"
286,2020-06-18,United Arab Emirates,2,382,43364,"rgb(246, 207, 113)"
287,2020-06-19,United Arab Emirates,3,388,43752,"rgb(246, 207, 113)"
288,2020-06-20,United Arab Emirates,2,393,44145,"rgb(246, 207, 113)"
289,2020-06-21,United Arab Emirates,1,388,44533,"rgb(246, 207, 113)"
290,2020-06-22,United Arab Emirates,1,392,44925,"rgb(246, 207, 113)"
291,2020-06-23,United Arab Emirates,1,378,45303,"rgb(246, 207, 113)"
292,2020-06-24,United Arab Emirates,2,380,45683,"rgb(246, 207, 113)"
293,2020-06-25,United Arab Emirates,2,450,46133,"rgb(246, 207, 113)"
294,2020-06-26,United Arab Emirates,1,430,46563,"rgb(246, 207, 113)"
295,2020-06-27,United Arab Emirates,2,410,46973,"rgb(246, 207, 113)"
296,2020-06-28,United Arab Emirates,1,387,47360,"rgb(246, 207, 113)"
297,2020-06-29,United Arab Emirates,2,437,47797,"rgb(246, 207, 113)"
298,2020-06-30,United Arab Emirates,1,449,48246,"rgb(246, 207, 113)"
299,2020-07-01,United Arab Emirates,1,421,48667,"rgb(246, 207, 113)"
300,2020-07-02,United Arab Emirates,1,402,49069,"rgb(246, 207, 113)"
301,2020-07-03,United Arab Emirates,1,400,49469,"rgb(246, 207, 113)"
302,2020-07-04,United Arab Emirates,1,672,50141,"rgb(246, 207, 113)"
303,2020-07-05,United Arab Emirates,3,716,50857,"rgb(246, 207, 113)"
304,2020-07-06,United Arab Emirates,2,683,51540,"rgb(246, 207, 113)"
305,2020-07-07,United Arab Emirates,1,528,52068,"rgb(246, 207, 113)"
306,2020-07-08,United Arab Emirates,2,532,52600,"rgb(246, 207, 113)"
307,2020-07-09,United Arab Emirates,1,445,53045,"rgb(246, 207, 113)"
308,2020-07-10,United Arab Emirates,1,532,53577,"rgb(246, 207, 113)"
309,2020-07-11,United Arab Emirates,1,473,54050,"rgb(246, 207, 113)"
310,2020-07-12,United Arab Emirates,2,403,54453,"rgb(246, 207, 113)"
311,2020-07-13,United Arab Emirates,2,401,54854,"rgb(246, 207, 113)"
312,2019-12-31,Afghanistan,0,0,0,"rgb(248, 156, 116)"
313,2020-01-01,Afghanistan,0,0,0,"rgb(248, 156, 116)"
314,2020-01-02,Afghanistan,0,0,0,"rgb(248, 156, 116)"
315,2020-01-03,Afghanistan,0,0,0,"rgb(248, 156, 116)"
316,2020-01-04,Afghanistan,0,0,0,"rgb(248, 156, 116)"
317,2020-01-05,Afghanistan,0,0,0,"rgb(248, 156, 116)"
318,2020-01-06,Afghanistan,0,0,0,"rgb(248, 156, 116)"
319,2020-01-07,Afghanistan,0,0,0,"rgb(248, 156, 116)"
320,2020-01-08,Afghanistan,0,0,0,"rgb(248, 156, 116)"
321,2020-01-09,Afghanistan,0,0,0,"rgb(248, 156, 116)"
322,2020-01-10,Afghanistan,0,0,0,"rgb(248, 156, 116)"
323,2020-01-11,Afghanistan,0,0,0,"rgb(248, 156, 116)"
324,2020-01-12,Afghanistan,0,0,0,"rgb(248, 156, 116)"
325,2020-01-13,Afghanistan,0,0,0,"rgb(248, 156, 116)"
326,2020-01-14,Afghanistan,0,0,0,"rgb(248, 156, 116)"
327,2020-01-15,Afghanistan,0,0,0,"rgb(248, 156, 116)"
328,2020-01-16,Afghanistan,0,0,0,"rgb(248, 156, 116)"
329,2020-01-17,Afghanistan,0,0,0,"rgb(248, 156, 116)"
330,2020-01-18,Afghanistan,0,0,0,"rgb(248, 156, 116)"
331,2020-01-19,Afghanistan,0,0,0,"rgb(248, 156, 116)"
332,2020-01-20,Afghanistan,0,0,0,"rgb(248, 156, 116)"
333,2020-01-21,Afghanistan,0,0,0,"rgb(248, 156, 116)"
334,2020-01-22,Afghanistan,0,0,0,"rgb(248, 156, 116)"
335,2020-01-23,Afghanistan,0,0,0,"rgb(248, 156, 116)"
336,2020-01-24,Afghanistan,0,0,0,"rgb(248, 156, 116)"
337,2020-01-25,Afghanistan,0,0,0,"rgb(248, 156, 116)"
338,2020-01-26,Afghanistan,0,0,0,"rgb(248, 156, 116)"
339,2020-01-27,Afghanistan,0,0,0,"rgb(248, 156, 116)"
340,2020-01-28,Afghanistan,0,0,0,"rgb(248, 156, 116)"
341,2020-01-29,Afghanistan,0,0,0,"rgb(248, 156, 116)"
342,2020-01-30,Afghanistan,0,0,0,"rgb(248, 156, 116)"
343,2020-01-31,Afghanistan,0,0,0,"rgb(248, 156, 116)"
344,2020-02-01,Afghanistan,0,0,0,"rgb(248, 156, 116)"
345,2020-02-02,Afghanistan,0,0,0,"rgb(248, 156, 116)"
346,2020-02-03,Afghanistan,0,0,0,"rgb(248, 156, 116)"
347,2020-02-04,Afghanistan,0,0,0,"rgb(248, 156, 116)"
348,2020-02-05,Afghanistan,0,0,0,"rgb(248, 156, 116)"
349,2020-02-06,Afghanistan,0,0,0,"rgb(248, 156, 116)"
350,2020-02-07,Afghanistan,0,0,0,"rgb(248, 156, 116)"
351,2020-02-08,Afghanistan,0,0,0,"rgb(248, 156, 116)"
352,2020-02-09,Afghanistan,0,0,0,"rgb(248, 156, 116)"
353,2020-02-10,Afghanistan,0,0,0,"rgb(248, 156, 116)"
354,2020-02-11,Afghanistan,0,0,0,"rgb(248, 156, 116)"
355,2020-02-12,Afghanistan,0,0,0,"rgb(248, 156, 116)"
356,2020-02-13,Afghanistan,0,0,0,"rgb(248, 156, 116)"
357,2020-02-14,Afghanistan,0,0,0,"rgb(248, 156, 116)"
358,2020-02-15,Afghanistan,0,0,0,"rgb(248, 156, 116)"
359,2020-02-16,Afghanistan,0,0,0,"rgb(248, 156, 116)"
360,2020-02-17,Afghanistan,0,0,0,"rgb(248, 156, 116)"
361,2020-02-18,Afghanistan,0,0,0,"rgb(248, 156, 116)"
362,2020-02-19,Afghanistan,0,0,0,"rgb(248, 156, 116)"
363,2020-02-20,Afghanistan,0,0,0,"rgb(248, 156, 116)"
364,2020-02-21,Afghanistan,0,0,0,"rgb(248, 156, 116)"
365,2020-02-22,Afghanistan,0,0,0,"rgb(248, 156, 116)"
366,2020-02-23,Afghanistan,0,0,0,"rgb(248, 156, 116)"
367,2020-02-24,Afghanistan,0,0,0,"rgb(248, 156, 116)"
368,2020-02-25,Afghanistan,0,1,1,"rgb(248, 156, 116)"
369,2020-02-26,Afghanistan,0,0,1,"rgb(248, 156, 116)"
370,2020-02-27,Afghanistan,0,0,1,"rgb(248, 156, 116)"
371,2020-02-28,Afghanistan,0,0,1,"rgb(248, 156, 116)"
372,2020-02-29,Afghanistan,0,0,1,"rgb(248, 156, 116)"
373,2020-03-01,Afghanistan,0,0,1,"rgb(248, 156, 116)"
374,2020-03-02,Afghanistan,0,0,1,"rgb(248, 156, 116)"
375,2020-03-08,Afghanistan,0,3,4,"rgb(248, 156, 116)"
376,2020-03-11,Afghanistan,0,3,7,"rgb(248, 156, 116)"
377,2020-03-15,Afghanistan,0,3,10,"rgb(248, 156, 116)"
378,2020-03-16,Afghanistan,0,6,16,"rgb(248, 156, 116)"
379,2020-03-17,Afghanistan,0,5,21,"rgb(248, 156, 116)"
380,2020-03-18,Afghanistan,0,1,22,"rgb(248, 156, 116)"
381,2020-03-19,Afghanistan,0,0,22,"rgb(248, 156, 116)"
382,2020-03-20,Afghanistan,0,0,22,"rgb(248, 156, 116)"
383,2020-03-21,Afghanistan,0,2,24,"rgb(248, 156, 116)"
384,2020-03-22,Afghanistan,0,0,24,"rgb(248, 156, 116)"
385,2020-03-23,Afghanistan,0,10,34,"rgb(248, 156, 116)"
386,2020-03-24,Afghanistan,1,6,40,"rgb(248, 156, 116)"
387,2020-03-25,Afghanistan,0,2,42,"rgb(248, 156, 116)"
388,2020-03-26,Afghanistan,0,33,75,"rgb(248, 156, 116)"
389,2020-03-27,Afghanistan,0,0,75,"rgb(248, 156, 116)"
390,2020-03-28,Afghanistan,1,16,91,"rgb(248, 156, 116)"
391,2020-03-29,Afghanistan,1,15,106,"rgb(248, 156, 116)"
392,2020-03-30,Afghanistan,1,8,114,"rgb(248, 156, 116)"
393,2020-03-31,Afghanistan,0,27,141,"rgb(248, 156, 116)"
394,2020-04-01,Afghanistan,0,25,166,"rgb(248, 156, 116)"
395,2020-04-02,Afghanistan,0,26,192,"rgb(248, 156, 116)"
396,2020-04-03,Afghanistan,0,43,235,"rgb(248, 156, 116)"
397,2020-04-04,Afghanistan,0,0,235,"rgb(248, 156, 116)"
398,2020-04-05,Afghanistan,1,35,270,"rgb(248, 156, 116)"
399,2020-04-06,Afghanistan,2,29,299,"rgb(248, 156, 116)"
400,2020-04-07,Afghanistan,0,38,337,"rgb(248, 156, 116)"
401,2020-04-08,Afghanistan,4,30,367,"rgb(248, 156, 116)"
402,2020-04-09,Afghanistan,3,56,423,"rgb(248, 156, 116)"
403,2020-04-10,Afghanistan,1,61,484,"rgb(248, 156, 116)"
404,2020-04-11,Afghanistan,0,37,521,"rgb(248, 156, 116)"
405,2020-04-12,Afghanistan,3,34,555,"rgb(248, 156, 116)"
406,2020-04-13,Afghanistan,0,52,607,"rgb(248, 156, 116)"
407,2020-04-14,Afghanistan,3,58,665,"rgb(248, 156, 116)"
408,2020-04-15,Afghanistan,2,49,714,"rgb(248, 156, 116)"
409,2020-04-16,Afghanistan,2,70,784,"rgb(248, 156, 116)"
410,2020-04-17,Afghanistan,4,10,794,"rgb(248, 156, 116)"
411,2020-04-18,Afghanistan,1,51,845,"rgb(248, 156, 116)"
412,2020-04-19,Afghanistan,0,63,908,"rgb(248, 156, 116)"
413,2020-04-20,Afghanistan,3,88,996,"rgb(248, 156, 116)"
414,2020-04-21,Afghanistan,2,35,1031,"rgb(248, 156, 116)"
415,2020-04-22,Afghanistan,1,61,1092,"rgb(248, 156, 116)"
416,2020-04-23,Afghanistan,4,84,1176,"rgb(248, 156, 116)"
417,2020-04-24,Afghanistan,2,105,1281,"rgb(248, 156, 116)"
418,2020-04-25,Afghanistan,1,70,1351,"rgb(248, 156, 116)"
419,2020-04-26,Afghanistan,4,112,1463,"rgb(248, 156, 116)"
420,2020-04-27,Afghanistan,10,68,1531,"rgb(248, 156, 116)"
421,2020-04-28,Afghanistan,0,172,1703,"rgb(248, 156, 116)"
422,2020-04-29,Afghanistan,3,124,1827,"rgb(248, 156, 116)"
423,2020-04-30,Afghanistan,0,122,1949,"rgb(248, 156, 116)"
424,2020-05-01,Afghanistan,4,222,2171,"rgb(248, 156, 116)"
425,2020-05-02,Afghanistan,4,164,2335,"rgb(248, 156, 116)"
426,2020-05-03,Afghanistan,4,134,2469,"rgb(248, 156, 116)"
427,2020-05-04,Afghanistan,13,235,2704,"rgb(248, 156, 116)"
428,2020-05-05,Afghanistan,5,190,2894,"rgb(248, 156, 116)"
429,2020-05-06,Afghanistan,5,330,3224,"rgb(248, 156, 116)"
430,2020-05-07,Afghanistan,9,168,3392,"rgb(248, 156, 116)"
431,2020-05-08,Afghanistan,2,171,3563,"rgb(248, 156, 116)"
432,2020-05-09,Afghanistan,3,215,3778,"rgb(248, 156, 116)"
433,2020-05-10,Afghanistan,6,255,4033,"rgb(248, 156, 116)"
434,2020-05-11,Afghanistan,5,369,4402,"rgb(248, 156, 116)"
435,2020-05-12,Afghanistan,2,285,4687,"rgb(248, 156, 116)"
436,2020-05-13,Afghanistan,5,280,4967,"rgb(248, 156, 116)"
437,2020-05-14,Afghanistan,3,259,5226,"rgb(248, 156, 116)"
438,2020-05-15,Afghanistan,6,113,5339,"rgb(248, 156, 116)"
439,2020-05-16,Afghanistan,32,1063,6402,"rgb(248, 156, 116)"
440,2020-05-17,Afghanistan,0,0,6402,"rgb(248, 156, 116)"
441,2020-05-18,Afghanistan,1,262,6664,"rgb(248, 156, 116)"
442,2020-05-19,Afghanistan,4,408,7072,"rgb(248, 156, 116)"
443,2020-05-20,Afghanistan,5,581,7653,"rgb(248, 156, 116)"
444,2020-05-21,Afghanistan,9,492,8145,"rgb(248, 156, 116)"
445,2020-05-22,Afghanistan,6,531,8676,"rgb(248, 156, 116)"
446,2020-05-23,Afghanistan,12,540,9216,"rgb(248, 156, 116)"
447,2020-05-24,Afghanistan,11,782,9998,"rgb(248, 156, 116)"
448,2020-05-25,Afghanistan,2,584,10582,"rgb(248, 156, 116)"
449,2020-05-26,Afghanistan,1,591,11173,"rgb(248, 156, 116)"
450,2020-05-27,Afghanistan,1,658,11831,"rgb(248, 156, 116)"
451,2020-05-28,Afghanistan,7,625,12456,"rgb(248, 156, 116)"
452,2020-05-29,Afghanistan,8,580,13036,"rgb(248, 156, 116)"
453,2020-05-30,Afghanistan,11,623,13659,"rgb(248, 156, 116)"
454,2020-05-31,Afghanistan,3,866,14525,"rgb(248, 156, 116)"
455,2020-06-01,Afghanistan,8,680,15205,"rgb(248, 156, 116)"
456,2020-06-02,Afghanistan,8,545,15750,"rgb(248, 156, 116)"
457,2020-06-03,Afghanistan,5,759,16509,"rgb(248, 156, 116)"
458,2020-06-04,Afghanistan,24,758,17267,"rgb(248, 156, 116)"
459,2020-06-05,Afghanistan,6,787,18054,"rgb(248, 156, 116)"
460,2020-06-06,Afghanistan,9,915,18969,"rgb(248, 156, 116)"
461,2020-06-07,Afghanistan,18,582,19551,"rgb(248, 156, 116)"
462,2020-06-08,Afghanistan,30,791,20342,"rgb(248, 156, 116)"
463,2020-06-09,Afghanistan,12,575,20917,"rgb(248, 156, 116)"
464,2020-06-10,Afghanistan,15,542,21459,"rgb(248, 156, 116)"
465,2020-06-11,Afghanistan,21,684,22143,"rgb(248, 156, 116)"
466,2020-06-12,Afghanistan,21,747,22890,"rgb(248, 156, 116)"
467,2020-06-13,Afghanistan,20,656,23546,"rgb(248, 156, 116)"
468,2020-06-14,Afghanistan,5,556,24102,"rgb(248, 156, 116)"
469,2020-06-15,Afghanistan,20,664,24766,"rgb(248, 156, 116)"
470,2020-06-16,Afghanistan,7,761,25527,"rgb(248, 156, 116)"
471,2020-06-17,Afghanistan,13,783,26310,"rgb(248, 156, 116)"
472,2020-06-18,Afghanistan,13,564,26874,"rgb(248, 156, 116)"
473,2020-06-19,Afghanistan,42,658,27532,"rgb(248, 156, 116)"
474,2020-06-20,Afghanistan,2,346,27878,"rgb(248, 156, 116)"
475,2020-06-21,Afghanistan,21,546,28424,"rgb(248, 156, 116)"
476,2020-06-22,Afghanistan,12,409,28833,"rgb(248, 156, 116)"
477,2020-06-23,Afghanistan,17,310,29143,"rgb(248, 156, 116)"
478,2020-06-24,Afghanistan,20,338,29481,"rgb(248, 156, 116)"
479,2020-06-25,Afghanistan,21,234,29715,"rgb(248, 156, 116)"
480,2020-06-26,Afghanistan,36,460,30175,"rgb(248, 156, 116)"
481,2020-06-27,Afghanistan,8,276,30451,"rgb(248, 156, 116)"
482,2020-06-28,Afghanistan,20,165,30616,"rgb(248, 156, 116)"
483,2020-06-29,Afghanistan,18,351,30967,"rgb(248, 156, 116)"
484,2020-06-30,Afghanistan,12,271,31238,"rgb(248, 156, 116)"
485,2020-07-01,Afghanistan,13,279,31517,"rgb(248, 156, 116)"
486,2020-07-02,Afghanistan,28,319,31836,"rgb(248, 156, 116)"
487,2020-07-03,Afghanistan,33,186,32022,"rgb(248, 156, 116)"
488,2020-07-04,Afghanistan,12,302,32324,"rgb(248, 156, 116)"
489,2020-07-05,Afghanistan,7,348,32672,"rgb(248, 156, 116)"
490,2020-07-06,Afghanistan,38,279,32951,"rgb(248, 156, 116)"
491,2020-07-07,Afghanistan,56,433,33384,"rgb(248, 156, 116)"
492,2020-07-08,Afghanistan,16,210,33594,"rgb(248, 156, 116)"
493,2020-07-09,Afghanistan,1,59,33653,"rgb(248, 156, 116)"
494,2020-07-10,Afghanistan,20,255,33908,"rgb(248, 156, 116)"
495,2020-07-11,Afghanistan,37,458,34366,"rgb(248, 156, 116)"
496,2020-07-12,Afghanistan,16,85,34451,"rgb(248, 156, 116)"
497,2020-07-13,Afghanistan,0,0,34451,"rgb(248, 156, 116)"
498,2020-03-15,Antigua and Barbuda,0,1,1,"rgb(220, 176, 242)"
499,2020-03-21,Antigua and Barbuda,0,0,1,"rgb(220, 176, 242)"
500,2020-03-22,Antigua and Barbuda,0,0,1,"rgb(220, 176, 242)"
501,2020-03-23,Antigua and Barbuda,0,0,1,"rgb(220, 176, 242)"
502,2020-03-24,Antigua and Barbuda,0,0,1,"rgb(220, 176, 242)"
503,2020-03-25,Antigua and Barbuda,0,2,3,"rgb(220, 176, 242)"
504,2020-03-26,Antigua and Barbuda,0,0,3,"rgb(220, 176, 242)"
505,2020-03-27,Antigua and Barbuda,0,4,7,"rgb(220, 176, 242)"
506,2020-03-28,Antigua and Barbuda,0,0,7,"rgb(220, 176, 242)"
507,2020-03-29,Antigua and Barbuda,0,0,7,"rgb(220, 176, 242)"
508,2020-03-30,Antigua and Barbuda,0,0,7,"rgb(220, 176, 242)"
509,2020-03-31,Antigua and Barbuda,0,0,7,"rgb(220, 176, 242)"
510,2020-04-01,Antigua and Barbuda,0,0,7,"rgb(220, 176, 242)"
511,2020-04-02,Antigua and Barbuda,0,0,7,"rgb(220, 176, 242)"
512,2020-04-03,Antigua and Barbuda,0,2,9,"rgb(220, 176, 242)"
513,2020-04-04,Antigua and Barbuda,0,6,15,"rgb(220, 176, 242)"
514,2020-04-05,Antigua and Barbuda,0,0,15,"rgb(220, 176, 242)"
515,2020-04-06,Antigua and Barbuda,0,0,15,"rgb(220, 176, 242)"
516,2020-04-07,Antigua and Barbuda,0,0,15,"rgb(220, 176, 242)"
517,2020-04-08,Antigua and Barbuda,0,0,15,"rgb(220, 176, 242)"
518,2020-04-09,Antigua and Barbuda,0,0,15,"rgb(220, 176, 242)"
519,2020-04-10,Antigua and Barbuda,2,4,19,"rgb(220, 176, 242)"
520,2020-04-11,Antigua and Barbuda,0,2,21,"rgb(220, 176, 242)"
521,2020-04-12,Antigua and Barbuda,0,0,21,"rgb(220, 176, 242)"
522,2020-04-13,Antigua and Barbuda,0,0,21,"rgb(220, 176, 242)"
523,2020-04-14,Antigua and Barbuda,0,2,23,"rgb(220, 176, 242)"
524,2020-04-15,Antigua and Barbuda,0,0,23,"rgb(220, 176, 242)"
525,2020-04-16,Antigua and Barbuda,0,0,23,"rgb(220, 176, 242)"
526,2020-04-17,Antigua and Barbuda,0,0,23,"rgb(220, 176, 242)"
527,2020-04-18,Antigua and Barbuda,0,0,23,"rgb(220, 176, 242)"
528,2020-04-19,Antigua and Barbuda,0,0,23,"rgb(220, 176, 242)"
529,2020-04-20,Antigua and Barbuda,0,0,23,"rgb(220, 176, 242)"
530,2020-04-21,Antigua and Barbuda,1,0,23,"rgb(220, 176, 242)"
531,2020-04-22,Antigua and Barbuda,0,1,24,"rgb(220, 176, 242)"
532,2020-04-23,Antigua and Barbuda,0,0,24,"rgb(220, 176, 242)"
533,2020-04-24,Antigua and Barbuda,0,0,24,"rgb(220, 176, 242)"
534,2020-04-25,Antigua and Barbuda,0,0,24,"rgb(220, 176, 242)"
535,2020-04-26,Antigua and Barbuda,0,0,24,"rgb(220, 176, 242)"
536,2020-04-27,Antigua and Barbuda,0,0,24,"rgb(220, 176, 242)"
537,2020-04-28,Antigua and Barbuda,0,0,24,"rgb(220, 176, 242)"
538,2020-04-29,Antigua and Barbuda,0,0,24,"rgb(220, 176, 242)"
539,2020-04-30,Antigua and Barbuda,0,0,24,"rgb(220, 176, 242)"
540,2020-05-01,Antigua and Barbuda,0,0,24,"rgb(220, 176, 242)"
541,2020-05-02,Antigua and Barbuda,0,1,25,"rgb(220, 176, 242)"
542,2020-05-03,Antigua and Barbuda,0,0,25,"rgb(220, 176, 242)"
543,2020-05-04,Antigua and Barbuda,0,0,25,"rgb(220, 176, 242)"
544,2020-05-05,Antigua and Barbuda,0,0,25,"rgb(220, 176, 242)"
545,2020-05-06,Antigua and Barbuda,0,0,25,"rgb(220, 176, 242)"
546,2020-05-07,Antigua and Barbuda,0,0,25,"rgb(220, 176, 242)"
547,2020-05-08,Antigua and Barbuda,0,0,25,"rgb(220, 176, 242)"
548,2020-05-09,Antigua and Barbuda,0,0,25,"rgb(220, 176, 242)"
549,2020-05-10,Antigua and Barbuda,0,0,25,"rgb(220, 176, 242)"
550,2020-05-11,Antigua and Barbuda,0,0,25,"rgb(220, 176, 242)"
551,2020-05-12,Antigua and Barbuda,0,0,25,"rgb(220, 176, 242)"
552,2020-05-13,Antigua and Barbuda,0,0,25,"rgb(220, 176, 242)"
553,2020-05-14,Antigua and Barbuda,0,0,25,"rgb(220, 176, 242)"
554,2020-05-15,Antigua and Barbuda,0,0,25,"rgb(220, 176, 242)"
555,2020-05-16,Antigua and Barbuda,0,0,25,"rgb(220, 176, 242)"
556,2020-05-17,Antigua and Barbuda,0,0,25,"rgb(220, 176, 242)"
557,2020-05-18,Antigua and Barbuda,0,0,25,"rgb(220, 176, 242)"
558,2020-05-19,Antigua and Barbuda,0,0,25,"rgb(220, 176, 242)"
559,2020-05-20,Antigua and Barbuda,0,0,25,"rgb(220, 176, 242)"
560,2020-05-21,Antigua and Barbuda,0,0,25,"rgb(220, 176, 242)"
561,2020-05-22,Antigua and Barbuda,0,0,25,"rgb(220, 176, 242)"
562,2020-05-23,Antigua and Barbuda,0,0,25,"rgb(220, 176, 242)"
563,2020-05-24,Antigua and Barbuda,0,0,25,"rgb(220, 176, 242)"
564,2020-05-25,Antigua and Barbuda,0,0,25,"rgb(220, 176, 242)"
565,2020-05-26,Antigua and Barbuda,0,0,25,"rgb(220, 176, 242)"
566,2020-05-27,Antigua and Barbuda,0,0,25,"rgb(220, 176, 242)"
567,2020-05-28,Antigua and Barbuda,0,0,25,"rgb(220, 176, 242)"
568,2020-05-29,Antigua and Barbuda,0,0,25,"rgb(220, 176, 242)"
569,2020-05-30,Antigua and Barbuda,0,0,25,"rgb(220, 176, 242)"
570,2020-05-31,Antigua and Barbuda,0,0,25,"rgb(220, 176, 242)"
571,2020-06-01,Antigua and Barbuda,0,0,25,"rgb(220, 176, 242)"
572,2020-06-02,Antigua and Barbuda,0,0,25,"rgb(220, 176, 242)"
573,2020-06-03,Antigua and Barbuda,0,0,25,"rgb(220, 176, 242)"
574,2020-06-04,Antigua and Barbuda,0,1,26,"rgb(220, 176, 242)"
575,2020-06-05,Antigua and Barbuda,0,0,26,"rgb(220, 176, 242)"
576,2020-06-06,Antigua and Barbuda,0,0,26,"rgb(220, 176, 242)"
577,2020-06-07,Antigua and Barbuda,0,0,26,"rgb(220, 176, 242)"
578,2020-06-08,Antigua and Barbuda,0,0,26,"rgb(220, 176, 242)"
579,2020-06-09,Antigua and Barbuda,0,0,26,"rgb(220, 176, 242)"
580,2020-06-10,Antigua and Barbuda,0,0,26,"rgb(220, 176, 242)"
581,2020-06-11,Antigua and Barbuda,0,0,26,"rgb(220, 176, 242)"
582,2020-06-12,Antigua and Barbuda,0,0,26,"rgb(220, 176, 242)"
583,2020-06-13,Antigua and Barbuda,0,0,26,"rgb(220, 176, 242)"
584,2020-06-14,Antigua and Barbuda,0,0,26,"rgb(220, 176, 242)"
585,2020-06-15,Antigua and Barbuda,0,0,26,"rgb(220, 176, 242)"
586,2020-06-16,Antigua and Barbuda,0,0,26,"rgb(220, 176, 242)"
587,2020-06-17,Antigua and Barbuda,0,0,26,"rgb(220, 176, 242)"
588,2020-06-18,Antigua and Barbuda,0,0,26,"rgb(220, 176, 242)"
589,2020-06-19,Antigua and Barbuda,0,0,26,"rgb(220, 176, 242)"
590,2020-06-20,Antigua and Barbuda,0,0,26,"rgb(220, 176, 242)"
591,2020-06-21,Antigua and Barbuda,0,0,26,"rgb(220, 176, 242)"
592,2020-06-22,Antigua and Barbuda,0,0,26,"rgb(220, 176, 242)"
593,2020-06-23,Antigua and Barbuda,0,0,26,"rgb(220, 176, 242)"
594,2020-06-24,Antigua and Barbuda,0,0,26,"rgb(220, 176, 242)"
595,2020-06-25,Antigua and Barbuda,0,39,65,"rgb(220, 176, 242)"
596,2020-06-26,Antigua and Barbuda,0,0,65,"rgb(220, 176, 242)"
597,2020-06-27,Antigua and Barbuda,0,0,65,"rgb(220, 176, 242)"
598,2020-06-28,Antigua and Barbuda,0,0,65,"rgb(220, 176, 242)"
599,2020-06-29,Antigua and Barbuda,0,0,65,"rgb(220, 176, 242)"
600,2020-06-30,Antigua and Barbuda,0,1,66,"rgb(220, 176, 242)"
601,2020-07-01,Antigua and Barbuda,0,0,66,"rgb(220, 176, 242)"
602,2020-07-02,Antigua and Barbuda,0,0,66,"rgb(220, 176, 242)"
603,2020-07-03,Antigua and Barbuda,0,2,68,"rgb(220, 176, 242)"
604,2020-07-04,Antigua and Barbuda,0,0,68,"rgb(220, 176, 242)"
605,2020-07-05,Antigua and Barbuda,0,0,68,"rgb(220, 176, 242)"
606,2020-07-06,Antigua and Barbuda,0,0,68,"rgb(220, 176, 242)"
607,2020-07-07,Antigua and Barbuda,0,2,70,"rgb(220, 176, 242)"
608,2020-07-08,Antigua and Barbuda,0,0,70,"rgb(220, 176, 242)"
609,2020-07-09,Antigua and Barbuda,0,3,73,"rgb(220, 176, 242)"
610,2020-07-10,Antigua and Barbuda,0,0,73,"rgb(220, 176, 242)"
611,2020-07-11,Antigua and Barbuda,0,1,74,"rgb(220, 176, 242)"
612,2020-07-12,Antigua and Barbuda,0,0,74,"rgb(220, 176, 242)"
613,2020-07-13,Antigua and Barbuda,0,0,74,"rgb(220, 176, 242)"
614,2020-03-27,Anguilla,0,2,2,"rgb(135, 197, 95)"
615,2020-03-28,Anguilla,0,0,2,"rgb(135, 197, 95)"
616,2020-03-29,Anguilla,0,0,2,"rgb(135, 197, 95)"
617,2020-03-30,Anguilla,0,0,2,"rgb(135, 197, 95)"
618,2020-03-31,Anguilla,0,0,2,"rgb(135, 197, 95)"
619,2020-04-01,Anguilla,0,0,2,"rgb(135, 197, 95)"
620,2020-04-02,Anguilla,0,0,2,"rgb(135, 197, 95)"
621,2020-04-03,Anguilla,0,1,3,"rgb(135, 197, 95)"
622,2020-04-04,Anguilla,0,0,3,"rgb(135, 197, 95)"
623,2020-04-05,Anguilla,0,0,3,"rgb(135, 197, 95)"
624,2020-04-06,Anguilla,0,0,3,"rgb(135, 197, 95)"
625,2020-04-07,Anguilla,0,0,3,"rgb(135, 197, 95)"
626,2020-04-08,Anguilla,0,0,3,"rgb(135, 197, 95)"
627,2020-04-09,Anguilla,0,0,3,"rgb(135, 197, 95)"
628,2020-04-10,Anguilla,0,0,3,"rgb(135, 197, 95)"
629,2020-04-11,Anguilla,0,0,3,"rgb(135, 197, 95)"
630,2020-04-12,Anguilla,0,0,3,"rgb(135, 197, 95)"
631,2020-04-13,Anguilla,0,0,3,"rgb(135, 197, 95)"
632,2020-04-14,Anguilla,0,0,3,"rgb(135, 197, 95)"
633,2020-04-15,Anguilla,0,0,3,"rgb(135, 197, 95)"
634,2020-04-16,Anguilla,0,0,3,"rgb(135, 197, 95)"
635,2020-04-17,Anguilla,0,0,3,"rgb(135, 197, 95)"
636,2020-04-18,Anguilla,0,0,3,"rgb(135, 197, 95)"
637,2020-04-19,Anguilla,0,0,3,"rgb(135, 197, 95)"
638,2020-04-20,Anguilla,0,0,3,"rgb(135, 197, 95)"
639,2020-04-21,Anguilla,0,0,3,"rgb(135, 197, 95)"
640,2020-04-22,Anguilla,0,0,3,"rgb(135, 197, 95)"
641,2020-04-23,Anguilla,0,0,3,"rgb(135, 197, 95)"
642,2020-04-24,Anguilla,0,0,3,"rgb(135, 197, 95)"
643,2020-04-25,Anguilla,0,0,3,"rgb(135, 197, 95)"
644,2020-04-26,Anguilla,0,0,3,"rgb(135, 197, 95)"
645,2020-04-27,Anguilla,0,0,3,"rgb(135, 197, 95)"
646,2020-04-28,Anguilla,0,0,3,"rgb(135, 197, 95)"
647,2020-04-29,Anguilla,0,0,3,"rgb(135, 197, 95)"
648,2020-04-30,Anguilla,0,0,3,"rgb(135, 197, 95)"
649,2020-05-01,Anguilla,0,0,3,"rgb(135, 197, 95)"
650,2020-05-02,Anguilla,0,0,3,"rgb(135, 197, 95)"
651,2020-05-03,Anguilla,0,0,3,"rgb(135, 197, 95)"
652,2020-05-04,Anguilla,0,0,3,"rgb(135, 197, 95)"
653,2020-05-05,Anguilla,0,0,3,"rgb(135, 197, 95)"
654,2020-05-06,Anguilla,0,0,3,"rgb(135, 197, 95)"
655,2020-05-07,Anguilla,0,0,3,"rgb(135, 197, 95)"
656,2020-05-08,Anguilla,0,0,3,"rgb(135, 197, 95)"
657,2020-05-09,Anguilla,0,0,3,"rgb(135, 197, 95)"
658,2020-05-10,Anguilla,0,0,3,"rgb(135, 197, 95)"
659,2020-05-11,Anguilla,0,0,3,"rgb(135, 197, 95)"
660,2020-05-12,Anguilla,0,0,3,"rgb(135, 197, 95)"
661,2020-05-13,Anguilla,0,0,3,"rgb(135, 197, 95)"
662,2020-05-14,Anguilla,0,0,3,"rgb(135, 197, 95)"
663,2020-05-15,Anguilla,0,0,3,"rgb(135, 197, 95)"
664,2020-05-16,Anguilla,0,0,3,"rgb(135, 197, 95)"
665,2020-05-17,Anguilla,0,0,3,"rgb(135, 197, 95)"
666,2020-05-18,Anguilla,0,0,3,"rgb(135, 197, 95)"
667,2020-05-19,Anguilla,0,0,3,"rgb(135, 197, 95)"
668,2020-05-20,Anguilla,0,0,3,"rgb(135, 197, 95)"
669,2020-05-21,Anguilla,0,0,3,"rgb(135, 197, 95)"
670,2020-05-22,Anguilla,0,0,3,"rgb(135, 197, 95)"
671,2020-05-23,Anguilla,0,0,3,"rgb(135, 197, 95)"
672,2020-05-24,Anguilla,0,0,3,"rgb(135, 197, 95)"
673,2020-05-25,Anguilla,0,0,3,"rgb(135, 197, 95)"
674,2020-05-26,Anguilla,0,0,3,"rgb(135, 197, 95)"
675,2020-05-27,Anguilla,0,0,3,"rgb(135, 197, 95)"
676,2020-05-28,Anguilla,0,0,3,"rgb(135, 197, 95)"
677,2020-05-29,Anguilla,0,0,3,"rgb(135, 197, 95)"
678,2020-05-30,Anguilla,0,0,3,"rgb(135, 197, 95)"
679,2020-05-31,Anguilla,0,0,3,"rgb(135, 197, 95)"
680,2020-06-01,Anguilla,0,0,3,"rgb(135, 197, 95)"
681,2020-06-02,Anguilla,0,0,3,"rgb(135, 197, 95)"
682,2020-06-03,Anguilla,0,0,3,"rgb(135, 197, 95)"
683,2020-06-04,Anguilla,0,0,3,"rgb(135, 197, 95)"
684,2020-06-05,Anguilla,0,0,3,"rgb(135, 197, 95)"
685,2020-06-06,Anguilla,0,0,3,"rgb(135, 197, 95)"
686,2020-06-07,Anguilla,0,0,3,"rgb(135, 197, 95)"
687,2020-06-08,Anguilla,0,0,3,"rgb(135, 197, 95)"
688,2020-06-09,Anguilla,0,0,3,"rgb(135, 197, 95)"
689,2020-06-10,Anguilla,0,0,3,"rgb(135, 197, 95)"
690,2020-06-11,Anguilla,0,0,3,"rgb(135, 197, 95)"
691,2020-06-12,Anguilla,0,0,3,"rgb(135, 197, 95)"
692,2020-06-13,Anguilla,0,0,3,"rgb(135, 197, 95)"
693,2020-06-14,Anguilla,0,0,3,"rgb(135, 197, 95)"
694,2020-06-15,Anguilla,0,0,3,"rgb(135, 197, 95)"
695,2020-06-16,Anguilla,0,0,3,"rgb(135, 197, 95)"
696,2020-06-17,Anguilla,0,0,3,"rgb(135, 197, 95)"
697,2020-06-18,Anguilla,0,0,3,"rgb(135, 197, 95)"
698,2020-06-19,Anguilla,0,0,3,"rgb(135, 197, 95)"
699,2020-06-20,Anguilla,0,0,3,"rgb(135, 197, 95)"
700,2020-06-21,Anguilla,0,0,3,"rgb(135, 197, 95)"
701,2020-06-22,Anguilla,0,0,3,"rgb(135, 197, 95)"
702,2020-06-23,Anguilla,0,0,3,"rgb(135, 197, 95)"
703,2020-06-24,Anguilla,0,0,3,"rgb(135, 197, 95)"
704,2020-06-25,Anguilla,0,0,3,"rgb(135, 197, 95)"
705,2020-06-26,Anguilla,0,0,3,"rgb(135, 197, 95)"
706,2020-06-27,Anguilla,0,0,3,"rgb(135, 197, 95)"
707,2020-06-28,Anguilla,0,0,3,"rgb(135, 197, 95)"
708,2020-06-29,Anguilla,0,0,3,"rgb(135, 197, 95)"
709,2020-06-30,Anguilla,0,0,3,"rgb(135, 197, 95)"
710,2020-07-01,Anguilla,0,0,3,"rgb(135, 197, 95)"
711,2020-07-02,Anguilla,0,0,3,"rgb(135, 197, 95)"
712,2020-07-03,Anguilla,0,0,3,"rgb(135, 197, 95)"
713,2020-07-04,Anguilla,0,0,3,"rgb(135, 197, 95)"
714,2020-07-05,Anguilla,0,0,3,"rgb(135, 197, 95)"
715,2020-07-06,Anguilla,0,0,3,"rgb(135, 197, 95)"
716,2020-07-07,Anguilla,0,0,3,"rgb(135, 197, 95)"
717,2020-07-08,Anguilla,0,0,3,"rgb(135, 197, 95)"
718,2020-07-09,Anguilla,0,0,3,"rgb(135, 197, 95)"
719,2020-07-10,Anguilla,0,0,3,"rgb(135, 197, 95)"
720,2020-07-11,Anguilla,0,0,3,"rgb(135, 197, 95)"
721,2020-07-12,Anguilla,0,0,3,"rgb(135, 197, 95)"
722,2020-07-13,Anguilla,0,0,3,"rgb(135, 197, 95)"
723,2020-03-09,Albania,0,2,2,"rgb(158, 185, 243)"
724,2020-03-10,Albania,0,4,6,"rgb(158, 185, 243)"
725,2020-03-11,Albania,0,4,10,"rgb(158, 185, 243)"
726,2020-03-12,Albania,1,1,11,"rgb(158, 185, 243)"
727,2020-03-13,Albania,0,12,23,"rgb(158, 185, 243)"
728,2020-03-14,Albania,0,10,33,"rgb(158, 185, 243)"
729,2020-03-15,Albania,0,5,38,"rgb(158, 185, 243)"
730,2020-03-16,Albania,0,4,42,"rgb(158, 185, 243)"
731,2020-03-17,Albania,0,9,51,"rgb(158, 185, 243)"
732,2020-03-18,Albania,0,4,55,"rgb(158, 185, 243)"
733,2020-03-19,Albania,1,4,59,"rgb(158, 185, 243)"
734,2020-03-20,Albania,0,11,70,"rgb(158, 185, 243)"
735,2020-03-21,Albania,0,0,70,"rgb(158, 185, 243)"
736,2020-03-22,Albania,0,6,76,"rgb(158, 185, 243)"
737,2020-03-23,Albania,0,13,89,"rgb(158, 185, 243)"
738,2020-03-24,Albania,2,11,100,"rgb(158, 185, 243)"
739,2020-03-25,Albania,1,23,123,"rgb(158, 185, 243)"
740,2020-03-26,Albania,0,23,146,"rgb(158, 185, 243)"
741,2020-03-27,Albania,1,28,174,"rgb(158, 185, 243)"
742,2020-03-28,Albania,3,12,186,"rgb(158, 185, 243)"
743,2020-03-29,Albania,1,11,197,"rgb(158, 185, 243)"
744,2020-03-30,Albania,0,15,212,"rgb(158, 185, 243)"
745,2020-03-31,Albania,2,11,223,"rgb(158, 185, 243)"
746,2020-04-01,Albania,3,20,243,"rgb(158, 185, 243)"
747,2020-04-02,Albania,0,16,259,"rgb(158, 185, 243)"
748,2020-04-03,Albania,1,18,277,"rgb(158, 185, 243)"
749,2020-04-04,Albania,1,27,304,"rgb(158, 185, 243)"
750,2020-04-05,Albania,2,29,333,"rgb(158, 185, 243)"
751,2020-04-06,Albania,2,28,361,"rgb(158, 185, 243)"
752,2020-04-07,Albania,1,16,377,"rgb(158, 185, 243)"
753,2020-04-08,Albania,0,6,383,"rgb(158, 185, 243)"
754,2020-04-09,Albania,0,17,400,"rgb(158, 185, 243)"
755,2020-04-10,Albania,1,9,409,"rgb(158, 185, 243)"
756,2020-04-11,Albania,0,7,416,"rgb(158, 185, 243)"
757,2020-04-12,Albania,0,17,433,"rgb(158, 185, 243)"
758,2020-04-13,Albania,0,13,446,"rgb(158, 185, 243)"
759,2020-04-14,Albania,0,21,467,"rgb(158, 185, 243)"
760,2020-04-15,Albania,1,8,475,"rgb(158, 185, 243)"
761,2020-04-16,Albania,1,19,494,"rgb(158, 185, 243)"
762,2020-04-17,Albania,1,24,518,"rgb(158, 185, 243)"
763,2020-04-18,Albania,0,21,539,"rgb(158, 185, 243)"
764,2020-04-19,Albania,0,9,548,"rgb(158, 185, 243)"
765,2020-04-20,Albania,0,14,562,"rgb(158, 185, 243)"
766,2020-04-21,Albania,0,22,584,"rgb(158, 185, 243)"
767,2020-04-22,Albania,0,25,609,"rgb(158, 185, 243)"
768,2020-04-23,Albania,1,25,634,"rgb(158, 185, 243)"
769,2020-04-24,Albania,0,29,663,"rgb(158, 185, 243)"
770,2020-04-25,Albania,0,15,678,"rgb(158, 185, 243)"
771,2020-04-26,Albania,0,34,712,"rgb(158, 185, 243)"
772,2020-04-27,Albania,1,14,726,"rgb(158, 185, 243)"
773,2020-04-28,Albania,0,10,736,"rgb(158, 185, 243)"
774,2020-04-29,Albania,2,14,750,"rgb(158, 185, 243)"
775,2020-04-30,Albania,1,16,766,"rgb(158, 185, 243)"
776,2020-05-01,Albania,0,7,773,"rgb(158, 185, 243)"
777,2020-05-02,Albania,0,9,782,"rgb(158, 185, 243)"
778,2020-05-03,Albania,0,7,789,"rgb(158, 185, 243)"
779,2020-05-04,Albania,0,6,795,"rgb(158, 185, 243)"
780,2020-05-05,Albania,0,8,803,"rgb(158, 185, 243)"
781,2020-05-06,Albania,0,17,820,"rgb(158, 185, 243)"
782,2020-05-07,Albania,0,12,832,"rgb(158, 185, 243)"
783,2020-05-08,Albania,0,10,842,"rgb(158, 185, 243)"
784,2020-05-09,Albania,0,8,850,"rgb(158, 185, 243)"
785,2020-05-10,Albania,0,6,856,"rgb(158, 185, 243)"
786,2020-05-11,Albania,0,12,868,"rgb(158, 185, 243)"
787,2020-05-12,Albania,0,4,872,"rgb(158, 185, 243)"
788,2020-05-13,Albania,0,4,876,"rgb(158, 185, 243)"
789,2020-05-14,Albania,0,4,880,"rgb(158, 185, 243)"
790,2020-05-15,Albania,0,18,898,"rgb(158, 185, 243)"
791,2020-05-16,Albania,0,18,916,"rgb(158, 185, 243)"
792,2020-05-17,Albania,0,17,933,"rgb(158, 185, 243)"
793,2020-05-18,Albania,0,13,946,"rgb(158, 185, 243)"
794,2020-05-19,Albania,0,2,948,"rgb(158, 185, 243)"
795,2020-05-20,Albania,0,1,949,"rgb(158, 185, 243)"
796,2020-05-21,Albania,0,15,964,"rgb(158, 185, 243)"
797,2020-05-22,Albania,0,5,969,"rgb(158, 185, 243)"
798,2020-05-23,Albania,0,12,981,"rgb(158, 185, 243)"
799,2020-05-24,Albania,0,8,989,"rgb(158, 185, 243)"
800,2020-05-25,Albania,1,9,998,"rgb(158, 185, 243)"
801,2020-05-26,Albania,0,6,1004,"rgb(158, 185, 243)"
802,2020-05-27,Albania,1,25,1029,"rgb(158, 185, 243)"
803,2020-05-28,Albania,0,21,1050,"rgb(158, 185, 243)"
804,2020-05-29,Albania,0,26,1076,"rgb(158, 185, 243)"
805,2020-05-30,Albania,0,23,1099,"rgb(158, 185, 243)"
806,2020-05-31,Albania,0,23,1122,"rgb(158, 185, 243)"
807,2020-06-01,Albania,0,15,1137,"rgb(158, 185, 243)"
808,2020-06-02,Albania,0,6,1143,"rgb(158, 185, 243)"
809,2020-06-03,Albania,0,21,1164,"rgb(158, 185, 243)"
810,2020-06-04,Albania,0,20,1184,"rgb(158, 185, 243)"
811,2020-06-05,Albania,0,13,1197,"rgb(158, 185, 243)"
812,2020-06-06,Albania,0,15,1212,"rgb(158, 185, 243)"
813,2020-06-07,Albania,1,20,1232,"rgb(158, 185, 243)"
814,2020-06-08,Albania,0,14,1246,"rgb(158, 185, 243)"
815,2020-06-09,Albania,0,17,1263,"rgb(158, 185, 243)"
816,2020-06-10,Albania,0,36,1299,"rgb(158, 185, 243)"
817,2020-06-11,Albania,0,42,1341,"rgb(158, 185, 243)"
818,2020-06-12,Albania,1,44,1385,"rgb(158, 185, 243)"
819,2020-06-13,Albania,1,31,1416,"rgb(158, 185, 243)"
820,2020-06-14,Albania,0,48,1464,"rgb(158, 185, 243)"
821,2020-06-15,Albania,0,57,1521,"rgb(158, 185, 243)"
822,2020-06-16,Albania,0,69,1590,"rgb(158, 185, 243)"
823,2020-06-17,Albania,1,82,1672,"rgb(158, 185, 243)"
824,2020-06-18,Albania,1,50,1722,"rgb(158, 185, 243)"
825,2020-06-19,Albania,1,66,1788,"rgb(158, 185, 243)"
826,2020-06-20,Albania,3,50,1838,"rgb(158, 185, 243)"
827,2020-06-21,Albania,1,53,1891,"rgb(158, 185, 243)"
828,2020-06-22,Albania,1,36,1927,"rgb(158, 185, 243)"
829,2020-06-23,Albania,0,68,1995,"rgb(158, 185, 243)"
830,2020-06-24,Albania,1,52,2047,"rgb(158, 185, 243)"
831,2020-06-25,Albania,2,67,2114,"rgb(158, 185, 243)"
832,2020-06-26,Albania,2,78,2192,"rgb(158, 185, 243)"
833,2020-06-27,Albania,2,77,2269,"rgb(158, 185, 243)"
834,2020-06-28,Albania,2,61,2330,"rgb(158, 185, 243)"
835,2020-06-29,Albania,2,72,2402,"rgb(158, 185, 243)"
836,2020-06-30,Albania,3,64,2466,"rgb(158, 185, 243)"
837,2020-07-01,Albania,4,69,2535,"rgb(158, 185, 243)"
838,2020-07-02,Albania,3,45,2580,"rgb(158, 185, 243)"
839,2020-07-03,Albania,4,82,2662,"rgb(158, 185, 243)"
840,2020-07-04,Albania,3,90,2752,"rgb(158, 185, 243)"
841,2020-07-05,Albania,2,67,2819,"rgb(158, 185, 243)"
842,2020-07-06,Albania,2,74,2893,"rgb(158, 185, 243)"
843,2020-07-07,Albania,3,71,2964,"rgb(158, 185, 243)"
844,2020-07-08,Albania,2,74,3038,"rgb(158, 185, 243)"
845,2020-07-09,Albania,2,68,3106,"rgb(158, 185, 243)"
846,2020-07-10,Albania,0,82,3188,"rgb(158, 185, 243)"
847,2020-07-11,Albania,2,90,3278,"rgb(158, 185, 243)"
848,2020-07-12,Albania,4,93,3371,"rgb(158, 185, 243)"
849,2020-07-13,Albania,4,83,3454,"rgb(158, 185, 243)"
850,2019-12-31,Armenia,0,0,0,"rgb(254, 136, 177)"
851,2020-01-01,Armenia,0,0,0,"rgb(254, 136, 177)"
852,2020-01-02,Armenia,0,0,0,"rgb(254, 136, 177)"
853,2020-01-03,Armenia,0,0,0,"rgb(254, 136, 177)"
854,2020-01-04,Armenia,0,0,0,"rgb(254, 136, 177)"
855,2020-01-05,Armenia,0,0,0,"rgb(254, 136, 177)"
856,2020-01-06,Armenia,0,0,0,"rgb(254, 136, 177)"
857,2020-01-07,Armenia,0,0,0,"rgb(254, 136, 177)"
858,2020-01-08,Armenia,0,0,0,"rgb(254, 136, 177)"
859,2020-01-09,Armenia,0,0,0,"rgb(254, 136, 177)"
860,2020-01-10,Armenia,0,0,0,"rgb(254, 136, 177)"
861,2020-01-11,Armenia,0,0,0,"rgb(254, 136, 177)"
862,2020-01-12,Armenia,0,0,0,"rgb(254, 136, 177)"
863,2020-01-13,Armenia,0,0,0,"rgb(254, 136, 177)"
864,2020-01-14,Armenia,0,0,0,"rgb(254, 136, 177)"
865,2020-01-15,Armenia,0,0,0,"rgb(254, 136, 177)"
866,2020-01-16,Armenia,0,0,0,"rgb(254, 136, 177)"
867,2020-01-17,Armenia,0,0,0,"rgb(254, 136, 177)"
868,2020-01-18,Armenia,0,0,0,"rgb(254, 136, 177)"
869,2020-01-19,Armenia,0,0,0,"rgb(254, 136, 177)"
870,2020-01-20,Armenia,0,0,0,"rgb(254, 136, 177)"
871,2020-01-21,Armenia,0,0,0,"rgb(254, 136, 177)"
872,2020-01-22,Armenia,0,0,0,"rgb(254, 136, 177)"
873,2020-01-23,Armenia,0,0,0,"rgb(254, 136, 177)"
874,2020-01-24,Armenia,0,0,0,"rgb(254, 136, 177)"
875,2020-01-25,Armenia,0,0,0,"rgb(254, 136, 177)"
876,2020-01-26,Armenia,0,0,0,"rgb(254, 136, 177)"
877,2020-01-27,Armenia,0,0,0,"rgb(254, 136, 177)"
878,2020-01-28,Armenia,0,0,0,"rgb(254, 136, 177)"
879,2020-01-29,Armenia,0,0,0,"rgb(254, 136, 177)"
880,2020-01-30,Armenia,0,0,0,"rgb(254, 136, 177)"
881,2020-01-31,Armenia,0,0,0,"rgb(254, 136, 177)"
882,2020-02-01,Armenia,0,0,0,"rgb(254, 136, 177)"
883,2020-02-02,Armenia,0,0,0,"rgb(254, 136, 177)"
884,2020-02-03,Armenia,0,0,0,"rgb(254, 136, 177)"
885,2020-02-04,Armenia,0,0,0,"rgb(254, 136, 177)"
886,2020-02-05,Armenia,0,0,0,"rgb(254, 136, 177)"
887,2020-02-06,Armenia,0,0,0,"rgb(254, 136, 177)"
888,2020-02-07,Armenia,0,0,0,"rgb(254, 136, 177)"
889,2020-02-08,Armenia,0,0,0,"rgb(254, 136, 177)"
890,2020-02-09,Armenia,0,0,0,"rgb(254, 136, 177)"
891,2020-02-10,Armenia,0,0,0,"rgb(254, 136, 177)"
892,2020-02-11,Armenia,0,0,0,"rgb(254, 136, 177)"
893,2020-02-12,Armenia,0,0,0,"rgb(254, 136, 177)"
894,2020-02-13,Armenia,0,0,0,"rgb(254, 136, 177)"
895,2020-02-14,Armenia,0,0,0,"rgb(254, 136, 177)"
896,2020-02-15,Armenia,0,0,0,"rgb(254, 136, 177)"
897,2020-02-16,Armenia,0,0,0,"rgb(254, 136, 177)"
898,2020-02-17,Armenia,0,0,0,"rgb(254, 136, 177)"
899,2020-02-18,Armenia,0,0,0,"rgb(254, 136, 177)"
900,2020-02-19,Armenia,0,0,0,"rgb(254, 136, 177)"
901,2020-02-20,Armenia,0,0,0,"rgb(254, 136, 177)"
902,2020-02-21,Armenia,0,0,0,"rgb(254, 136, 177)"
903,2020-02-22,Armenia,0,0,0,"rgb(254, 136, 177)"
904,2020-02-23,Armenia,0,0,0,"rgb(254, 136, 177)"
905,2020-02-24,Armenia,0,0,0,"rgb(254, 136, 177)"
906,2020-02-25,Armenia,0,0,0,"rgb(254, 136, 177)"
907,2020-02-26,Armenia,0,0,0,"rgb(254, 136, 177)"
908,2020-02-27,Armenia,0,0,0,"rgb(254, 136, 177)"
909,2020-02-28,Armenia,0,0,0,"rgb(254, 136, 177)"
910,2020-02-29,Armenia,0,0,0,"rgb(254, 136, 177)"
911,2020-03-01,Armenia,0,1,1,"rgb(254, 136, 177)"
912,2020-03-02,Armenia,0,0,1,"rgb(254, 136, 177)"
913,2020-03-12,Armenia,0,3,4,"rgb(254, 136, 177)"
914,2020-03-13,Armenia,0,2,6,"rgb(254, 136, 177)"
915,2020-03-14,Armenia,0,7,13,"rgb(254, 136, 177)"
916,2020-03-15,Armenia,0,7,20,"rgb(254, 136, 177)"
917,2020-03-16,Armenia,0,10,30,"rgb(254, 136, 177)"
918,2020-03-17,Armenia,0,22,52,"rgb(254, 136, 177)"
919,2020-03-18,Armenia,0,26,78,"rgb(254, 136, 177)"
920,2020-03-19,Armenia,0,37,115,"rgb(254, 136, 177)"
921,2020-03-20,Armenia,0,7,122,"rgb(254, 136, 177)"
922,2020-03-21,Armenia,0,14,136,"rgb(254, 136, 177)"
923,2020-03-22,Armenia,0,24,160,"rgb(254, 136, 177)"
924,2020-03-23,Armenia,0,30,190,"rgb(254, 136, 177)"
925,2020-03-24,Armenia,0,4,194,"rgb(254, 136, 177)"
926,2020-03-25,Armenia,0,71,265,"rgb(254, 136, 177)"
927,2020-03-26,Armenia,0,25,290,"rgb(254, 136, 177)"
928,2020-03-27,Armenia,1,39,329,"rgb(254, 136, 177)"
929,2020-03-28,Armenia,0,43,372,"rgb(254, 136, 177)"
930,2020-03-29,Armenia,2,52,424,"rgb(254, 136, 177)"
931,2020-03-30,Armenia,0,0,424,"rgb(254, 136, 177)"
932,2020-03-31,Armenia,0,58,482,"rgb(254, 136, 177)"
933,2020-04-01,Armenia,0,50,532,"rgb(254, 136, 177)"
934,2020-04-02,Armenia,0,39,571,"rgb(254, 136, 177)"
935,2020-04-03,Armenia,1,92,663,"rgb(254, 136, 177)"
936,2020-04-04,Armenia,3,73,736,"rgb(254, 136, 177)"
937,2020-04-05,Armenia,0,34,770,"rgb(254, 136, 177)"
938,2020-04-06,Armenia,0,52,822,"rgb(254, 136, 177)"
939,2020-04-07,Armenia,1,11,833,"rgb(254, 136, 177)"
940,2020-04-08,Armenia,0,20,853,"rgb(254, 136, 177)"
941,2020-04-09,Armenia,1,28,881,"rgb(254, 136, 177)"
942,2020-04-10,Armenia,1,40,921,"rgb(254, 136, 177)"
943,2020-04-11,Armenia,1,16,937,"rgb(254, 136, 177)"
944,2020-04-12,Armenia,2,30,967,"rgb(254, 136, 177)"
945,2020-04-13,Armenia,0,46,1013,"rgb(254, 136, 177)"
946,2020-04-14,Armenia,1,26,1039,"rgb(254, 136, 177)"
947,2020-04-15,Armenia,3,72,1111,"rgb(254, 136, 177)"
948,2020-04-16,Armenia,1,48,1159,"rgb(254, 136, 177)"
949,2020-04-17,Armenia,1,42,1201,"rgb(254, 136, 177)"
950,2020-04-18,Armenia,1,47,1248,"rgb(254, 136, 177)"
951,2020-04-19,Armenia,0,43,1291,"rgb(254, 136, 177)"
952,2020-04-20,Armenia,2,48,1339,"rgb(254, 136, 177)"
953,2020-04-21,Armenia,2,62,1401,"rgb(254, 136, 177)"
954,2020-04-22,Armenia,0,72,1473,"rgb(254, 136, 177)"
955,2020-04-23,Armenia,0,50,1523,"rgb(254, 136, 177)"
956,2020-04-24,Armenia,3,73,1596,"rgb(254, 136, 177)"
957,2020-04-25,Armenia,1,81,1677,"rgb(254, 136, 177)"
958,2020-04-26,Armenia,0,69,1746,"rgb(254, 136, 177)"
959,2020-04-27,Armenia,1,62,1808,"rgb(254, 136, 177)"
960,2020-04-28,Armenia,1,59,1867,"rgb(254, 136, 177)"
961,2020-04-29,Armenia,0,65,1932,"rgb(254, 136, 177)"
962,2020-04-30,Armenia,0,0,1932,"rgb(254, 136, 177)"
963,2020-05-01,Armenia,2,134,2066,"rgb(254, 136, 177)"
964,2020-05-02,Armenia,1,82,2148,"rgb(254, 136, 177)"
965,2020-05-03,Armenia,0,125,2273,"rgb(254, 136, 177)"
966,2020-05-04,Armenia,2,113,2386,"rgb(254, 136, 177)"
967,2020-05-05,Armenia,4,121,2507,"rgb(254, 136, 177)"
968,2020-05-06,Armenia,1,112,2619,"rgb(254, 136, 177)"
969,2020-05-07,Armenia,0,163,2782,"rgb(254, 136, 177)"
970,2020-05-08,Armenia,2,102,2884,"rgb(254, 136, 177)"
971,2020-05-09,Armenia,1,145,3029,"rgb(254, 136, 177)"
972,2020-05-10,Armenia,1,146,3175,"rgb(254, 136, 177)"
973,2020-05-11,Armenia,1,138,3313,"rgb(254, 136, 177)"
974,2020-05-12,Armenia,1,79,3392,"rgb(254, 136, 177)"
975,2020-05-13,Armenia,1,146,3538,"rgb(254, 136, 177)"
976,2020-05-14,Armenia,1,180,3718,"rgb(254, 136, 177)"
977,2020-05-15,Armenia,1,142,3860,"rgb(254, 136, 177)"
978,2020-05-16,Armenia,3,184,4044,"rgb(254, 136, 177)"
979,2020-05-17,Armenia,3,239,4283,"rgb(254, 136, 177)"
980,2020-05-18,Armenia,5,189,4472,"rgb(254, 136, 177)"
981,2020-05-19,Armenia,1,351,4823,"rgb(254, 136, 177)"
982,2020-05-20,Armenia,3,218,5041,"rgb(254, 136, 177)"
983,2020-05-21,Armenia,3,230,5271,"rgb(254, 136, 177)"
984,2020-05-22,Armenia,3,335,5606,"rgb(254, 136, 177)"
985,2020-05-23,Armenia,4,322,5928,"rgb(254, 136, 177)"
986,2020-05-24,Armenia,3,374,6302,"rgb(254, 136, 177)"
987,2020-05-25,Armenia,4,359,6661,"rgb(254, 136, 177)"
988,2020-05-26,Armenia,6,452,7113,"rgb(254, 136, 177)"
989,2020-05-27,Armenia,4,289,7402,"rgb(254, 136, 177)"
990,2020-05-28,Armenia,7,372,7774,"rgb(254, 136, 177)"
991,2020-05-29,Armenia,15,442,8216,"rgb(254, 136, 177)"
992,2020-05-30,Armenia,7,460,8676,"rgb(254, 136, 177)"
993,2020-05-31,Armenia,7,251,8927,"rgb(254, 136, 177)"
994,2020-06-01,Armenia,4,355,9282,"rgb(254, 136, 177)"
995,2020-06-02,Armenia,8,210,9492,"rgb(254, 136, 177)"
996,2020-06-03,Armenia,19,517,10009,"rgb(254, 136, 177)"
997,2020-06-04,Armenia,12,515,10524,"rgb(254, 136, 177)"
998,2020-06-05,Armenia,6,697,11221,"rgb(254, 136, 177)"
999,2020-06-06,Armenia,7,596,11817,"rgb(254, 136, 177)"
1000,2020-06-07,Armenia,7,547,12364,"rgb(254, 136, 177)"
1001,2020-06-08,Armenia,10,766,13130,"rgb(254, 136, 177)"
1002,2020-06-09,Armenia,11,195,13325,"rgb(254, 136, 177)"
1003,2020-06-10,Armenia,6,350,13675,"rgb(254, 136, 177)"
1004,2020-06-11,Armenia,10,428,14103,"rgb(254, 136, 177)"
1005,2020-06-12,Armenia,18,566,14669,"rgb(254, 136, 177)"
1006,2020-06-13,Armenia,13,612,15281,"rgb(254, 136, 177)"
1007,2020-06-14,Armenia,6,723,16004,"rgb(254, 136, 177)"
1008,2020-06-15,Armenia,5,663,16667,"rgb(254, 136, 177)"
1009,2020-06-16,Armenia,16,397,17064,"rgb(254, 136, 177)"
1010,2020-06-17,Armenia,8,425,17489,"rgb(254, 136, 177)"
1011,2020-06-18,Armenia,9,544,18033,"rgb(254, 136, 177)"
1012,2020-06-19,Armenia,7,665,18698,"rgb(254, 136, 177)"
1013,2020-06-20,Armenia,10,459,19157,"rgb(254, 136, 177)"
1014,2020-06-21,Armenia,13,551,19708,"rgb(254, 136, 177)"
1015,2020-06-22,Armenia,28,880,20588,"rgb(254, 136, 177)"
1016,2020-06-23,Armenia,0,0,20588,"rgb(254, 136, 177)"
1017,2020-06-24,Armenia,26,1129,21717,"rgb(254, 136, 177)"
1018,2020-06-25,Armenia,0,0,21717,"rgb(254, 136, 177)"
1019,2020-06-26,Armenia,24,1530,23247,"rgb(254, 136, 177)"
1020,2020-06-27,Armenia,10,662,23909,"rgb(254, 136, 177)"
1021,2020-06-28,Armenia,6,736,24645,"rgb(254, 136, 177)"
1022,2020-06-29,Armenia,7,482,25127,"rgb(254, 136, 177)"
1023,2020-06-30,Armenia,0,0,25127,"rgb(254, 136, 177)"
1024,2020-07-01,Armenia,10,415,25542,"rgb(254, 136, 177)"
1025,2020-07-02,Armenia,10,523,26065,"rgb(254, 136, 177)"
1026,2020-07-03,Armenia,6,593,26658,"rgb(254, 136, 177)"
1027,2020-07-04,Armenia,10,662,27320,"rgb(254, 136, 177)"
1028,2020-07-05,Armenia,8,580,27900,"rgb(254, 136, 177)"
1029,2020-07-06,Armenia,7,706,28606,"rgb(254, 136, 177)"
1030,2020-07-07,Armenia,7,330,28936,"rgb(254, 136, 177)"
1031,2020-07-08,Armenia,12,349,29285,"rgb(254, 136, 177)"
1032,2020-07-09,Armenia,18,535,29820,"rgb(254, 136, 177)"
1033,2020-07-10,Armenia,14,526,30346,"rgb(254, 136, 177)"
1034,2020-07-11,Armenia,11,557,30903,"rgb(254, 136, 177)"
1035,2020-07-12,Armenia,13,489,31392,"rgb(254, 136, 177)"
1036,2020-07-13,Armenia,6,577,31969,"rgb(254, 136, 177)"
1037,2020-03-22,Angola,0,2,2,"rgb(201, 219, 116)"
1038,2020-03-23,Angola,0,0,2,"rgb(201, 219, 116)"
1039,2020-03-24,Angola,0,0,2,"rgb(201, 219, 116)"
1040,2020-03-25,Angola,0,0,2,"rgb(201, 219, 116)"
1041,2020-03-26,Angola,0,0,2,"rgb(201, 219, 116)"
1042,2020-03-27,Angola,0,1,3,"rgb(201, 219, 116)"
1043,2020-03-28,Angola,0,1,4,"rgb(201, 219, 116)"
1044,2020-03-29,Angola,0,0,4,"rgb(201, 219, 116)"
1045,2020-03-30,Angola,2,3,7,"rgb(201, 219, 116)"
1046,2020-03-31,Angola,0,0,7,"rgb(201, 219, 116)"
1047,2020-04-01,Angola,0,0,7,"rgb(201, 219, 116)"
1048,2020-04-02,Angola,0,1,8,"rgb(201, 219, 116)"
1049,2020-04-03,Angola,0,0,8,"rgb(201, 219, 116)"
1050,2020-04-04,Angola,0,0,8,"rgb(201, 219, 116)"
1051,2020-04-05,Angola,0,2,10,"rgb(201, 219, 116)"
1052,2020-04-06,Angola,0,4,14,"rgb(201, 219, 116)"
1053,2020-04-07,Angola,0,2,16,"rgb(201, 219, 116)"
1054,2020-04-08,Angola,0,1,17,"rgb(201, 219, 116)"
1055,2020-04-09,Angola,0,2,19,"rgb(201, 219, 116)"
1056,2020-04-10,Angola,0,0,19,"rgb(201, 219, 116)"
1057,2020-04-11,Angola,0,0,19,"rgb(201, 219, 116)"
1058,2020-04-12,Angola,0,0,19,"rgb(201, 219, 116)"
1059,2020-04-13,Angola,0,0,19,"rgb(201, 219, 116)"
1060,2020-04-14,Angola,0,0,19,"rgb(201, 219, 116)"
1061,2020-04-15,Angola,0,0,19,"rgb(201, 219, 116)"
1062,2020-04-16,Angola,0,0,19,"rgb(201, 219, 116)"
1063,2020-04-17,Angola,0,0,19,"rgb(201, 219, 116)"
1064,2020-04-18,Angola,0,0,19,"rgb(201, 219, 116)"
1065,2020-04-19,Angola,0,5,24,"rgb(201, 219, 116)"
1066,2020-04-20,Angola,0,0,24,"rgb(201, 219, 116)"
1067,2020-04-21,Angola,0,0,24,"rgb(201, 219, 116)"
1068,2020-04-22,Angola,0,0,24,"rgb(201, 219, 116)"
1069,2020-04-23,Angola,0,0,24,"rgb(201, 219, 116)"
1070,2020-04-24,Angola,0,1,25,"rgb(201, 219, 116)"
1071,2020-04-25,Angola,0,0,25,"rgb(201, 219, 116)"
1072,2020-04-26,Angola,0,0,25,"rgb(201, 219, 116)"
1073,2020-04-27,Angola,0,1,26,"rgb(201, 219, 116)"
1074,2020-04-28,Angola,0,1,27,"rgb(201, 219, 116)"
1075,2020-04-29,Angola,0,0,27,"rgb(201, 219, 116)"
1076,2020-04-30,Angola,0,0,27,"rgb(201, 219, 116)"
1077,2020-05-01,Angola,0,0,27,"rgb(201, 219, 116)"
1078,2020-05-02,Angola,0,2,29,"rgb(201, 219, 116)"
1079,2020-05-03,Angola,0,6,35,"rgb(201, 219, 116)"
1080,2020-05-04,Angola,0,0,35,"rgb(201, 219, 116)"
1081,2020-05-05,Angola,0,0,35,"rgb(201, 219, 116)"
1082,2020-05-06,Angola,0,1,36,"rgb(201, 219, 116)"
1083,2020-05-07,Angola,0,0,36,"rgb(201, 219, 116)"
1084,2020-05-08,Angola,0,0,36,"rgb(201, 219, 116)"
1085,2020-05-09,Angola,0,7,43,"rgb(201, 219, 116)"
1086,2020-05-10,Angola,0,0,43,"rgb(201, 219, 116)"
1087,2020-05-11,Angola,0,2,45,"rgb(201, 219, 116)"
1088,2020-05-12,Angola,0,0,45,"rgb(201, 219, 116)"
1089,2020-05-13,Angola,0,0,45,"rgb(201, 219, 116)"
1090,2020-05-14,Angola,0,0,45,"rgb(201, 219, 116)"
1091,2020-05-15,Angola,0,3,48,"rgb(201, 219, 116)"
1092,2020-05-16,Angola,0,0,48,"rgb(201, 219, 116)"
1093,2020-05-17,Angola,0,0,48,"rgb(201, 219, 116)"
1094,2020-05-18,Angola,0,0,48,"rgb(201, 219, 116)"
1095,2020-05-19,Angola,0,0,48,"rgb(201, 219, 116)"
1096,2020-05-20,Angola,0,2,50,"rgb(201, 219, 116)"
1097,2020-05-21,Angola,1,2,52,"rgb(201, 219, 116)"
1098,2020-05-22,Angola,0,6,58,"rgb(201, 219, 116)"
1099,2020-05-23,Angola,0,2,60,"rgb(201, 219, 116)"
1100,2020-05-24,Angola,0,0,60,"rgb(201, 219, 116)"
1101,2020-05-25,Angola,1,9,69,"rgb(201, 219, 116)"
1102,2020-05-26,Angola,0,0,69,"rgb(201, 219, 116)"
1103,2020-05-27,Angola,0,2,71,"rgb(201, 219, 116)"
1104,2020-05-28,Angola,0,0,71,"rgb(201, 219, 116)"
1105,2020-05-29,Angola,0,2,73,"rgb(201, 219, 116)"
1106,2020-05-30,Angola,0,4,77,"rgb(201, 219, 116)"
1107,2020-05-31,Angola,0,7,84,"rgb(201, 219, 116)"
1108,2020-06-01,Angola,0,2,86,"rgb(201, 219, 116)"
1109,2020-06-02,Angola,0,0,86,"rgb(201, 219, 116)"
1110,2020-06-03,Angola,0,0,86,"rgb(201, 219, 116)"
1111,2020-06-04,Angola,0,0,86,"rgb(201, 219, 116)"
1112,2020-06-05,Angola,0,0,86,"rgb(201, 219, 116)"
1113,2020-06-06,Angola,0,0,86,"rgb(201, 219, 116)"
1114,2020-06-07,Angola,0,0,86,"rgb(201, 219, 116)"
1115,2020-06-08,Angola,0,5,91,"rgb(201, 219, 116)"
1116,2020-06-09,Angola,0,1,92,"rgb(201, 219, 116)"
1117,2020-06-10,Angola,0,4,96,"rgb(201, 219, 116)"
1118,2020-06-11,Angola,0,17,113,"rgb(201, 219, 116)"
1119,2020-06-12,Angola,1,5,118,"rgb(201, 219, 116)"
1120,2020-06-13,Angola,0,12,130,"rgb(201, 219, 116)"
1121,2020-06-14,Angola,1,8,138,"rgb(201, 219, 116)"
1122,2020-06-15,Angola,0,2,140,"rgb(201, 219, 116)"
1123,2020-06-16,Angola,0,2,142,"rgb(201, 219, 116)"
1124,2020-06-17,Angola,0,0,142,"rgb(201, 219, 116)"
1125,2020-06-18,Angola,1,13,155,"rgb(201, 219, 116)"
1126,2020-06-19,Angola,0,0,155,"rgb(201, 219, 116)"
1127,2020-06-20,Angola,1,11,166,"rgb(201, 219, 116)"
1128,2020-06-21,Angola,0,6,172,"rgb(201, 219, 116)"
1129,2020-06-22,Angola,1,4,176,"rgb(201, 219, 116)"
1130,2020-06-23,Angola,0,7,183,"rgb(201, 219, 116)"
1131,2020-06-24,Angola,1,3,186,"rgb(201, 219, 116)"
1132,2020-06-25,Angola,0,3,189,"rgb(201, 219, 116)"
1133,2020-06-26,Angola,0,8,197,"rgb(201, 219, 116)"
1134,2020-06-27,Angola,0,15,212,"rgb(201, 219, 116)"
1135,2020-06-28,Angola,0,32,244,"rgb(201, 219, 116)"
1136,2020-06-29,Angola,1,23,267,"rgb(201, 219, 116)"
1137,2020-06-30,Angola,0,9,276,"rgb(201, 219, 116)"
1138,2020-07-01,Angola,2,8,284,"rgb(201, 219, 116)"
1139,2020-07-02,Angola,2,7,291,"rgb(201, 219, 116)"
1140,2020-07-03,Angola,2,24,315,"rgb(201, 219, 116)"
1141,2020-07-04,Angola,1,13,328,"rgb(201, 219, 116)"
1142,2020-07-05,Angola,1,18,346,"rgb(201, 219, 116)"
1143,2020-07-06,Angola,0,0,346,"rgb(201, 219, 116)"
1144,2020-07-07,Angola,0,7,353,"rgb(201, 219, 116)"
1145,2020-07-08,Angola,0,0,353,"rgb(201, 219, 116)"
1146,2020-07-09,Angola,2,33,386,"rgb(201, 219, 116)"
1147,2020-07-10,Angola,1,10,396,"rgb(201, 219, 116)"
1148,2020-07-11,Angola,1,62,458,"rgb(201, 219, 116)"
1149,2020-07-12,Angola,2,25,483,"rgb(201, 219, 116)"
1150,2020-07-13,Angola,1,23,506,"rgb(201, 219, 116)"
1151,2020-03-04,Argentina,0,1,1,"rgb(139, 224, 164)"
1152,2020-03-06,Argentina,0,1,2,"rgb(139, 224, 164)"
1153,2020-03-07,Argentina,0,6,8,"rgb(139, 224, 164)"
1154,2020-03-08,Argentina,1,1,9,"rgb(139, 224, 164)"
1155,2020-03-09,Argentina,0,3,12,"rgb(139, 224, 164)"
1156,2020-03-11,Argentina,0,7,19,"rgb(139, 224, 164)"
1157,2020-03-13,Argentina,0,12,31,"rgb(139, 224, 164)"
1158,2020-03-14,Argentina,1,3,34,"rgb(139, 224, 164)"
1159,2020-03-15,Argentina,0,11,45,"rgb(139, 224, 164)"
1160,2020-03-16,Argentina,0,11,56,"rgb(139, 224, 164)"
1161,2020-03-17,Argentina,0,9,65,"rgb(139, 224, 164)"
1162,2020-03-18,Argentina,0,14,79,"rgb(139, 224, 164)"
1163,2020-03-19,Argentina,0,18,97,"rgb(139, 224, 164)"
1164,2020-03-20,Argentina,1,31,128,"rgb(139, 224, 164)"
1165,2020-03-21,Argentina,0,30,158,"rgb(139, 224, 164)"
1166,2020-03-22,Argentina,1,67,225,"rgb(139, 224, 164)"
1167,2020-03-23,Argentina,0,41,266,"rgb(139, 224, 164)"
1168,2020-03-24,Argentina,0,35,301,"rgb(139, 224, 164)"
1169,2020-03-25,Argentina,2,86,387,"rgb(139, 224, 164)"
1170,2020-03-26,Argentina,2,115,502,"rgb(139, 224, 164)"
1171,2020-03-27,Argentina,4,87,589,"rgb(139, 224, 164)"
1172,2020-03-28,Argentina,5,101,690,"rgb(139, 224, 164)"
1173,2020-03-29,Argentina,2,55,745,"rgb(139, 224, 164)"
1174,2020-03-30,Argentina,1,75,820,"rgb(139, 224, 164)"
1175,2020-03-31,Argentina,4,146,966,"rgb(139, 224, 164)"
1176,2020-04-01,Argentina,0,0,966,"rgb(139, 224, 164)"
1177,2020-04-02,Argentina,7,167,1133,"rgb(139, 224, 164)"
1178,2020-04-03,Argentina,3,0,1133,"rgb(139, 224, 164)"
1179,2020-04-04,Argentina,3,132,1265,"rgb(139, 224, 164)"
1180,2020-04-05,Argentina,6,186,1451,"rgb(139, 224, 164)"
1181,2020-04-06,Argentina,3,103,1554,"rgb(139, 224, 164)"
1182,2020-04-07,Argentina,7,74,1628,"rgb(139, 224, 164)"
1183,2020-04-08,Argentina,7,87,1715,"rgb(139, 224, 164)"
1184,2020-04-09,Argentina,5,80,1795,"rgb(139, 224, 164)"
1185,2020-04-10,Argentina,14,99,1894,"rgb(139, 224, 164)"
1186,2020-04-11,Argentina,3,81,1975,"rgb(139, 224, 164)"
1187,2020-04-12,Argentina,7,162,2137,"rgb(139, 224, 164)"
1188,2020-04-13,Argentina,6,66,2203,"rgb(139, 224, 164)"
1189,2020-04-14,Argentina,3,69,2272,"rgb(139, 224, 164)"
1190,2020-04-15,Argentina,7,160,2432,"rgb(139, 224, 164)"
1191,2020-04-16,Argentina,4,0,2432,"rgb(139, 224, 164)"
1192,2020-04-17,Argentina,6,128,2560,"rgb(139, 224, 164)"
1193,2020-04-18,Argentina,7,98,2658,"rgb(139, 224, 164)"
1194,2020-04-19,Argentina,10,170,2828,"rgb(139, 224, 164)"
1195,2020-04-20,Argentina,2,102,2930,"rgb(139, 224, 164)"
1196,2020-04-21,Argentina,8,90,3020,"rgb(139, 224, 164)"
1197,2020-04-22,Argentina,9,112,3132,"rgb(139, 224, 164)"
1198,2020-04-23,Argentina,8,144,3276,"rgb(139, 224, 164)"
1199,2020-04-24,Argentina,6,147,3423,"rgb(139, 224, 164)"
1200,2020-04-25,Argentina,2,0,3423,"rgb(139, 224, 164)"
1201,2020-04-26,Argentina,18,344,3767,"rgb(139, 224, 164)"
1202,2020-04-27,Argentina,1,0,3767,"rgb(139, 224, 164)"
1203,2020-04-28,Argentina,11,223,3990,"rgb(139, 224, 164)"
1204,2020-04-29,Argentina,10,124,4114,"rgb(139, 224, 164)"
1205,2020-04-30,Argentina,7,158,4272,"rgb(139, 224, 164)"
1206,2020-05-01,Argentina,4,143,4415,"rgb(139, 224, 164)"
1207,2020-05-02,Argentina,7,104,4519,"rgb(139, 224, 164)"
1208,2020-05-03,Argentina,12,149,4668,"rgb(139, 224, 164)"
1209,2020-05-04,Argentina,9,102,4770,"rgb(139, 224, 164)"
1210,2020-05-05,Argentina,14,104,4874,"rgb(139, 224, 164)"
1211,2020-05-06,Argentina,4,133,5007,"rgb(139, 224, 164)"
1212,2020-05-07,Argentina,9,188,5195,"rgb(139, 224, 164)"
1213,2020-05-08,Argentina,9,163,5358,"rgb(139, 224, 164)"
1214,2020-05-09,Argentina,11,240,5598,"rgb(139, 224, 164)"
1215,2020-05-10,Argentina,7,165,5763,"rgb(139, 224, 164)"
1216,2020-05-11,Argentina,0,13,5776,"rgb(139, 224, 164)"
1217,2020-05-12,Argentina,5,245,6021,"rgb(139, 224, 164)"
1218,2020-05-13,Argentina,14,529,6550,"rgb(139, 224, 164)"
1219,2020-05-14,Argentina,10,316,6866,"rgb(139, 224, 164)"
1220,2020-05-15,Argentina,24,255,7121,"rgb(139, 224, 164)"
1221,2020-05-16,Argentina,3,345,7466,"rgb(139, 224, 164)"
1222,2020-05-17,Argentina,7,326,7792,"rgb(139, 224, 164)"
1223,2020-05-18,Argentina,3,0,7792,"rgb(139, 224, 164)"
1224,2020-05-19,Argentina,16,566,8358,"rgb(139, 224, 164)"
1225,2020-05-20,Argentina,11,438,8796,"rgb(139, 224, 164)"
1226,2020-05-21,Argentina,10,474,9270,"rgb(139, 224, 164)"
1227,2020-05-22,Argentina,13,648,9918,"rgb(139, 224, 164)"
1228,2020-05-23,Argentina,17,718,10636,"rgb(139, 224, 164)"
1229,2020-05-24,Argentina,12,704,11340,"rgb(139, 224, 164)"
1230,2020-05-25,Argentina,7,723,12063,"rgb(139, 224, 164)"
1231,2020-05-26,Argentina,15,552,12615,"rgb(139, 224, 164)"
1232,2020-05-27,Argentina,17,600,13215,"rgb(139, 224, 164)"
1233,2020-05-28,Argentina,16,705,13920,"rgb(139, 224, 164)"
1234,2020-05-29,Argentina,8,769,14689,"rgb(139, 224, 164)"
1235,2020-05-30,Argentina,12,717,15406,"rgb(139, 224, 164)"
1236,2020-05-31,Argentina,8,795,16201,"rgb(139, 224, 164)"
1237,2020-06-01,Argentina,11,637,16838,"rgb(139, 224, 164)"
1238,2020-06-02,Argentina,17,564,17402,"rgb(139, 224, 164)"
1239,2020-06-03,Argentina,13,904,18306,"rgb(139, 224, 164)"
1240,2020-06-04,Argentina,14,949,19255,"rgb(139, 224, 164)"
1241,2020-06-05,Argentina,5,0,19255,"rgb(139, 224, 164)"
1242,2020-06-06,Argentina,44,1769,21024,"rgb(139, 224, 164)"
1243,2020-06-07,Argentina,16,983,22007,"rgb(139, 224, 164)"
1244,2020-06-08,Argentina,16,774,22781,"rgb(139, 224, 164)"
1245,2020-06-09,Argentina,29,826,23607,"rgb(139, 224, 164)"
1246,2020-06-10,Argentina,24,1141,24748,"rgb(139, 224, 164)"
1247,2020-06-11,Argentina,18,1239,25987,"rgb(139, 224, 164)"
1248,2020-06-12,Argentina,30,1373,27360,"rgb(139, 224, 164)"
1249,2020-06-13,Argentina,20,1391,28751,"rgb(139, 224, 164)"
1250,2020-06-14,Argentina,30,1531,30282,"rgb(139, 224, 164)"
1251,2020-06-15,Argentina,18,1282,31564,"rgb(139, 224, 164)"
1252,2020-06-16,Argentina,21,1208,32772,"rgb(139, 224, 164)"
1253,2020-06-17,Argentina,24,1374,34146,"rgb(139, 224, 164)"
1254,2020-06-18,Argentina,35,1393,35539,"rgb(139, 224, 164)"
1255,2020-06-19,Argentina,16,0,35539,"rgb(139, 224, 164)"
1256,2020-06-20,Argentina,50,4018,39557,"rgb(139, 224, 164)"
1257,2020-06-21,Argentina,13,1634,41191,"rgb(139, 224, 164)"
1258,2020-06-22,Argentina,19,1581,42772,"rgb(139, 224, 164)"
1259,2020-06-23,Argentina,32,2146,44918,"rgb(139, 224, 164)"
1260,2020-06-24,Argentina,6,0,44918,"rgb(139, 224, 164)"
1261,2020-06-25,Argentina,36,4920,49838,"rgb(139, 224, 164)"
1262,2020-06-26,Argentina,39,2606,52444,"rgb(139, 224, 164)"
1263,2020-06-27,Argentina,43,0,52444,"rgb(139, 224, 164)"
1264,2020-06-28,Argentina,40,5287,57731,"rgb(139, 224, 164)"
1265,2020-06-29,Argentina,10,0,57731,"rgb(139, 224, 164)"
1266,2020-06-30,Argentina,63,4524,62255,"rgb(139, 224, 164)"
1267,2020-07-01,Argentina,27,2262,64517,"rgb(139, 224, 164)"
1268,2020-07-02,Argentina,44,2667,67184,"rgb(139, 224, 164)"
1269,2020-07-03,Argentina,34,2744,69928,"rgb(139, 224, 164)"
1270,2020-07-04,Argentina,52,2845,72773,"rgb(139, 224, 164)"
1271,2020-07-05,Argentina,16,0,72773,"rgb(139, 224, 164)"
1272,2020-07-06,Argentina,37,2590,75363,"rgb(139, 224, 164)"
1273,2020-07-07,Argentina,33,2439,77802,"rgb(139, 224, 164)"
1274,2020-07-08,Argentina,79,2632,80434,"rgb(139, 224, 164)"
1275,2020-07-09,Argentina,52,2979,83413,"rgb(139, 224, 164)"
1276,2020-07-10,Argentina,53,7267,90680,"rgb(139, 224, 164)"
1277,2020-07-11,Argentina,42,3367,94047,"rgb(139, 224, 164)"
1278,2020-07-12,Argentina,61,3462,97509,"rgb(139, 224, 164)"
1279,2020-07-13,Argentina,8,2644,100153,"rgb(139, 224, 164)"
1280,2019-12-31,Austria,0,0,0,"rgb(180, 151, 231)"
1281,2020-01-01,Austria,0,0,0,"rgb(180, 151, 231)"
1282,2020-01-02,Austria,0,0,0,"rgb(180, 151, 231)"
1283,2020-01-03,Austria,0,0,0,"rgb(180, 151, 231)"
1284,2020-01-04,Austria,0,0,0,"rgb(180, 151, 231)"
1285,2020-01-05,Austria,0,0,0,"rgb(180, 151, 231)"
1286,2020-01-06,Austria,0,0,0,"rgb(180, 151, 231)"
1287,2020-01-07,Austria,0,0,0,"rgb(180, 151, 231)"
1288,2020-01-08,Austria,0,0,0,"rgb(180, 151, 231)"
1289,2020-01-09,Austria,0,0,0,"rgb(180, 151, 231)"
1290,2020-01-10,Austria,0,0,0,"rgb(180, 151, 231)"
1291,2020-01-11,Austria,0,0,0,"rgb(180, 151, 231)"
1292,2020-01-12,Austria,0,0,0,"rgb(180, 151, 231)"
1293,2020-01-13,Austria,0,0,0,"rgb(180, 151, 231)"
1294,2020-01-14,Austria,0,0,0,"rgb(180, 151, 231)"
1295,2020-01-15,Austria,0,0,0,"rgb(180, 151, 231)"
1296,2020-01-16,Austria,0,0,0,"rgb(180, 151, 231)"
1297,2020-01-17,Austria,0,0,0,"rgb(180, 151, 231)"
1298,2020-01-18,Austria,0,0,0,"rgb(180, 151, 231)"
1299,2020-01-19,Austria,0,0,0,"rgb(180, 151, 231)"
1300,2020-01-20,Austria,0,0,0,"rgb(180, 151, 231)"
1301,2020-01-21,Austria,0,0,0,"rgb(180, 151, 231)"
1302,2020-01-22,Austria,0,0,0,"rgb(180, 151, 231)"
1303,2020-01-23,Austria,0,0,0,"rgb(180, 151, 231)"
1304,2020-01-24,Austria,0,0,0,"rgb(180, 151, 231)"
1305,2020-01-25,Austria,0,0,0,"rgb(180, 151, 231)"
1306,2020-01-26,Austria,0,0,0,"rgb(180, 151, 231)"
1307,2020-01-27,Austria,0,0,0,"rgb(180, 151, 231)"
1308,2020-01-28,Austria,0,0,0,"rgb(180, 151, 231)"
1309,2020-01-29,Austria,0,0,0,"rgb(180, 151, 231)"
1310,2020-01-30,Austria,0,0,0,"rgb(180, 151, 231)"
1311,2020-01-31,Austria,0,0,0,"rgb(180, 151, 231)"
1312,2020-02-01,Austria,0,0,0,"rgb(180, 151, 231)"
1313,2020-02-02,Austria,0,0,0,"rgb(180, 151, 231)"
1314,2020-02-03,Austria,0,0,0,"rgb(180, 151, 231)"
1315,2020-02-04,Austria,0,0,0,"rgb(180, 151, 231)"
1316,2020-02-05,Austria,0,0,0,"rgb(180, 151, 231)"
1317,2020-02-06,Austria,0,0,0,"rgb(180, 151, 231)"
1318,2020-02-07,Austria,0,0,0,"rgb(180, 151, 231)"
1319,2020-02-08,Austria,0,0,0,"rgb(180, 151, 231)"
1320,2020-02-09,Austria,0,0,0,"rgb(180, 151, 231)"
1321,2020-02-10,Austria,0,0,0,"rgb(180, 151, 231)"
1322,2020-02-11,Austria,0,0,0,"rgb(180, 151, 231)"
1323,2020-02-12,Austria,0,0,0,"rgb(180, 151, 231)"
1324,2020-02-13,Austria,0,0,0,"rgb(180, 151, 231)"
1325,2020-02-14,Austria,0,0,0,"rgb(180, 151, 231)"
1326,2020-02-15,Austria,0,0,0,"rgb(180, 151, 231)"
1327,2020-02-16,Austria,0,0,0,"rgb(180, 151, 231)"
1328,2020-02-17,Austria,0,0,0,"rgb(180, 151, 231)"
1329,2020-02-18,Austria,0,0,0,"rgb(180, 151, 231)"
1330,2020-02-19,Austria,0,0,0,"rgb(180, 151, 231)"
1331,2020-02-20,Austria,0,0,0,"rgb(180, 151, 231)"
1332,2020-02-21,Austria,0,0,0,"rgb(180, 151, 231)"
1333,2020-02-22,Austria,0,0,0,"rgb(180, 151, 231)"
1334,2020-02-23,Austria,0,0,0,"rgb(180, 151, 231)"
1335,2020-02-24,Austria,0,0,0,"rgb(180, 151, 231)"
1336,2020-02-25,Austria,0,0,0,"rgb(180, 151, 231)"
1337,2020-02-26,Austria,0,2,2,"rgb(180, 151, 231)"
1338,2020-02-27,Austria,0,0,2,"rgb(180, 151, 231)"
1339,2020-02-28,Austria,0,3,5,"rgb(180, 151, 231)"
1340,2020-02-29,Austria,0,2,7,"rgb(180, 151, 231)"
1341,2020-03-01,Austria,0,3,10,"rgb(180, 151, 231)"
1342,2020-03-02,Austria,0,4,14,"rgb(180, 151, 231)"
1343,2020-03-03,Austria,0,4,18,"rgb(180, 151, 231)"
1344,2020-03-04,Austria,0,6,24,"rgb(180, 151, 231)"
1345,2020-03-05,Austria,0,5,29,"rgb(180, 151, 231)"
1346,2020-03-06,Austria,0,12,41,"rgb(180, 151, 231)"
1347,2020-03-07,Austria,0,33,74,"rgb(180, 151, 231)"
1348,2020-03-08,Austria,0,25,99,"rgb(180, 151, 231)"
1349,2020-03-09,Austria,0,3,102,"rgb(180, 151, 231)"
1350,2020-03-10,Austria,0,29,131,"rgb(180, 151, 231)"
1351,2020-03-11,Austria,0,51,182,"rgb(180, 151, 231)"
1352,2020-03-12,Austria,0,64,246,"rgb(180, 151, 231)"
1353,2020-03-13,Austria,1,115,361,"rgb(180, 151, 231)"
1354,2020-03-14,Austria,0,143,504,"rgb(180, 151, 231)"
1355,2020-03-15,Austria,0,151,655,"rgb(180, 151, 231)"
1356,2020-03-16,Austria,0,205,860,"rgb(180, 151, 231)"
1357,2020-03-17,Austria,2,156,1016,"rgb(180, 151, 231)"
1358,2020-03-18,Austria,0,316,1332,"rgb(180, 151, 231)"
1359,2020-03-19,Austria,1,314,1646,"rgb(180, 151, 231)"
1360,2020-03-20,Austria,2,550,2196,"rgb(180, 151, 231)"
1361,2020-03-21,Austria,0,453,2649,"rgb(180, 151, 231)"
1362,2020-03-22,Austria,2,375,3024,"rgb(180, 151, 231)"
1363,2020-03-23,Austria,8,607,3631,"rgb(180, 151, 231)"
1364,2020-03-24,Austria,9,855,4486,"rgb(180, 151, 231)"
1365,2020-03-25,Austria,5,796,5282,"rgb(180, 151, 231)"
1366,2020-03-26,Austria,4,606,5888,"rgb(180, 151, 231)"
1367,2020-03-27,Austria,18,1141,7029,"rgb(180, 151, 231)"
1368,2020-03-28,Austria,16,668,7697,"rgb(180, 151, 231)"
1369,2020-03-29,Austria,0,594,8291,"rgb(180, 151, 231)"
1370,2020-03-30,Austria,18,522,8813,"rgb(180, 151, 231)"
1371,2020-03-31,Austria,22,805,9618,"rgb(180, 151, 231)"
1372,2020-04-01,Austria,20,564,10182,"rgb(180, 151, 231)"
1373,2020-04-02,Austria,18,529,10711,"rgb(180, 151, 231)"
1374,2020-04-03,Austria,12,418,11129,"rgb(180, 151, 231)"
1375,2020-04-04,Austria,10,396,11525,"rgb(180, 151, 231)"
1376,2020-04-05,Austria,18,241,11766,"rgb(180, 151, 231)"
1377,2020-04-06,Austria,18,217,11983,"rgb(180, 151, 231)"
1378,2020-04-07,Austria,16,314,12297,"rgb(180, 151, 231)"
1379,2020-04-08,Austria,23,343,12640,"rgb(180, 151, 231)"
1380,2020-04-09,Austria,30,329,12969,"rgb(180, 151, 231)"
1381,2020-04-10,Austria,22,279,13248,"rgb(180, 151, 231)"
1382,2020-04-11,Austria,24,312,13560,"rgb(180, 151, 231)"
1383,2020-04-12,Austria,18,247,13807,"rgb(180, 151, 231)"
1384,2020-04-13,Austria,13,130,13937,"rgb(180, 151, 231)"
1385,2020-04-14,Austria,18,106,14043,"rgb(180, 151, 231)"
1386,2020-04-15,Austria,16,191,14234,"rgb(180, 151, 231)"
1387,2020-04-16,Austria,9,136,14370,"rgb(180, 151, 231)"
1388,2020-04-17,Austria,17,78,14448,"rgb(180, 151, 231)"
1389,2020-04-18,Austria,21,155,14603,"rgb(180, 151, 231)"
1390,2020-04-19,Austria,12,59,14662,"rgb(180, 151, 231)"
1391,2020-04-20,Austria,9,48,14710,"rgb(180, 151, 231)"
1392,2020-04-21,Austria,10,73,14783,"rgb(180, 151, 231)"
1393,2020-04-22,Austria,1,50,14833,"rgb(180, 151, 231)"
1394,2020-04-23,Austria,31,91,14924,"rgb(180, 151, 231)"
1395,2020-04-24,Austria,14,61,14985,"rgb(180, 151, 231)"
1396,2020-04-25,Austria,5,83,15068,"rgb(180, 151, 231)"
1397,2020-04-26,Austria,23,66,15134,"rgb(180, 151, 231)"
1398,2020-04-27,Austria,6,55,15189,"rgb(180, 151, 231)"
1399,2020-04-28,Austria,7,67,15256,"rgb(180, 151, 231)"
1400,2020-04-29,Austria,20,58,15314,"rgb(180, 151, 231)"
1401,2020-04-30,Austria,11,50,15364,"rgb(180, 151, 231)"
1402,2020-05-01,Austria,4,60,15424,"rgb(180, 151, 231)"
1403,2020-05-02,Austria,5,34,15458,"rgb(180, 151, 231)"
1404,2020-05-03,Austria,7,12,15470,"rgb(180, 151, 231)"
1405,2020-05-04,Austria,2,68,15538,"rgb(180, 151, 231)"
1406,2020-05-05,Austria,2,31,15569,"rgb(180, 151, 231)"
1407,2020-05-06,Austria,6,17,15586,"rgb(180, 151, 231)"
1408,2020-05-07,Austria,2,65,15651,"rgb(180, 151, 231)"
1409,2020-05-08,Austria,1,22,15673,"rgb(180, 151, 231)"
1410,2020-05-09,Austria,5,62,15735,"rgb(180, 151, 231)"
1411,2020-05-10,Austria,1,42,15777,"rgb(180, 151, 231)"
1412,2020-05-11,Austria,3,10,15787,"rgb(180, 151, 231)"
1413,2020-05-12,Austria,2,87,15874,"rgb(180, 151, 231)"
1414,2020-05-13,Austria,3,36,15910,"rgb(180, 151, 231)"
1415,2020-05-14,Austria,1,54,15964,"rgb(180, 151, 231)"
1416,2020-05-15,Austria,2,41,16005,"rgb(180, 151, 231)"
1417,2020-05-16,Austria,2,63,16068,"rgb(180, 151, 231)"
1418,2020-05-17,Austria,0,72,16140,"rgb(180, 151, 231)"
1419,2020-05-18,Austria,1,14,16154,"rgb(180, 151, 231)"
1420,2020-05-19,Austria,0,25,16179,"rgb(180, 151, 231)"
1421,2020-05-20,Austria,3,78,16257,"rgb(180, 151, 231)"
1422,2020-05-21,Austria,1,18,16275,"rgb(180, 151, 231)"
1423,2020-05-22,Austria,0,57,16332,"rgb(180, 151, 231)"
1424,2020-05-23,Austria,2,29,16361,"rgb(180, 151, 231)"
1425,2020-05-24,Austria,4,46,16407,"rgb(180, 151, 231)"
1426,2020-05-25,Austria,1,32,16439,"rgb(180, 151, 231)"
1427,2020-05-26,Austria,1,20,16459,"rgb(180, 151, 231)"
1428,2020-05-27,Austria,2,38,16497,"rgb(180, 151, 231)"
1429,2020-05-28,Austria,2,18,16515,"rgb(180, 151, 231)"
1430,2020-05-29,Austria,23,28,16543,"rgb(180, 151, 231)"
1431,2020-05-30,Austria,0,51,16594,"rgb(180, 151, 231)"
1432,2020-05-31,Austria,0,44,16638,"rgb(180, 151, 231)"
1433,2020-06-01,Austria,0,4,16642,"rgb(180, 151, 231)"
1434,2020-06-02,Austria,0,21,16663,"rgb(180, 151, 231)"
1435,2020-06-03,Austria,1,11,16674,"rgb(180, 151, 231)"
1436,2020-06-04,Austria,1,31,16705,"rgb(180, 151, 231)"
1437,2020-06-05,Austria,0,36,16741,"rgb(180, 151, 231)"
1438,2020-06-06,Austria,2,62,16803,"rgb(180, 151, 231)"
1439,2020-06-07,Austria,0,19,16822,"rgb(180, 151, 231)"
1440,2020-06-08,Austria,0,46,16868,"rgb(180, 151, 231)"
1441,2020-06-09,Austria,0,21,16889,"rgb(180, 151, 231)"
1442,2020-06-10,Austria,0,13,16902,"rgb(180, 151, 231)"
1443,2020-06-11,Austria,1,34,16936,"rgb(180, 151, 231)"
1444,2020-06-12,Austria,1,28,16964,"rgb(180, 151, 231)"
1445,2020-06-13,Austria,1,30,16994,"rgb(180, 151, 231)"
1446,2020-06-14,Austria,2,20,17014,"rgb(180, 151, 231)"
1447,2020-06-15,Austria,0,24,17038,"rgb(180, 151, 231)"
1448,2020-06-16,Austria,1,27,17065,"rgb(180, 151, 231)"
1449,2020-06-17,Austria,3,33,17098,"rgb(180, 151, 231)"
1450,2020-06-18,Austria,6,17,17115,"rgb(180, 151, 231)"
1451,2020-06-19,Austria,1,40,17155,"rgb(180, 151, 231)"
1452,2020-06-20,Austria,0,30,17185,"rgb(180, 151, 231)"
1453,2020-06-21,Austria,0,62,17247,"rgb(180, 151, 231)"
1454,2020-06-22,Austria,2,38,17285,"rgb(180, 151, 231)"
1455,2020-06-23,Austria,0,35,17320,"rgb(180, 151, 231)"
1456,2020-06-24,Austria,3,31,17351,"rgb(180, 151, 231)"
1457,2020-06-25,Austria,0,33,17384,"rgb(180, 151, 231)"
1458,2020-06-26,Austria,5,47,17431,"rgb(180, 151, 231)"
1459,2020-06-27,Austria,0,67,17498,"rgb(180, 151, 231)"
1460,2020-06-28,Austria,2,64,17562,"rgb(180, 151, 231)"
1461,2020-06-29,Austria,2,63,17625,"rgb(180, 151, 231)"
1462,2020-06-30,Austria,1,41,17666,"rgb(180, 151, 231)"
1463,2020-07-01,Austria,2,111,17777,"rgb(180, 151, 231)"
1464,2020-07-02,Austria,0,37,17814,"rgb(180, 151, 231)"
1465,2020-07-03,Austria,0,138,17952,"rgb(180, 151, 231)"
1466,2020-07-04,Austria,0,121,18073,"rgb(180, 151, 231)"
1467,2020-07-05,Austria,0,123,18196,"rgb(180, 151, 231)"
1468,2020-07-06,Austria,1,73,18269,"rgb(180, 151, 231)"
1469,2020-07-07,Austria,0,57,18326,"rgb(180, 151, 231)"
1470,2020-07-08,Austria,0,89,18415,"rgb(180, 151, 231)"
1471,2020-07-09,Austria,0,101,18516,"rgb(180, 151, 231)"
1472,2020-07-10,Austria,0,97,18613,"rgb(180, 151, 231)"
1473,2020-07-11,Austria,0,74,18687,"rgb(180, 151, 231)"
1474,2020-07-12,Austria,0,108,18795,"rgb(180, 151, 231)"
1475,2020-07-13,Austria,2,52,18847,"rgb(180, 151, 231)"
1476,2019-12-31,Australia,0,0,0,"rgb(179, 179, 179)"
1477,2020-01-01,Australia,0,0,0,"rgb(179, 179, 179)"
1478,2020-01-02,Australia,0,0,0,"rgb(179, 179, 179)"
1479,2020-01-03,Australia,0,0,0,"rgb(179, 179, 179)"
1480,2020-01-04,Australia,0,0,0,"rgb(179, 179, 179)"
1481,2020-01-05,Australia,0,0,0,"rgb(179, 179, 179)"
1482,2020-01-06,Australia,0,0,0,"rgb(179, 179, 179)"
1483,2020-01-07,Australia,0,0,0,"rgb(179, 179, 179)"
1484,2020-01-08,Australia,0,0,0,"rgb(179, 179, 179)"
1485,2020-01-09,Australia,0,0,0,"rgb(179, 179, 179)"
1486,2020-01-10,Australia,0,0,0,"rgb(179, 179, 179)"
1487,2020-01-11,Australia,0,0,0,"rgb(179, 179, 179)"
1488,2020-01-12,Australia,0,0,0,"rgb(179, 179, 179)"
1489,2020-01-13,Australia,0,0,0,"rgb(179, 179, 179)"
1490,2020-01-14,Australia,0,0,0,"rgb(179, 179, 179)"
1491,2020-01-15,Australia,0,0,0,"rgb(179, 179, 179)"
1492,2020-01-16,Australia,0,0,0,"rgb(179, 179, 179)"
1493,2020-01-17,Australia,0,0,0,"rgb(179, 179, 179)"
1494,2020-01-18,Australia,0,0,0,"rgb(179, 179, 179)"
1495,2020-01-19,Australia,0,0,0,"rgb(179, 179, 179)"
1496,2020-01-20,Australia,0,0,0,"rgb(179, 179, 179)"
1497,2020-01-21,Australia,0,0,0,"rgb(179, 179, 179)"
1498,2020-01-22,Australia,0,0,0,"rgb(179, 179, 179)"
1499,2020-01-23,Australia,0,0,0,"rgb(179, 179, 179)"
1500,2020-01-24,Australia,0,0,0,"rgb(179, 179, 179)"
1501,2020-01-25,Australia,0,1,1,"rgb(179, 179, 179)"
1502,2020-01-26,Australia,0,3,4,"rgb(179, 179, 179)"
1503,2020-01-27,Australia,0,0,4,"rgb(179, 179, 179)"
1504,2020-01-28,Australia,0,0,4,"rgb(179, 179, 179)"
1505,2020-01-29,Australia,0,0,4,"rgb(179, 179, 179)"
1506,2020-01-30,Australia,0,2,6,"rgb(179, 179, 179)"
1507,2020-01-31,Australia,0,1,7,"rgb(179, 179, 179)"
1508,2020-02-01,Australia,0,2,9,"rgb(179, 179, 179)"
1509,2020-02-02,Australia,0,2,11,"rgb(179, 179, 179)"
1510,2020-02-03,Australia,0,0,11,"rgb(179, 179, 179)"
1511,2020-02-04,Australia,0,0,11,"rgb(179, 179, 179)"
1512,2020-02-05,Australia,0,1,12,"rgb(179, 179, 179)"
1513,2020-02-06,Australia,0,1,13,"rgb(179, 179, 179)"
1514,2020-02-07,Australia,0,1,14,"rgb(179, 179, 179)"
1515,2020-02-08,Australia,0,0,14,"rgb(179, 179, 179)"
1516,2020-02-09,Australia,0,0,14,"rgb(179, 179, 179)"
1517,2020-02-10,Australia,0,0,14,"rgb(179, 179, 179)"
1518,2020-02-11,Australia,0,0,14,"rgb(179, 179, 179)"
1519,2020-02-12,Australia,0,0,14,"rgb(179, 179, 179)"
1520,2020-02-13,Australia,0,0,14,"rgb(179, 179, 179)"
1521,2020-02-14,Australia,0,1,15,"rgb(179, 179, 179)"
1522,2020-02-15,Australia,0,0,15,"rgb(179, 179, 179)"
1523,2020-02-16,Australia,0,0,15,"rgb(179, 179, 179)"
1524,2020-02-17,Australia,0,0,15,"rgb(179, 179, 179)"
1525,2020-02-18,Australia,0,0,15,"rgb(179, 179, 179)"
1526,2020-02-19,Australia,0,0,15,"rgb(179, 179, 179)"
1527,2020-02-20,Australia,0,0,15,"rgb(179, 179, 179)"
1528,2020-02-21,Australia,0,2,17,"rgb(179, 179, 179)"
1529,2020-02-22,Australia,0,4,21,"rgb(179, 179, 179)"
1530,2020-02-23,Australia,0,1,22,"rgb(179, 179, 179)"
1531,2020-02-24,Australia,0,0,22,"rgb(179, 179, 179)"
1532,2020-02-25,Australia,0,0,22,"rgb(179, 179, 179)"
1533,2020-02-26,Australia,0,0,22,"rgb(179, 179, 179)"
1534,2020-02-27,Australia,0,1,23,"rgb(179, 179, 179)"
1535,2020-02-28,Australia,0,0,23,"rgb(179, 179, 179)"
1536,2020-02-29,Australia,0,2,25,"rgb(179, 179, 179)"
1537,2020-03-01,Australia,1,1,26,"rgb(179, 179, 179)"
1538,2020-03-02,Australia,0,3,29,"rgb(179, 179, 179)"
1539,2020-03-03,Australia,0,4,33,"rgb(179, 179, 179)"
1540,2020-03-04,Australia,0,8,41,"rgb(179, 179, 179)"
1541,2020-03-05,Australia,1,11,52,"rgb(179, 179, 179)"
1542,2020-03-06,Australia,0,7,59,"rgb(179, 179, 179)"
1543,2020-03-07,Australia,0,4,63,"rgb(179, 179, 179)"
1544,2020-03-08,Australia,1,11,74,"rgb(179, 179, 179)"
1545,2020-03-09,Australia,0,6,80,"rgb(179, 179, 179)"
1546,2020-03-10,Australia,0,20,100,"rgb(179, 179, 179)"
1547,2020-03-11,Australia,0,12,112,"rgb(179, 179, 179)"
1548,2020-03-12,Australia,0,14,126,"rgb(179, 179, 179)"
1549,2020-03-13,Australia,0,30,156,"rgb(179, 179, 179)"
1550,2020-03-14,Australia,0,41,197,"rgb(179, 179, 179)"
1551,2020-03-15,Australia,0,52,249,"rgb(179, 179, 179)"
1552,2020-03-16,Australia,2,49,298,"rgb(179, 179, 179)"
1553,2020-03-17,Australia,0,77,375,"rgb(179, 179, 179)"
1554,2020-03-18,Australia,0,79,454,"rgb(179, 179, 179)"
1555,2020-03-19,Australia,1,111,565,"rgb(179, 179, 179)"
1556,2020-03-20,Australia,0,144,709,"rgb(179, 179, 179)"
1557,2020-03-21,Australia,1,165,874,"rgb(179, 179, 179)"
1558,2020-03-22,Australia,0,224,1098,"rgb(179, 179, 179)"
1559,2020-03-23,Australia,0,611,1709,"rgb(179, 179, 179)"
1560,2020-03-24,Australia,0,114,1823,"rgb(179, 179, 179)"
1561,2020-03-25,Australia,1,600,2423,"rgb(179, 179, 179)"
1562,2020-03-26,Australia,3,376,2799,"rgb(179, 179, 179)"
1563,2020-03-27,Australia,2,367,3166,"rgb(179, 179, 179)"
1564,2020-03-28,Australia,0,212,3378,"rgb(179, 179, 179)"
1565,2020-03-29,Australia,1,431,3809,"rgb(179, 179, 179)"
1566,2020-03-30,Australia,2,284,4093,"rgb(179, 179, 179)"
1567,2020-03-31,Australia,3,464,4557,"rgb(179, 179, 179)"
1568,2020-04-01,Australia,1,150,4707,"rgb(179, 179, 179)"
1569,2020-04-02,Australia,1,269,4976,"rgb(179, 179, 179)"
1570,2020-04-03,Australia,2,248,5224,"rgb(179, 179, 179)"
1571,2020-04-04,Australia,7,324,5548,"rgb(179, 179, 179)"
1572,2020-04-05,Australia,4,139,5687,"rgb(179, 179, 179)"
1573,2020-04-06,Australia,2,57,5744,"rgb(179, 179, 179)"
1574,2020-04-07,Australia,6,100,5844,"rgb(179, 179, 179)"
1575,2020-04-08,Australia,3,112,5956,"rgb(179, 179, 179)"
1576,2020-04-09,Australia,5,96,6052,"rgb(179, 179, 179)"
1577,2020-04-10,Australia,2,100,6152,"rgb(179, 179, 179)"
1578,2020-04-11,Australia,2,86,6238,"rgb(179, 179, 179)"
1579,2020-04-12,Australia,3,51,6289,"rgb(179, 179, 179)"
1580,2020-04-13,Australia,4,33,6322,"rgb(179, 179, 179)"
1581,2020-04-14,Australia,0,44,6366,"rgb(179, 179, 179)"
1582,2020-04-15,Australia,0,50,6416,"rgb(179, 179, 179)"
1583,2020-04-16,Australia,2,42,6458,"rgb(179, 179, 179)"
1584,2020-04-17,Australia,0,39,6497,"rgb(179, 179, 179)"
1585,2020-04-18,Australia,4,36,6533,"rgb(179, 179, 179)"
1586,2020-04-19,Australia,2,53,6586,"rgb(179, 179, 179)"
1587,2020-04-20,Australia,1,26,6612,"rgb(179, 179, 179)"
1588,2020-04-21,Australia,1,13,6625,"rgb(179, 179, 179)"
1589,2020-04-22,Australia,3,22,6647,"rgb(179, 179, 179)"
1590,2020-04-23,Australia,0,7,6654,"rgb(179, 179, 179)"
1591,2020-04-24,Australia,1,13,6667,"rgb(179, 179, 179)"
1592,2020-04-25,Australia,4,20,6687,"rgb(179, 179, 179)"
1593,2020-04-26,Australia,2,16,6703,"rgb(179, 179, 179)"
1594,2020-04-27,Australia,2,10,6713,"rgb(179, 179, 179)"
1595,2020-04-28,Australia,1,12,6725,"rgb(179, 179, 179)"
1596,2020-04-29,Australia,4,13,6738,"rgb(179, 179, 179)"
1597,2020-04-30,Australia,2,8,6746,"rgb(179, 179, 179)"
1598,2020-05-01,Australia,2,16,6762,"rgb(179, 179, 179)"
1599,2020-05-02,Australia,1,5,6767,"rgb(179, 179, 179)"
1600,2020-05-03,Australia,0,16,6783,"rgb(179, 179, 179)"
1601,2020-05-04,Australia,2,18,6801,"rgb(179, 179, 179)"
1602,2020-05-05,Australia,0,24,6825,"rgb(179, 179, 179)"
1603,2020-05-06,Australia,1,24,6849,"rgb(179, 179, 179)"
1604,2020-05-07,Australia,1,26,6875,"rgb(179, 179, 179)"
1605,2020-05-08,Australia,0,21,6896,"rgb(179, 179, 179)"
1606,2020-05-09,Australia,0,18,6914,"rgb(179, 179, 179)"
1607,2020-05-10,Australia,0,15,6929,"rgb(179, 179, 179)"
1608,2020-05-11,Australia,0,12,6941,"rgb(179, 179, 179)"
1609,2020-05-12,Australia,0,7,6948,"rgb(179, 179, 179)"
1610,2020-05-13,Australia,0,16,6964,"rgb(179, 179, 179)"
1611,2020-05-14,Australia,1,11,6975,"rgb(179, 179, 179)"
1612,2020-05-15,Australia,0,14,6989,"rgb(179, 179, 179)"
1613,2020-05-16,Australia,0,30,7019,"rgb(179, 179, 179)"
1614,2020-05-17,Australia,0,17,7036,"rgb(179, 179, 179)"
1615,2020-05-18,Australia,0,9,7045,"rgb(179, 179, 179)"
1616,2020-05-19,Australia,1,15,7060,"rgb(179, 179, 179)"
1617,2020-05-20,Australia,0,8,7068,"rgb(179, 179, 179)"
1618,2020-05-21,Australia,1,11,7079,"rgb(179, 179, 179)"
1619,2020-05-22,Australia,0,2,7081,"rgb(179, 179, 179)"
1620,2020-05-23,Australia,1,14,7095,"rgb(179, 179, 179)"
1621,2020-05-24,Australia,1,11,7106,"rgb(179, 179, 179)"
1622,2020-05-25,Australia,0,3,7109,"rgb(179, 179, 179)"
1623,2020-05-26,Australia,0,9,7118,"rgb(179, 179, 179)"
1624,2020-05-27,Australia,0,15,7133,"rgb(179, 179, 179)"
1625,2020-05-28,Australia,0,6,7139,"rgb(179, 179, 179)"
1626,2020-05-29,Australia,0,11,7150,"rgb(179, 179, 179)"
1627,2020-05-30,Australia,0,23,7173,"rgb(179, 179, 179)"
1628,2020-05-31,Australia,0,12,7185,"rgb(179, 179, 179)"
1629,2020-06-01,Australia,0,10,7195,"rgb(179, 179, 179)"
1630,2020-06-02,Australia,0,9,7204,"rgb(179, 179, 179)"
1631,2020-06-03,Australia,0,17,7221,"rgb(179, 179, 179)"
1632,2020-06-04,Australia,0,8,7229,"rgb(179, 179, 179)"
1633,2020-06-05,Australia,0,11,7240,"rgb(179, 179, 179)"
1634,2020-06-06,Australia,0,11,7251,"rgb(179, 179, 179)"
1635,2020-06-07,Australia,0,4,7255,"rgb(179, 179, 179)"
1636,2020-06-08,Australia,0,5,7260,"rgb(179, 179, 179)"
1637,2020-06-09,Australia,0,5,7265,"rgb(179, 179, 179)"
1638,2020-06-10,Australia,0,2,7267,"rgb(179, 179, 179)"
1639,2020-06-11,Australia,0,9,7276,"rgb(179, 179, 179)"
1640,2020-06-12,Australia,0,9,7285,"rgb(179, 179, 179)"
1641,2020-06-13,Australia,0,5,7290,"rgb(179, 179, 179)"
1642,2020-06-14,Australia,0,12,7302,"rgb(179, 179, 179)"
1643,2020-06-15,Australia,0,18,7320,"rgb(179, 179, 179)"
1644,2020-06-16,Australia,0,15,7335,"rgb(179, 179, 179)"
1645,2020-06-17,Australia,0,12,7347,"rgb(179, 179, 179)"
1646,2020-06-18,Australia,0,23,7370,"rgb(179, 179, 179)"
1647,2020-06-19,Australia,0,21,7391,"rgb(179, 179, 179)"
1648,2020-06-20,Australia,0,18,7409,"rgb(179, 179, 179)"
1649,2020-06-21,Australia,0,27,7436,"rgb(179, 179, 179)"
1650,2020-06-22,Australia,0,25,7461,"rgb(179, 179, 179)"
1651,2020-06-23,Australia,0,13,7474,"rgb(179, 179, 179)"
1652,2020-06-24,Australia,0,18,7492,"rgb(179, 179, 179)"
1653,2020-06-25,Australia,1,29,7521,"rgb(179, 179, 179)"
1654,2020-06-26,Australia,1,37,7558,"rgb(179, 179, 179)"
1655,2020-06-27,Australia,0,37,7595,"rgb(179, 179, 179)"
1656,2020-06-28,Australia,0,46,7641,"rgb(179, 179, 179)"
1657,2020-06-29,Australia,0,45,7686,"rgb(179, 179, 179)"
1658,2020-06-30,Australia,0,81,7767,"rgb(179, 179, 179)"
1659,2020-07-01,Australia,0,67,7834,"rgb(179, 179, 179)"
1660,2020-07-02,Australia,0,86,7920,"rgb(179, 179, 179)"
1661,2020-07-03,Australia,0,81,8001,"rgb(179, 179, 179)"
1662,2020-07-04,Australia,0,254,8255,"rgb(179, 179, 179)"
1663,2020-07-05,Australia,0,107,8362,"rgb(179, 179, 179)"
1664,2020-07-06,Australia,0,87,8449,"rgb(179, 179, 179)"
1665,2020-07-07,Australia,2,137,8586,"rgb(179, 179, 179)"
1666,2020-07-08,Australia,0,169,8755,"rgb(179, 179, 179)"
1667,2020-07-09,Australia,0,131,8886,"rgb(179, 179, 179)"
1668,2020-07-10,Australia,0,173,9059,"rgb(179, 179, 179)"
1669,2020-07-11,Australia,0,300,9359,"rgb(179, 179, 179)"
1670,2020-07-12,Australia,1,194,9553,"rgb(179, 179, 179)"
1671,2020-07-13,Australia,1,244,9797,"rgb(179, 179, 179)"
1672,2020-03-13,Aruba,0,2,2,"rgb(229, 134, 6)"
1673,2020-03-20,Aruba,0,2,4,"rgb(229, 134, 6)"
1674,2020-03-24,Aruba,0,8,12,"rgb(229, 134, 6)"
1675,2020-03-25,Aruba,0,5,17,"rgb(229, 134, 6)"
1676,2020-03-26,Aruba,0,2,19,"rgb(229, 134, 6)"
1677,2020-03-27,Aruba,0,9,28,"rgb(229, 134, 6)"
1678,2020-03-28,Aruba,0,0,28,"rgb(229, 134, 6)"
1679,2020-03-29,Aruba,0,0,28,"rgb(229, 134, 6)"
1680,2020-03-30,Aruba,0,22,50,"rgb(229, 134, 6)"
1681,2020-04-01,Aruba,0,5,55,"rgb(229, 134, 6)"
1682,2020-04-02,Aruba,0,0,55,"rgb(229, 134, 6)"
1683,2020-04-03,Aruba,0,5,60,"rgb(229, 134, 6)"
1684,2020-04-04,Aruba,0,2,62,"rgb(229, 134, 6)"
1685,2020-04-05,Aruba,0,2,64,"rgb(229, 134, 6)"
1686,2020-04-06,Aruba,0,0,64,"rgb(229, 134, 6)"
1687,2020-04-07,Aruba,0,7,71,"rgb(229, 134, 6)"
1688,2020-04-08,Aruba,0,3,74,"rgb(229, 134, 6)"
1689,2020-04-09,Aruba,0,3,77,"rgb(229, 134, 6)"
1690,2020-04-10,Aruba,0,5,82,"rgb(229, 134, 6)"
1691,2020-04-11,Aruba,0,4,86,"rgb(229, 134, 6)"
1692,2020-04-12,Aruba,0,6,92,"rgb(229, 134, 6)"
1693,2020-04-13,Aruba,0,0,92,"rgb(229, 134, 6)"
1694,2020-04-14,Aruba,0,0,92,"rgb(229, 134, 6)"
1695,2020-04-15,Aruba,0,0,92,"rgb(229, 134, 6)"
1696,2020-04-16,Aruba,1,1,93,"rgb(229, 134, 6)"
1697,2020-04-17,Aruba,0,2,95,"rgb(229, 134, 6)"
1698,2020-04-18,Aruba,1,1,96,"rgb(229, 134, 6)"
1699,2020-04-19,Aruba,0,0,96,"rgb(229, 134, 6)"
1700,2020-04-20,Aruba,0,1,97,"rgb(229, 134, 6)"
1701,2020-04-21,Aruba,0,0,97,"rgb(229, 134, 6)"
1702,2020-04-22,Aruba,0,0,97,"rgb(229, 134, 6)"
1703,2020-04-23,Aruba,0,3,100,"rgb(229, 134, 6)"
1704,2020-04-24,Aruba,0,0,100,"rgb(229, 134, 6)"
1705,2020-04-25,Aruba,0,0,100,"rgb(229, 134, 6)"
1706,2020-04-26,Aruba,0,0,100,"rgb(229, 134, 6)"
1707,2020-04-27,Aruba,0,0,100,"rgb(229, 134, 6)"
1708,2020-04-28,Aruba,0,0,100,"rgb(229, 134, 6)"
1709,2020-04-29,Aruba,0,0,100,"rgb(229, 134, 6)"
1710,2020-04-30,Aruba,0,0,100,"rgb(229, 134, 6)"
1711,2020-05-01,Aruba,0,0,100,"rgb(229, 134, 6)"
1712,2020-05-02,Aruba,0,0,100,"rgb(229, 134, 6)"
1713,2020-05-03,Aruba,0,0,100,"rgb(229, 134, 6)"
1714,2020-05-04,Aruba,0,0,100,"rgb(229, 134, 6)"
1715,2020-05-05,Aruba,0,0,100,"rgb(229, 134, 6)"
1716,2020-05-06,Aruba,0,0,100,"rgb(229, 134, 6)"
1717,2020-05-07,Aruba,0,1,101,"rgb(229, 134, 6)"
1718,2020-05-08,Aruba,1,0,101,"rgb(229, 134, 6)"
1719,2020-05-09,Aruba,0,0,101,"rgb(229, 134, 6)"
1720,2020-05-10,Aruba,0,0,101,"rgb(229, 134, 6)"
1721,2020-05-11,Aruba,0,0,101,"rgb(229, 134, 6)"
1722,2020-05-12,Aruba,0,0,101,"rgb(229, 134, 6)"
1723,2020-05-13,Aruba,0,0,101,"rgb(229, 134, 6)"
1724,2020-05-14,Aruba,0,0,101,"rgb(229, 134, 6)"
1725,2020-05-15,Aruba,0,0,101,"rgb(229, 134, 6)"
1726,2020-05-16,Aruba,0,0,101,"rgb(229, 134, 6)"
1727,2020-05-17,Aruba,0,0,101,"rgb(229, 134, 6)"
1728,2020-05-18,Aruba,0,0,101,"rgb(229, 134, 6)"
1729,2020-05-19,Aruba,0,0,101,"rgb(229, 134, 6)"
1730,2020-05-20,Aruba,0,0,101,"rgb(229, 134, 6)"
1731,2020-05-21,Aruba,0,0,101,"rgb(229, 134, 6)"
1732,2020-05-22,Aruba,0,0,101,"rgb(229, 134, 6)"
1733,2020-05-23,Aruba,0,0,101,"rgb(229, 134, 6)"
1734,2020-05-24,Aruba,0,0,101,"rgb(229, 134, 6)"
1735,2020-05-25,Aruba,0,0,101,"rgb(229, 134, 6)"
1736,2020-05-26,Aruba,0,0,101,"rgb(229, 134, 6)"
1737,2020-05-27,Aruba,0,0,101,"rgb(229, 134, 6)"
1738,2020-05-28,Aruba,0,0,101,"rgb(229, 134, 6)"
1739,2020-05-29,Aruba,0,0,101,"rgb(229, 134, 6)"
1740,2020-05-30,Aruba,0,0,101,"rgb(229, 134, 6)"
1741,2020-05-31,Aruba,0,0,101,"rgb(229, 134, 6)"
1742,2020-06-01,Aruba,0,0,101,"rgb(229, 134, 6)"
1743,2020-06-02,Aruba,0,0,101,"rgb(229, 134, 6)"
1744,2020-06-03,Aruba,0,0,101,"rgb(229, 134, 6)"
1745,2020-06-04,Aruba,0,0,101,"rgb(229, 134, 6)"
1746,2020-06-05,Aruba,0,0,101,"rgb(229, 134, 6)"
1747,2020-06-06,Aruba,0,0,101,"rgb(229, 134, 6)"
1748,2020-06-07,Aruba,0,0,101,"rgb(229, 134, 6)"
1749,2020-06-08,Aruba,0,0,101,"rgb(229, 134, 6)"
1750,2020-06-09,Aruba,0,0,101,"rgb(229, 134, 6)"
1751,2020-06-10,Aruba,0,0,101,"rgb(229, 134, 6)"
1752,2020-06-11,Aruba,0,0,101,"rgb(229, 134, 6)"
1753,2020-06-12,Aruba,0,0,101,"rgb(229, 134, 6)"
1754,2020-06-13,Aruba,0,0,101,"rgb(229, 134, 6)"
1755,2020-06-14,Aruba,0,0,101,"rgb(229, 134, 6)"
1756,2020-06-15,Aruba,0,0,101,"rgb(229, 134, 6)"
1757,2020-06-16,Aruba,0,0,101,"rgb(229, 134, 6)"
1758,2020-06-17,Aruba,0,0,101,"rgb(229, 134, 6)"
1759,2020-06-18,Aruba,0,0,101,"rgb(229, 134, 6)"
1760,2020-06-19,Aruba,0,0,101,"rgb(229, 134, 6)"
1761,2020-06-20,Aruba,0,0,101,"rgb(229, 134, 6)"
1762,2020-06-21,Aruba,0,0,101,"rgb(229, 134, 6)"
1763,2020-06-22,Aruba,0,0,101,"rgb(229, 134, 6)"
1764,2020-06-23,Aruba,0,0,101,"rgb(229, 134, 6)"
1765,2020-06-24,Aruba,0,0,101,"rgb(229, 134, 6)"
1766,2020-06-25,Aruba,0,0,101,"rgb(229, 134, 6)"
1767,2020-06-26,Aruba,0,0,101,"rgb(229, 134, 6)"
1768,2020-06-27,Aruba,0,0,101,"rgb(229, 134, 6)"
1769,2020-06-28,Aruba,0,0,101,"rgb(229, 134, 6)"
1770,2020-06-29,Aruba,0,0,101,"rgb(229, 134, 6)"
1771,2020-06-30,Aruba,0,2,103,"rgb(229, 134, 6)"
1772,2020-07-01,Aruba,0,0,103,"rgb(229, 134, 6)"
1773,2020-07-02,Aruba,0,0,103,"rgb(229, 134, 6)"
1774,2020-07-03,Aruba,0,1,104,"rgb(229, 134, 6)"
1775,2020-07-04,Aruba,0,0,104,"rgb(229, 134, 6)"
1776,2020-07-05,Aruba,0,1,105,"rgb(229, 134, 6)"
1777,2020-07-06,Aruba,0,0,105,"rgb(229, 134, 6)"
1778,2020-07-07,Aruba,0,0,105,"rgb(229, 134, 6)"
1779,2020-07-08,Aruba,0,0,105,"rgb(229, 134, 6)"
1780,2020-07-09,Aruba,0,0,105,"rgb(229, 134, 6)"
1781,2020-07-10,Aruba,0,0,105,"rgb(229, 134, 6)"
1782,2020-07-11,Aruba,0,0,105,"rgb(229, 134, 6)"
1783,2020-07-12,Aruba,0,0,105,"rgb(229, 134, 6)"
1784,2020-07-13,Aruba,0,0,105,"rgb(229, 134, 6)"
1785,2019-12-31,Azerbaijan,0,0,0,"rgb(93, 105, 177)"
1786,2020-01-01,Azerbaijan,0,0,0,"rgb(93, 105, 177)"
1787,2020-01-02,Azerbaijan,0,0,0,"rgb(93, 105, 177)"
1788,2020-01-03,Azerbaijan,0,0,0,"rgb(93, 105, 177)"
1789,2020-01-04,Azerbaijan,0,0,0,"rgb(93, 105, 177)"
1790,2020-01-05,Azerbaijan,0,0,0,"rgb(93, 105, 177)"
1791,2020-01-06,Azerbaijan,0,0,0,"rgb(93, 105, 177)"
1792,2020-01-07,Azerbaijan,0,0,0,"rgb(93, 105, 177)"
1793,2020-01-08,Azerbaijan,0,0,0,"rgb(93, 105, 177)"
1794,2020-01-09,Azerbaijan,0,0,0,"rgb(93, 105, 177)"
1795,2020-01-10,Azerbaijan,0,0,0,"rgb(93, 105, 177)"
1796,2020-01-11,Azerbaijan,0,0,0,"rgb(93, 105, 177)"
1797,2020-01-12,Azerbaijan,0,0,0,"rgb(93, 105, 177)"
1798,2020-01-13,Azerbaijan,0,0,0,"rgb(93, 105, 177)"
1799,2020-01-14,Azerbaijan,0,0,0,"rgb(93, 105, 177)"
1800,2020-01-15,Azerbaijan,0,0,0,"rgb(93, 105, 177)"
1801,2020-01-16,Azerbaijan,0,0,0,"rgb(93, 105, 177)"
1802,2020-01-17,Azerbaijan,0,0,0,"rgb(93, 105, 177)"
1803,2020-01-18,Azerbaijan,0,0,0,"rgb(93, 105, 177)"
1804,2020-01-19,Azerbaijan,0,0,0,"rgb(93, 105, 177)"
1805,2020-01-20,Azerbaijan,0,0,0,"rgb(93, 105, 177)"
1806,2020-01-21,Azerbaijan,0,0,0,"rgb(93, 105, 177)"
1807,2020-01-22,Azerbaijan,0,0,0,"rgb(93, 105, 177)"
1808,2020-01-23,Azerbaijan,0,0,0,"rgb(93, 105, 177)"
1809,2020-01-24,Azerbaijan,0,0,0,"rgb(93, 105, 177)"
1810,2020-01-25,Azerbaijan,0,0,0,"rgb(93, 105, 177)"
1811,2020-01-26,Azerbaijan,0,0,0,"rgb(93, 105, 177)"
1812,2020-01-27,Azerbaijan,0,0,0,"rgb(93, 105, 177)"
1813,2020-01-28,Azerbaijan,0,0,0,"rgb(93, 105, 177)"
1814,2020-01-29,Azerbaijan,0,0,0,"rgb(93, 105, 177)"
1815,2020-01-30,Azerbaijan,0,0,0,"rgb(93, 105, 177)"
1816,2020-01-31,Azerbaijan,0,0,0,"rgb(93, 105, 177)"
1817,2020-02-01,Azerbaijan,0,0,0,"rgb(93, 105, 177)"
1818,2020-02-02,Azerbaijan,0,0,0,"rgb(93, 105, 177)"
1819,2020-02-03,Azerbaijan,0,0,0,"rgb(93, 105, 177)"
1820,2020-02-04,Azerbaijan,0,0,0,"rgb(93, 105, 177)"
1821,2020-02-05,Azerbaijan,0,0,0,"rgb(93, 105, 177)"
1822,2020-02-06,Azerbaijan,0,0,0,"rgb(93, 105, 177)"
1823,2020-02-07,Azerbaijan,0,0,0,"rgb(93, 105, 177)"
1824,2020-02-08,Azerbaijan,0,0,0,"rgb(93, 105, 177)"
1825,2020-02-09,Azerbaijan,0,0,0,"rgb(93, 105, 177)"
1826,2020-02-10,Azerbaijan,0,0,0,"rgb(93, 105, 177)"
1827,2020-02-11,Azerbaijan,0,0,0,"rgb(93, 105, 177)"
1828,2020-02-12,Azerbaijan,0,0,0,"rgb(93, 105, 177)"
1829,2020-02-13,Azerbaijan,0,0,0,"rgb(93, 105, 177)"
1830,2020-02-14,Azerbaijan,0,0,0,"rgb(93, 105, 177)"
1831,2020-02-15,Azerbaijan,0,0,0,"rgb(93, 105, 177)"
1832,2020-02-16,Azerbaijan,0,0,0,"rgb(93, 105, 177)"
1833,2020-02-17,Azerbaijan,0,0,0,"rgb(93, 105, 177)"
1834,2020-02-18,Azerbaijan,0,0,0,"rgb(93, 105, 177)"
1835,2020-02-19,Azerbaijan,0,0,0,"rgb(93, 105, 177)"
1836,2020-02-20,Azerbaijan,0,0,0,"rgb(93, 105, 177)"
1837,2020-02-21,Azerbaijan,0,0,0,"rgb(93, 105, 177)"
1838,2020-02-22,Azerbaijan,0,0,0,"rgb(93, 105, 177)"
1839,2020-02-23,Azerbaijan,0,0,0,"rgb(93, 105, 177)"
1840,2020-02-24,Azerbaijan,0,0,0,"rgb(93, 105, 177)"
1841,2020-02-25,Azerbaijan,0,0,0,"rgb(93, 105, 177)"
1842,2020-02-26,Azerbaijan,0,0,0,"rgb(93, 105, 177)"
1843,2020-02-27,Azerbaijan,0,0,0,"rgb(93, 105, 177)"
1844,2020-02-28,Azerbaijan,0,0,0,"rgb(93, 105, 177)"
1845,2020-02-29,Azerbaijan,0,1,1,"rgb(93, 105, 177)"
1846,2020-03-01,Azerbaijan,0,0,1,"rgb(93, 105, 177)"
1847,2020-03-02,Azerbaijan,0,2,3,"rgb(93, 105, 177)"
1848,2020-03-06,Azerbaijan,0,3,6,"rgb(93, 105, 177)"
1849,2020-03-07,Azerbaijan,0,3,9,"rgb(93, 105, 177)"
1850,2020-03-11,Azerbaijan,0,2,11,"rgb(93, 105, 177)"
1851,2020-03-12,Azerbaijan,0,2,13,"rgb(93, 105, 177)"
1852,2020-03-13,Azerbaijan,0,0,13,"rgb(93, 105, 177)"
1853,2020-03-15,Azerbaijan,0,6,19,"rgb(93, 105, 177)"
1854,2020-03-16,Azerbaijan,0,0,19,"rgb(93, 105, 177)"
1855,2020-03-17,Azerbaijan,0,0,19,"rgb(93, 105, 177)"
1856,2020-03-18,Azerbaijan,0,9,28,"rgb(93, 105, 177)"
1857,2020-03-19,Azerbaijan,0,6,34,"rgb(93, 105, 177)"
1858,2020-03-20,Azerbaijan,0,10,44,"rgb(93, 105, 177)"
1859,2020-03-21,Azerbaijan,1,0,44,"rgb(93, 105, 177)"
1860,2020-03-22,Azerbaijan,0,9,53,"rgb(93, 105, 177)"
1861,2020-03-23,Azerbaijan,0,12,65,"rgb(93, 105, 177)"
1862,2020-03-24,Azerbaijan,0,7,72,"rgb(93, 105, 177)"
1863,2020-03-25,Azerbaijan,0,15,87,"rgb(93, 105, 177)"
1864,2020-03-26,Azerbaijan,1,6,93,"rgb(93, 105, 177)"
1865,2020-03-27,Azerbaijan,1,29,122,"rgb(93, 105, 177)"
1866,2020-03-28,Azerbaijan,0,43,165,"rgb(93, 105, 177)"
1867,2020-03-29,Azerbaijan,1,17,182,"rgb(93, 105, 177)"
1868,2020-03-30,Azerbaijan,0,27,209,"rgb(93, 105, 177)"
1869,2020-03-31,Azerbaijan,0,64,273,"rgb(93, 105, 177)"
1870,2020-04-01,Azerbaijan,1,25,298,"rgb(93, 105, 177)"
1871,2020-04-02,Azerbaijan,0,61,359,"rgb(93, 105, 177)"
1872,2020-04-03,Azerbaijan,0,41,400,"rgb(93, 105, 177)"
1873,2020-04-04,Azerbaijan,0,43,443,"rgb(93, 105, 177)"
1874,2020-04-05,Azerbaijan,0,78,521,"rgb(93, 105, 177)"
1875,2020-04-06,Azerbaijan,2,63,584,"rgb(93, 105, 177)"
1876,2020-04-07,Azerbaijan,0,57,641,"rgb(93, 105, 177)"
1877,2020-04-08,Azerbaijan,1,76,717,"rgb(93, 105, 177)"
1878,2020-04-09,Azerbaijan,0,105,822,"rgb(93, 105, 177)"
1879,2020-04-10,Azerbaijan,1,104,926,"rgb(93, 105, 177)"
1880,2020-04-11,Azerbaijan,1,65,991,"rgb(93, 105, 177)"
1881,2020-04-12,Azerbaijan,1,67,1058,"rgb(93, 105, 177)"
1882,2020-04-13,Azerbaijan,0,40,1098,"rgb(93, 105, 177)"
1883,2020-04-14,Azerbaijan,1,50,1148,"rgb(93, 105, 177)"
1884,2020-04-15,Azerbaijan,1,49,1197,"rgb(93, 105, 177)"
1885,2020-04-16,Azerbaijan,0,56,1253,"rgb(93, 105, 177)"
1886,2020-04-17,Azerbaijan,2,30,1283,"rgb(93, 105, 177)"
1887,2020-04-18,Azerbaijan,0,57,1340,"rgb(93, 105, 177)"
1888,2020-04-19,Azerbaijan,3,33,1373,"rgb(93, 105, 177)"
1889,2020-04-20,Azerbaijan,1,25,1398,"rgb(93, 105, 177)"
1890,2020-04-21,Azerbaijan,0,38,1436,"rgb(93, 105, 177)"
1891,2020-04-22,Azerbaijan,1,44,1480,"rgb(93, 105, 177)"
1892,2020-04-23,Azerbaijan,0,38,1518,"rgb(93, 105, 177)"
1893,2020-04-24,Azerbaijan,0,30,1548,"rgb(93, 105, 177)"
1894,2020-04-25,Azerbaijan,1,44,1592,"rgb(93, 105, 177)"
1895,2020-04-26,Azerbaijan,0,25,1617,"rgb(93, 105, 177)"
1896,2020-04-27,Azerbaijan,0,28,1645,"rgb(93, 105, 177)"
1897,2020-04-28,Azerbaijan,1,33,1678,"rgb(93, 105, 177)"
1898,2020-04-29,Azerbaijan,0,39,1717,"rgb(93, 105, 177)"
1899,2020-04-30,Azerbaijan,1,49,1766,"rgb(93, 105, 177)"
1900,2020-05-01,Azerbaijan,1,38,1804,"rgb(93, 105, 177)"
1901,2020-05-02,Azerbaijan,1,50,1854,"rgb(93, 105, 177)"
1902,2020-05-03,Azerbaijan,0,40,1894,"rgb(93, 105, 177)"
1903,2020-05-04,Azerbaijan,0,38,1932,"rgb(93, 105, 177)"
1904,2020-05-05,Azerbaijan,1,52,1984,"rgb(93, 105, 177)"
1905,2020-05-06,Azerbaijan,0,76,2060,"rgb(93, 105, 177)"
1906,2020-05-07,Azerbaijan,2,67,2127,"rgb(93, 105, 177)"
1907,2020-05-08,Azerbaijan,0,77,2204,"rgb(93, 105, 177)"
1908,2020-05-09,Azerbaijan,0,75,2279,"rgb(93, 105, 177)"
1909,2020-05-10,Azerbaijan,3,143,2422,"rgb(93, 105, 177)"
1910,2020-05-11,Azerbaijan,1,97,2519,"rgb(93, 105, 177)"
1911,2020-05-12,Azerbaijan,0,70,2589,"rgb(93, 105, 177)"
1912,2020-05-13,Azerbaijan,1,104,2693,"rgb(93, 105, 177)"
1913,2020-05-14,Azerbaijan,2,65,2758,"rgb(93, 105, 177)"
1914,2020-05-15,Azerbaijan,0,121,2879,"rgb(93, 105, 177)"
1915,2020-05-16,Azerbaijan,1,101,2980,"rgb(93, 105, 177)"
1916,2020-05-17,Azerbaijan,0,158,3138,"rgb(93, 105, 177)"
1917,2020-05-18,Azerbaijan,3,136,3274,"rgb(93, 105, 177)"
1918,2020-05-19,Azerbaijan,1,13,3287,"rgb(93, 105, 177)"
1919,2020-05-20,Azerbaijan,1,231,3518,"rgb(93, 105, 177)"
1920,2020-05-21,Azerbaijan,2,113,3631,"rgb(93, 105, 177)"
1921,2020-05-22,Azerbaijan,1,118,3749,"rgb(93, 105, 177)"
1922,2020-05-23,Azerbaijan,2,106,3855,"rgb(93, 105, 177)"
1923,2020-05-24,Azerbaijan,3,127,3982,"rgb(93, 105, 177)"
1924,2020-05-25,Azerbaijan,0,140,4122,"rgb(93, 105, 177)"
1925,2020-05-26,Azerbaijan,2,149,4271,"rgb(93, 105, 177)"
1926,2020-05-27,Azerbaijan,1,132,4403,"rgb(93, 105, 177)"
1927,2020-05-28,Azerbaijan,2,165,4568,"rgb(93, 105, 177)"
1928,2020-05-29,Azerbaijan,2,191,4759,"rgb(93, 105, 177)"
1929,2020-05-30,Azerbaijan,2,230,4989,"rgb(93, 105, 177)"
1930,2020-05-31,Azerbaijan,3,257,5246,"rgb(93, 105, 177)"
1931,2020-06-01,Azerbaijan,2,248,5494,"rgb(93, 105, 177)"
1932,2020-06-02,Azerbaijan,5,168,5662,"rgb(93, 105, 177)"
1933,2020-06-03,Azerbaijan,3,273,5935,"rgb(93, 105, 177)"
1934,2020-06-04,Azerbaijan,5,325,6260,"rgb(93, 105, 177)"
1935,2020-06-05,Azerbaijan,2,262,6522,"rgb(93, 105, 177)"
1936,2020-06-06,Azerbaijan,4,338,6860,"rgb(93, 105, 177)"
1937,2020-06-07,Azerbaijan,2,379,7239,"rgb(93, 105, 177)"
1938,2020-06-08,Azerbaijan,4,314,7553,"rgb(93, 105, 177)"
1939,2020-06-09,Azerbaijan,5,323,7876,"rgb(93, 105, 177)"
1940,2020-06-10,Azerbaijan,5,315,8191,"rgb(93, 105, 177)"
1941,2020-06-11,Azerbaijan,4,339,8530,"rgb(93, 105, 177)"
1942,2020-06-12,Azerbaijan,6,352,8882,"rgb(93, 105, 177)"
1943,2020-06-13,Azerbaijan,5,336,9218,"rgb(93, 105, 177)"
1944,2020-06-14,Azerbaijan,2,352,9570,"rgb(93, 105, 177)"
1945,2020-06-15,Azerbaijan,4,387,9957,"rgb(93, 105, 177)"
1946,2020-06-16,Azerbaijan,3,367,10324,"rgb(93, 105, 177)"
1947,2020-06-17,Azerbaijan,4,338,10662,"rgb(93, 105, 177)"
1948,2020-06-18,Azerbaijan,7,329,10991,"rgb(93, 105, 177)"
1949,2020-06-19,Azerbaijan,6,338,11329,"rgb(93, 105, 177)"
1950,2020-06-20,Azerbaijan,0,0,11329,"rgb(93, 105, 177)"
1951,2020-06-21,Azerbaijan,9,909,12238,"rgb(93, 105, 177)"
1952,2020-06-22,Azerbaijan,6,491,12729,"rgb(93, 105, 177)"
1953,2020-06-23,Azerbaijan,7,478,13207,"rgb(93, 105, 177)"
1954,2020-06-24,Azerbaijan,6,508,13715,"rgb(93, 105, 177)"
1955,2020-06-25,Azerbaijan,7,590,14305,"rgb(93, 105, 177)"
1956,2020-06-26,Azerbaijan,6,547,14852,"rgb(93, 105, 177)"
1957,2020-06-27,Azerbaijan,7,517,15369,"rgb(93, 105, 177)"
1958,2020-06-28,Azerbaijan,6,521,15890,"rgb(93, 105, 177)"
1959,2020-06-29,Azerbaijan,5,534,16424,"rgb(93, 105, 177)"
1960,2020-06-30,Azerbaijan,8,544,16968,"rgb(93, 105, 177)"
1961,2020-07-01,Azerbaijan,7,556,17524,"rgb(93, 105, 177)"
1962,2020-07-02,Azerbaijan,7,588,18112,"rgb(93, 105, 177)"
1963,2020-07-03,Azerbaijan,8,572,18684,"rgb(93, 105, 177)"
1964,2020-07-04,Azerbaijan,7,583,19267,"rgb(93, 105, 177)"
1965,2020-07-05,Azerbaijan,6,534,19801,"rgb(93, 105, 177)"
1966,2020-07-06,Azerbaijan,9,523,20324,"rgb(93, 105, 177)"
1967,2020-07-07,Azerbaijan,8,513,20837,"rgb(93, 105, 177)"
1968,2020-07-08,Azerbaijan,7,537,21374,"rgb(93, 105, 177)"
1969,2020-07-09,Azerbaijan,9,542,21916,"rgb(93, 105, 177)"
1970,2020-07-10,Azerbaijan,10,548,22464,"rgb(93, 105, 177)"
1971,2020-07-11,Azerbaijan,8,526,22990,"rgb(93, 105, 177)"
1972,2020-07-12,Azerbaijan,6,531,23521,"rgb(93, 105, 177)"
1973,2020-07-13,Azerbaijan,8,520,24041,"rgb(93, 105, 177)"
1974,2020-03-06,Bosnia and Herzegovina,0,2,2,"rgb(82, 188, 163)"
1975,2020-03-12,Bosnia and Herzegovina,0,1,3,"rgb(82, 188, 163)"
1976,2020-03-13,Bosnia and Herzegovina,0,0,3,"rgb(82, 188, 163)"
1977,2020-03-16,Bosnia and Herzegovina,0,15,18,"rgb(82, 188, 163)"
1978,2020-03-17,Bosnia and Herzegovina,0,3,21,"rgb(82, 188, 163)"
1979,2020-03-18,Bosnia and Herzegovina,0,0,21,"rgb(82, 188, 163)"
1980,2020-03-19,Bosnia and Herzegovina,0,15,36,"rgb(82, 188, 163)"
1981,2020-03-20,Bosnia and Herzegovina,0,8,44,"rgb(82, 188, 163)"
1982,2020-03-21,Bosnia and Herzegovina,0,0,44,"rgb(82, 188, 163)"
1983,2020-03-22,Bosnia and Herzegovina,1,48,92,"rgb(82, 188, 163)"
1984,2020-03-23,Bosnia and Herzegovina,0,33,125,"rgb(82, 188, 163)"
1985,2020-03-24,Bosnia and Herzegovina,0,4,129,"rgb(82, 188, 163)"
1986,2020-03-25,Bosnia and Herzegovina,1,33,162,"rgb(82, 188, 163)"
1987,2020-03-26,Bosnia and Herzegovina,1,19,181,"rgb(82, 188, 163)"
1988,2020-03-27,Bosnia and Herzegovina,0,0,181,"rgb(82, 188, 163)"
1989,2020-03-28,Bosnia and Herzegovina,0,48,229,"rgb(82, 188, 163)"
1990,2020-03-29,Bosnia and Herzegovina,2,28,257,"rgb(82, 188, 163)"
1991,2020-03-30,Bosnia and Herzegovina,1,66,323,"rgb(82, 188, 163)"
1992,2020-03-31,Bosnia and Herzegovina,2,30,353,"rgb(82, 188, 163)"
1993,2020-04-01,Bosnia and Herzegovina,4,60,413,"rgb(82, 188, 163)"
1994,2020-04-02,Bosnia and Herzegovina,1,51,464,"rgb(82, 188, 163)"
1995,2020-04-03,Bosnia and Herzegovina,4,68,532,"rgb(82, 188, 163)"
1996,2020-04-04,Bosnia and Herzegovina,1,54,586,"rgb(82, 188, 163)"
1997,2020-04-05,Bosnia and Herzegovina,3,46,632,"rgb(82, 188, 163)"
1998,2020-04-06,Bosnia and Herzegovina,3,31,663,"rgb(82, 188, 163)"
1999,2020-04-07,Bosnia and Herzegovina,4,32,695,"rgb(82, 188, 163)"
2000,2020-04-08,Bosnia and Herzegovina,4,86,781,"rgb(82, 188, 163)"
2001,2020-04-09,Bosnia and Herzegovina,3,35,816,"rgb(82, 188, 163)"
2002,2020-04-10,Bosnia and Herzegovina,1,59,875,"rgb(82, 188, 163)"
2003,2020-04-11,Bosnia and Herzegovina,1,26,901,"rgb(82, 188, 163)"
2004,2020-04-12,Bosnia and Herzegovina,0,47,948,"rgb(82, 188, 163)"
2005,2020-04-13,Bosnia and Herzegovina,1,59,1007,"rgb(82, 188, 163)"
2006,2020-04-14,Bosnia and Herzegovina,0,21,1028,"rgb(82, 188, 163)"
2007,2020-04-15,Bosnia and Herzegovina,1,45,1073,"rgb(82, 188, 163)"
2008,2020-04-16,Bosnia and Herzegovina,1,27,1100,"rgb(82, 188, 163)"
2009,2020-04-17,Bosnia and Herzegovina,1,52,1152,"rgb(82, 188, 163)"
2010,2020-04-18,Bosnia and Herzegovina,3,58,1210,"rgb(82, 188, 163)"
2011,2020-04-19,Bosnia and Herzegovina,1,44,1254,"rgb(82, 188, 163)"
2012,2020-04-20,Bosnia and Herzegovina,1,15,1269,"rgb(82, 188, 163)"
2013,2020-04-21,Bosnia and Herzegovina,2,31,1300,"rgb(82, 188, 163)"
2014,2020-04-22,Bosnia and Herzegovina,2,40,1340,"rgb(82, 188, 163)"
2015,2020-04-23,Bosnia and Herzegovina,2,27,1367,"rgb(82, 188, 163)"
2016,2020-04-24,Bosnia and Herzegovina,1,46,1413,"rgb(82, 188, 163)"
2017,2020-04-25,Bosnia and Herzegovina,1,7,1420,"rgb(82, 188, 163)"
2018,2020-04-26,Bosnia and Herzegovina,2,65,1485,"rgb(82, 188, 163)"
2019,2020-04-27,Bosnia and Herzegovina,2,31,1516,"rgb(82, 188, 163)"
2020,2020-04-28,Bosnia and Herzegovina,2,48,1564,"rgb(82, 188, 163)"
2021,2020-04-29,Bosnia and Herzegovina,2,24,1588,"rgb(82, 188, 163)"
2022,2020-04-30,Bosnia and Herzegovina,0,0,1588,"rgb(82, 188, 163)"
2023,2020-05-01,Bosnia and Herzegovina,2,101,1689,"rgb(82, 188, 163)"
2024,2020-05-02,Bosnia and Herzegovina,6,92,1781,"rgb(82, 188, 163)"
2025,2020-05-03,Bosnia and Herzegovina,2,58,1839,"rgb(82, 188, 163)"
2026,2020-05-04,Bosnia and Herzegovina,5,18,1857,"rgb(82, 188, 163)"
2027,2020-05-05,Bosnia and Herzegovina,1,69,1926,"rgb(82, 188, 163)"
2028,2020-05-06,Bosnia and Herzegovina,1,20,1946,"rgb(82, 188, 163)"
2029,2020-05-07,Bosnia and Herzegovina,7,41,1987,"rgb(82, 188, 163)"
2030,2020-05-08,Bosnia and Herzegovina,4,40,2027,"rgb(82, 188, 163)"
2031,2020-05-09,Bosnia and Herzegovina,8,43,2070,"rgb(82, 188, 163)"
2032,2020-05-10,Bosnia and Herzegovina,0,0,2070,"rgb(82, 188, 163)"
2033,2020-05-11,Bosnia and Herzegovina,4,20,2090,"rgb(82, 188, 163)"
2034,2020-05-12,Bosnia and Herzegovina,10,52,2142,"rgb(82, 188, 163)"
2035,2020-05-13,Bosnia and Herzegovina,5,16,2158,"rgb(82, 188, 163)"
2036,2020-05-14,Bosnia and Herzegovina,3,23,2181,"rgb(82, 188, 163)"
2037,2020-05-15,Bosnia and Herzegovina,3,35,2216,"rgb(82, 188, 163)"
2038,2020-05-16,Bosnia and Herzegovina,4,21,2237,"rgb(82, 188, 163)"
2039,2020-05-17,Bosnia and Herzegovina,2,30,2267,"rgb(82, 188, 163)"
2040,2020-05-18,Bosnia and Herzegovina,3,22,2289,"rgb(82, 188, 163)"
2041,2020-05-19,Bosnia and Herzegovina,0,14,2303,"rgb(82, 188, 163)"
2042,2020-05-20,Bosnia and Herzegovina,1,16,2319,"rgb(82, 188, 163)"
2043,2020-05-21,Bosnia and Herzegovina,2,15,2334,"rgb(82, 188, 163)"
2044,2020-05-22,Bosnia and Herzegovina,4,18,2352,"rgb(82, 188, 163)"
2045,2020-05-23,Bosnia and Herzegovina,2,20,2372,"rgb(82, 188, 163)"
2046,2020-05-24,Bosnia and Herzegovina,0,19,2391,"rgb(82, 188, 163)"
2047,2020-05-25,Bosnia and Herzegovina,3,10,2401,"rgb(82, 188, 163)"
2048,2020-05-26,Bosnia and Herzegovina,2,5,2406,"rgb(82, 188, 163)"
2049,2020-05-27,Bosnia and Herzegovina,3,10,2416,"rgb(82, 188, 163)"
2050,2020-05-28,Bosnia and Herzegovina,2,19,2435,"rgb(82, 188, 163)"
2051,2020-05-29,Bosnia and Herzegovina,2,27,2462,"rgb(82, 188, 163)"
2052,2020-05-30,Bosnia and Herzegovina,0,23,2485,"rgb(82, 188, 163)"
2053,2020-05-31,Bosnia and Herzegovina,0,9,2494,"rgb(82, 188, 163)"
2054,2020-06-01,Bosnia and Herzegovina,0,15,2509,"rgb(82, 188, 163)"
2055,2020-06-02,Bosnia and Herzegovina,0,14,2523,"rgb(82, 188, 163)"
2056,2020-06-03,Bosnia and Herzegovina,3,11,2534,"rgb(82, 188, 163)"
2057,2020-06-04,Bosnia and Herzegovina,0,16,2550,"rgb(82, 188, 163)"
2058,2020-06-05,Bosnia and Herzegovina,2,43,2593,"rgb(82, 188, 163)"
2059,2020-06-06,Bosnia and Herzegovina,0,12,2605,"rgb(82, 188, 163)"
2060,2020-06-07,Bosnia and Herzegovina,0,0,2605,"rgb(82, 188, 163)"
2061,2020-06-08,Bosnia and Herzegovina,0,0,2605,"rgb(82, 188, 163)"
2062,2020-06-09,Bosnia and Herzegovina,1,98,2703,"rgb(82, 188, 163)"
2063,2020-06-10,Bosnia and Herzegovina,0,24,2727,"rgb(82, 188, 163)"
2064,2020-06-11,Bosnia and Herzegovina,1,49,2776,"rgb(82, 188, 163)"
2065,2020-06-12,Bosnia and Herzegovina,0,55,2831,"rgb(82, 188, 163)"
2066,2020-06-13,Bosnia and Herzegovina,2,61,2892,"rgb(82, 188, 163)"
2067,2020-06-14,Bosnia and Herzegovina,1,48,2940,"rgb(82, 188, 163)"
2068,2020-06-15,Bosnia and Herzegovina,0,61,3001,"rgb(82, 188, 163)"
2069,2020-06-16,Bosnia and Herzegovina,1,38,3039,"rgb(82, 188, 163)"
2070,2020-06-17,Bosnia and Herzegovina,3,45,3084,"rgb(82, 188, 163)"
2071,2020-06-18,Bosnia and Herzegovina,0,60,3144,"rgb(82, 188, 163)"
2072,2020-06-19,Bosnia and Herzegovina,0,58,3202,"rgb(82, 188, 163)"
2073,2020-06-20,Bosnia and Herzegovina,1,86,3288,"rgb(82, 188, 163)"
2074,2020-06-21,Bosnia and Herzegovina,1,66,3354,"rgb(82, 188, 163)"
2075,2020-06-22,Bosnia and Herzegovina,0,0,3354,"rgb(82, 188, 163)"
2076,2020-06-23,Bosnia and Herzegovina,1,170,3524,"rgb(82, 188, 163)"
2077,2020-06-24,Bosnia and Herzegovina,1,63,3587,"rgb(82, 188, 163)"
2078,2020-06-25,Bosnia and Herzegovina,1,88,3675,"rgb(82, 188, 163)"
2079,2020-06-26,Bosnia and Herzegovina,3,121,3796,"rgb(82, 188, 163)"
2080,2020-06-27,Bosnia and Herzegovina,2,138,3934,"rgb(82, 188, 163)"
2081,2020-06-28,Bosnia and Herzegovina,1,1,3935,"rgb(82, 188, 163)"
2082,2020-06-29,Bosnia and Herzegovina,1,172,4107,"rgb(82, 188, 163)"
2083,2020-06-30,Bosnia and Herzegovina,4,236,4343,"rgb(82, 188, 163)"
2084,2020-07-01,Bosnia and Herzegovina,2,110,4453,"rgb(82, 188, 163)"
2085,2020-07-02,Bosnia and Herzegovina,0,0,4453,"rgb(82, 188, 163)"
2086,2020-07-03,Bosnia and Herzegovina,2,153,4606,"rgb(82, 188, 163)"
2087,2020-07-04,Bosnia and Herzegovina,1,182,4788,"rgb(82, 188, 163)"
2088,2020-07-05,Bosnia and Herzegovina,2,172,4960,"rgb(82, 188, 163)"
2089,2020-07-06,Bosnia and Herzegovina,0,289,5249,"rgb(82, 188, 163)"
2090,2020-07-07,Bosnia and Herzegovina,9,209,5458,"rgb(82, 188, 163)"
2091,2020-07-08,Bosnia and Herzegovina,8,163,5621,"rgb(82, 188, 163)"
2092,2020-07-09,Bosnia and Herzegovina,2,248,5869,"rgb(82, 188, 163)"
2093,2020-07-10,Bosnia and Herzegovina,5,217,6086,"rgb(82, 188, 163)"
2094,2020-07-11,Bosnia and Herzegovina,2,316,6402,"rgb(82, 188, 163)"
2095,2020-07-12,Bosnia and Herzegovina,0,0,6402,"rgb(82, 188, 163)"
2096,2020-07-13,Bosnia and Herzegovina,4,482,6884,"rgb(82, 188, 163)"
2097,2020-03-18,Barbados,0,1,1,"rgb(153, 201, 69)"
2098,2020-03-19,Barbados,0,0,1,"rgb(153, 201, 69)"
2099,2020-03-20,Barbados,0,1,2,"rgb(153, 201, 69)"
2100,2020-03-21,Barbados,0,4,6,"rgb(153, 201, 69)"
2101,2020-03-22,Barbados,0,8,14,"rgb(153, 201, 69)"
2102,2020-03-23,Barbados,0,3,17,"rgb(153, 201, 69)"
2103,2020-03-24,Barbados,0,0,17,"rgb(153, 201, 69)"
2104,2020-03-25,Barbados,0,1,18,"rgb(153, 201, 69)"
2105,2020-03-26,Barbados,0,0,18,"rgb(153, 201, 69)"
2106,2020-03-27,Barbados,0,6,24,"rgb(153, 201, 69)"
2107,2020-03-28,Barbados,0,0,24,"rgb(153, 201, 69)"
2108,2020-03-29,Barbados,0,2,26,"rgb(153, 201, 69)"
2109,2020-03-30,Barbados,0,7,33,"rgb(153, 201, 69)"
2110,2020-03-31,Barbados,0,1,34,"rgb(153, 201, 69)"
2111,2020-04-01,Barbados,0,0,34,"rgb(153, 201, 69)"
2112,2020-04-02,Barbados,0,11,45,"rgb(153, 201, 69)"
2113,2020-04-03,Barbados,0,0,45,"rgb(153, 201, 69)"
2114,2020-04-04,Barbados,0,0,45,"rgb(153, 201, 69)"
2115,2020-04-05,Barbados,0,6,51,"rgb(153, 201, 69)"
2116,2020-04-06,Barbados,1,5,56,"rgb(153, 201, 69)"
2117,2020-04-07,Barbados,1,4,60,"rgb(153, 201, 69)"
2118,2020-04-08,Barbados,1,3,63,"rgb(153, 201, 69)"
2119,2020-04-09,Barbados,0,0,63,"rgb(153, 201, 69)"
2120,2020-04-10,Barbados,0,3,66,"rgb(153, 201, 69)"
2121,2020-04-11,Barbados,1,1,67,"rgb(153, 201, 69)"
2122,2020-04-12,Barbados,0,1,68,"rgb(153, 201, 69)"
2123,2020-04-13,Barbados,0,3,71,"rgb(153, 201, 69)"
2124,2020-04-14,Barbados,0,1,72,"rgb(153, 201, 69)"
2125,2020-04-15,Barbados,1,1,73,"rgb(153, 201, 69)"
2126,2020-04-16,Barbados,0,2,75,"rgb(153, 201, 69)"
2127,2020-04-17,Barbados,0,0,75,"rgb(153, 201, 69)"
2128,2020-04-18,Barbados,0,0,75,"rgb(153, 201, 69)"
2129,2020-04-19,Barbados,0,0,75,"rgb(153, 201, 69)"
2130,2020-04-20,Barbados,0,0,75,"rgb(153, 201, 69)"
2131,2020-04-21,Barbados,0,0,75,"rgb(153, 201, 69)"
2132,2020-04-22,Barbados,0,0,75,"rgb(153, 201, 69)"
2133,2020-04-23,Barbados,1,1,76,"rgb(153, 201, 69)"
2134,2020-04-24,Barbados,0,0,76,"rgb(153, 201, 69)"
2135,2020-04-25,Barbados,0,0,76,"rgb(153, 201, 69)"
2136,2020-04-26,Barbados,0,3,79,"rgb(153, 201, 69)"
2137,2020-04-27,Barbados,0,0,79,"rgb(153, 201, 69)"
2138,2020-04-28,Barbados,0,1,80,"rgb(153, 201, 69)"
2139,2020-04-29,Barbados,0,0,80,"rgb(153, 201, 69)"
2140,2020-04-30,Barbados,1,0,80,"rgb(153, 201, 69)"
2141,2020-05-01,Barbados,0,1,81,"rgb(153, 201, 69)"
2142,2020-05-02,Barbados,0,0,81,"rgb(153, 201, 69)"
2143,2020-05-03,Barbados,0,0,81,"rgb(153, 201, 69)"
2144,2020-05-04,Barbados,0,1,82,"rgb(153, 201, 69)"
2145,2020-05-05,Barbados,0,0,82,"rgb(153, 201, 69)"
2146,2020-05-06,Barbados,0,0,82,"rgb(153, 201, 69)"
2147,2020-05-07,Barbados,0,0,82,"rgb(153, 201, 69)"
2148,2020-05-08,Barbados,0,0,82,"rgb(153, 201, 69)"
2149,2020-05-09,Barbados,0,1,83,"rgb(153, 201, 69)"
2150,2020-05-10,Barbados,0,1,84,"rgb(153, 201, 69)"
2151,2020-05-11,Barbados,0,0,84,"rgb(153, 201, 69)"
2152,2020-05-12,Barbados,0,0,84,"rgb(153, 201, 69)"
2153,2020-05-13,Barbados,0,1,85,"rgb(153, 201, 69)"
2154,2020-05-14,Barbados,0,0,85,"rgb(153, 201, 69)"
2155,2020-05-15,Barbados,0,0,85,"rgb(153, 201, 69)"
2156,2020-05-16,Barbados,0,0,85,"rgb(153, 201, 69)"
2157,2020-05-17,Barbados,0,1,86,"rgb(153, 201, 69)"
2158,2020-05-18,Barbados,0,2,88,"rgb(153, 201, 69)"
2159,2020-05-19,Barbados,0,0,88,"rgb(153, 201, 69)"
2160,2020-05-20,Barbados,0,2,90,"rgb(153, 201, 69)"
2161,2020-05-21,Barbados,0,0,90,"rgb(153, 201, 69)"
2162,2020-05-22,Barbados,0,0,90,"rgb(153, 201, 69)"
2163,2020-05-23,Barbados,0,0,90,"rgb(153, 201, 69)"
2164,2020-05-24,Barbados,0,2,92,"rgb(153, 201, 69)"
2165,2020-05-25,Barbados,0,0,92,"rgb(153, 201, 69)"
2166,2020-05-26,Barbados,0,0,92,"rgb(153, 201, 69)"
2167,2020-05-27,Barbados,0,0,92,"rgb(153, 201, 69)"
2168,2020-05-28,Barbados,0,0,92,"rgb(153, 201, 69)"
2169,2020-05-29,Barbados,0,0,92,"rgb(153, 201, 69)"
2170,2020-05-30,Barbados,0,0,92,"rgb(153, 201, 69)"
2171,2020-05-31,Barbados,0,0,92,"rgb(153, 201, 69)"
2172,2020-06-01,Barbados,0,0,92,"rgb(153, 201, 69)"
2173,2020-06-02,Barbados,0,0,92,"rgb(153, 201, 69)"
2174,2020-06-03,Barbados,0,0,92,"rgb(153, 201, 69)"
2175,2020-06-04,Barbados,0,0,92,"rgb(153, 201, 69)"
2176,2020-06-05,Barbados,0,0,92,"rgb(153, 201, 69)"
2177,2020-06-06,Barbados,0,0,92,"rgb(153, 201, 69)"
2178,2020-06-07,Barbados,0,0,92,"rgb(153, 201, 69)"
2179,2020-06-08,Barbados,0,0,92,"rgb(153, 201, 69)"
2180,2020-06-09,Barbados,0,0,92,"rgb(153, 201, 69)"
2181,2020-06-10,Barbados,0,0,92,"rgb(153, 201, 69)"
2182,2020-06-11,Barbados,0,4,96,"rgb(153, 201, 69)"
2183,2020-06-12,Barbados,0,0,96,"rgb(153, 201, 69)"
2184,2020-06-13,Barbados,0,0,96,"rgb(153, 201, 69)"
2185,2020-06-14,Barbados,0,0,96,"rgb(153, 201, 69)"
2186,2020-06-15,Barbados,0,0,96,"rgb(153, 201, 69)"
2187,2020-06-16,Barbados,0,1,97,"rgb(153, 201, 69)"
2188,2020-06-17,Barbados,0,0,97,"rgb(153, 201, 69)"
2189,2020-06-18,Barbados,0,0,97,"rgb(153, 201, 69)"
2190,2020-06-19,Barbados,0,0,97,"rgb(153, 201, 69)"
2191,2020-06-20,Barbados,0,0,97,"rgb(153, 201, 69)"
2192,2020-06-21,Barbados,0,0,97,"rgb(153, 201, 69)"
2193,2020-06-22,Barbados,0,0,97,"rgb(153, 201, 69)"
2194,2020-06-23,Barbados,0,0,97,"rgb(153, 201, 69)"
2195,2020-06-24,Barbados,0,0,97,"rgb(153, 201, 69)"
2196,2020-06-25,Barbados,0,0,97,"rgb(153, 201, 69)"
2197,2020-06-26,Barbados,0,0,97,"rgb(153, 201, 69)"
2198,2020-06-27,Barbados,0,0,97,"rgb(153, 201, 69)"
2199,2020-06-28,Barbados,0,0,97,"rgb(153, 201, 69)"
2200,2020-06-29,Barbados,0,0,97,"rgb(153, 201, 69)"
2201,2020-06-30,Barbados,0,0,97,"rgb(153, 201, 69)"
2202,2020-07-01,Barbados,0,0,97,"rgb(153, 201, 69)"
2203,2020-07-02,Barbados,0,0,97,"rgb(153, 201, 69)"
2204,2020-07-03,Barbados,0,0,97,"rgb(153, 201, 69)"
2205,2020-07-04,Barbados,0,0,97,"rgb(153, 201, 69)"
2206,2020-07-05,Barbados,0,0,97,"rgb(153, 201, 69)"
2207,2020-07-06,Barbados,0,1,98,"rgb(153, 201, 69)"
2208,2020-07-07,Barbados,0,0,98,"rgb(153, 201, 69)"
2209,2020-07-08,Barbados,0,0,98,"rgb(153, 201, 69)"
2210,2020-07-09,Barbados,0,0,98,"rgb(153, 201, 69)"
2211,2020-07-10,Barbados,0,0,98,"rgb(153, 201, 69)"
2212,2020-07-11,Barbados,0,0,98,"rgb(153, 201, 69)"
2213,2020-07-12,Barbados,0,5,103,"rgb(153, 201, 69)"
2214,2020-07-13,Barbados,0,0,103,"rgb(153, 201, 69)"
2215,2020-03-09,Bangladesh,0,3,3,"rgb(204, 97, 176)"
2216,2020-03-15,Bangladesh,0,0,3,"rgb(204, 97, 176)"
2217,2020-03-17,Bangladesh,0,2,5,"rgb(204, 97, 176)"
2218,2020-03-18,Bangladesh,0,3,8,"rgb(204, 97, 176)"
2219,2020-03-19,Bangladesh,0,2,10,"rgb(204, 97, 176)"
2220,2020-03-20,Bangladesh,0,0,10,"rgb(204, 97, 176)"
2221,2020-03-21,Bangladesh,0,7,17,"rgb(204, 97, 176)"
2222,2020-03-22,Bangladesh,2,7,24,"rgb(204, 97, 176)"
2223,2020-03-23,Bangladesh,1,3,27,"rgb(204, 97, 176)"
2224,2020-03-24,Bangladesh,0,6,33,"rgb(204, 97, 176)"
2225,2020-03-25,Bangladesh,1,6,39,"rgb(204, 97, 176)"
2226,2020-03-26,Bangladesh,1,0,39,"rgb(204, 97, 176)"
2227,2020-03-27,Bangladesh,0,9,48,"rgb(204, 97, 176)"
2228,2020-03-28,Bangladesh,0,0,48,"rgb(204, 97, 176)"
2229,2020-03-29,Bangladesh,0,0,48,"rgb(204, 97, 176)"
2230,2020-03-30,Bangladesh,0,1,49,"rgb(204, 97, 176)"
2231,2020-03-31,Bangladesh,0,0,49,"rgb(204, 97, 176)"
2232,2020-04-01,Bangladesh,0,2,51,"rgb(204, 97, 176)"
2233,2020-04-02,Bangladesh,1,3,54,"rgb(204, 97, 176)"
2234,2020-04-03,Bangladesh,0,2,56,"rgb(204, 97, 176)"
2235,2020-04-04,Bangladesh,0,5,61,"rgb(204, 97, 176)"
2236,2020-04-05,Bangladesh,2,9,70,"rgb(204, 97, 176)"
2237,2020-04-06,Bangladesh,1,18,88,"rgb(204, 97, 176)"
2238,2020-04-07,Bangladesh,3,35,123,"rgb(204, 97, 176)"
2239,2020-04-08,Bangladesh,5,41,164,"rgb(204, 97, 176)"
2240,2020-04-09,Bangladesh,3,54,218,"rgb(204, 97, 176)"
2241,2020-04-10,Bangladesh,1,112,330,"rgb(204, 97, 176)"
2242,2020-04-11,Bangladesh,6,94,424,"rgb(204, 97, 176)"
2243,2020-04-12,Bangladesh,3,58,482,"rgb(204, 97, 176)"
2244,2020-04-13,Bangladesh,4,139,621,"rgb(204, 97, 176)"
2245,2020-04-14,Bangladesh,5,182,803,"rgb(204, 97, 176)"
2246,2020-04-15,Bangladesh,7,209,1012,"rgb(204, 97, 176)"
2247,2020-04-16,Bangladesh,4,219,1231,"rgb(204, 97, 176)"
2248,2020-04-17,Bangladesh,10,341,1572,"rgb(204, 97, 176)"
2249,2020-04-18,Bangladesh,15,266,1838,"rgb(204, 97, 176)"
2250,2020-04-19,Bangladesh,9,306,2144,"rgb(204, 97, 176)"
2251,2020-04-20,Bangladesh,7,312,2456,"rgb(204, 97, 176)"
2252,2020-04-21,Bangladesh,10,492,2948,"rgb(204, 97, 176)"
2253,2020-04-22,Bangladesh,9,434,3382,"rgb(204, 97, 176)"
2254,2020-04-23,Bangladesh,10,390,3772,"rgb(204, 97, 176)"
2255,2020-04-24,Bangladesh,7,414,4186,"rgb(204, 97, 176)"
2256,2020-04-25,Bangladesh,4,503,4689,"rgb(204, 97, 176)"
2257,2020-04-26,Bangladesh,9,309,4998,"rgb(204, 97, 176)"
2258,2020-04-27,Bangladesh,5,418,5416,"rgb(204, 97, 176)"
2259,2020-04-28,Bangladesh,7,497,5913,"rgb(204, 97, 176)"
2260,2020-04-29,Bangladesh,3,549,6462,"rgb(204, 97, 176)"
2261,2020-04-30,Bangladesh,8,641,7103,"rgb(204, 97, 176)"
2262,2020-05-01,Bangladesh,5,564,7667,"rgb(204, 97, 176)"
2263,2020-05-02,Bangladesh,2,571,8238,"rgb(204, 97, 176)"
2264,2020-05-03,Bangladesh,5,552,8790,"rgb(204, 97, 176)"
2265,2020-05-04,Bangladesh,2,665,9455,"rgb(204, 97, 176)"
2266,2020-05-05,Bangladesh,5,688,10143,"rgb(204, 97, 176)"
2267,2020-05-06,Bangladesh,1,786,10929,"rgb(204, 97, 176)"
2268,2020-05-07,Bangladesh,3,790,11719,"rgb(204, 97, 176)"
2269,2020-05-08,Bangladesh,13,706,12425,"rgb(204, 97, 176)"
2270,2020-05-09,Bangladesh,7,709,13134,"rgb(204, 97, 176)"
2271,2020-05-10,Bangladesh,8,636,13770,"rgb(204, 97, 176)"
2272,2020-05-11,Bangladesh,14,887,14657,"rgb(204, 97, 176)"
2273,2020-05-12,Bangladesh,11,1034,15691,"rgb(204, 97, 176)"
2274,2020-05-13,Bangladesh,11,969,16660,"rgb(204, 97, 176)"
2275,2020-05-14,Bangladesh,19,1162,17822,"rgb(204, 97, 176)"
2276,2020-05-15,Bangladesh,14,1041,18863,"rgb(204, 97, 176)"
2277,2020-05-16,Bangladesh,15,1202,20065,"rgb(204, 97, 176)"
2278,2020-05-17,Bangladesh,16,930,20995,"rgb(204, 97, 176)"
2279,2020-05-18,Bangladesh,14,1273,22268,"rgb(204, 97, 176)"
2280,2020-05-19,Bangladesh,21,1602,23870,"rgb(204, 97, 176)"
2281,2020-05-20,Bangladesh,21,1251,25121,"rgb(204, 97, 176)"
2282,2020-05-21,Bangladesh,16,1617,26738,"rgb(204, 97, 176)"
2283,2020-05-22,Bangladesh,22,1773,28511,"rgb(204, 97, 176)"
2284,2020-05-23,Bangladesh,24,1694,30205,"rgb(204, 97, 176)"
2285,2020-05-24,Bangladesh,20,1873,32078,"rgb(204, 97, 176)"
2286,2020-05-25,Bangladesh,28,1532,33610,"rgb(204, 97, 176)"
2287,2020-05-26,Bangladesh,21,1975,35585,"rgb(204, 97, 176)"
2288,2020-05-27,Bangladesh,21,1166,36751,"rgb(204, 97, 176)"
2289,2020-05-28,Bangladesh,22,1541,38292,"rgb(204, 97, 176)"
2290,2020-05-29,Bangladesh,15,2029,40321,"rgb(204, 97, 176)"
2291,2020-05-30,Bangladesh,23,2523,42844,"rgb(204, 97, 176)"
2292,2020-05-31,Bangladesh,28,1764,44608,"rgb(204, 97, 176)"
2293,2020-06-01,Bangladesh,40,2545,47153,"rgb(204, 97, 176)"
2294,2020-06-02,Bangladesh,22,2381,49534,"rgb(204, 97, 176)"
2295,2020-06-03,Bangladesh,37,2911,52445,"rgb(204, 97, 176)"
2296,2020-06-04,Bangladesh,37,2695,55140,"rgb(204, 97, 176)"
2297,2020-06-05,Bangladesh,35,2423,57563,"rgb(204, 97, 176)"
2298,2020-06-06,Bangladesh,30,2828,60391,"rgb(204, 97, 176)"
2299,2020-06-07,Bangladesh,35,2635,63026,"rgb(204, 97, 176)"
2300,2020-06-08,Bangladesh,42,2743,65769,"rgb(204, 97, 176)"
2301,2020-06-09,Bangladesh,42,2735,68504,"rgb(204, 97, 176)"
2302,2020-06-10,Bangladesh,45,3171,71675,"rgb(204, 97, 176)"
2303,2020-06-11,Bangladesh,37,3190,74865,"rgb(204, 97, 176)"
2304,2020-06-12,Bangladesh,37,3187,78052,"rgb(204, 97, 176)"
2305,2020-06-13,Bangladesh,46,3471,81523,"rgb(204, 97, 176)"
2306,2020-06-14,Bangladesh,44,2856,84379,"rgb(204, 97, 176)"
2307,2020-06-15,Bangladesh,32,3141,87520,"rgb(204, 97, 176)"
2308,2020-06-16,Bangladesh,38,3099,90619,"rgb(204, 97, 176)"
2309,2020-06-17,Bangladesh,53,3862,94481,"rgb(204, 97, 176)"
2310,2020-06-18,Bangladesh,43,4008,98489,"rgb(204, 97, 176)"
2311,2020-06-19,Bangladesh,38,3803,102292,"rgb(204, 97, 176)"
2312,2020-06-20,Bangladesh,45,3243,105535,"rgb(204, 97, 176)"
2313,2020-06-21,Bangladesh,37,3240,108775,"rgb(204, 97, 176)"
2314,2020-06-22,Bangladesh,39,3531,112306,"rgb(204, 97, 176)"
2315,2020-06-23,Bangladesh,38,3480,115786,"rgb(204, 97, 176)"
2316,2020-06-24,Bangladesh,43,3412,119198,"rgb(204, 97, 176)"
2317,2020-06-25,Bangladesh,37,3462,122660,"rgb(204, 97, 176)"
2318,2020-06-26,Bangladesh,39,3946,126606,"rgb(204, 97, 176)"
2319,2020-06-27,Bangladesh,40,3868,130474,"rgb(204, 97, 176)"
2320,2020-06-28,Bangladesh,34,3504,133978,"rgb(204, 97, 176)"
2321,2020-06-29,Bangladesh,43,3809,137787,"rgb(204, 97, 176)"
2322,2020-06-30,Bangladesh,45,4014,141801,"rgb(204, 97, 176)"
2323,2020-07-01,Bangladesh,64,3682,145483,"rgb(204, 97, 176)"
2324,2020-07-02,Bangladesh,41,3775,149258,"rgb(204, 97, 176)"
2325,2020-07-03,Bangladesh,38,4019,153277,"rgb(204, 97, 176)"
2326,2020-07-04,Bangladesh,42,3114,156391,"rgb(204, 97, 176)"
2327,2020-07-05,Bangladesh,29,3288,159679,"rgb(204, 97, 176)"
2328,2020-07-06,Bangladesh,55,2738,162417,"rgb(204, 97, 176)"
2329,2020-07-07,Bangladesh,44,3201,165618,"rgb(204, 97, 176)"
2330,2020-07-08,Bangladesh,55,3027,168645,"rgb(204, 97, 176)"
2331,2020-07-09,Bangladesh,46,3489,172134,"rgb(204, 97, 176)"
2332,2020-07-10,Bangladesh,41,3360,175494,"rgb(204, 97, 176)"
2333,2020-07-11,Bangladesh,37,2949,178443,"rgb(204, 97, 176)"
2334,2020-07-12,Bangladesh,30,2686,181129,"rgb(204, 97, 176)"
2335,2020-07-13,Bangladesh,47,2666,183795,"rgb(204, 97, 176)"
2336,2019-12-31,Belgium,0,0,0,"rgb(36, 121, 108)"
2337,2020-01-01,Belgium,0,0,0,"rgb(36, 121, 108)"
2338,2020-01-02,Belgium,0,0,0,"rgb(36, 121, 108)"
2339,2020-01-03,Belgium,0,0,0,"rgb(36, 121, 108)"
2340,2020-01-04,Belgium,0,0,0,"rgb(36, 121, 108)"
2341,2020-01-05,Belgium,0,0,0,"rgb(36, 121, 108)"
2342,2020-01-06,Belgium,0,0,0,"rgb(36, 121, 108)"
2343,2020-01-07,Belgium,0,0,0,"rgb(36, 121, 108)"
2344,2020-01-08,Belgium,0,0,0,"rgb(36, 121, 108)"
2345,2020-01-09,Belgium,0,0,0,"rgb(36, 121, 108)"
2346,2020-01-10,Belgium,0,0,0,"rgb(36, 121, 108)"
2347,2020-01-11,Belgium,0,0,0,"rgb(36, 121, 108)"
2348,2020-01-12,Belgium,0,0,0,"rgb(36, 121, 108)"
2349,2020-01-13,Belgium,0,0,0,"rgb(36, 121, 108)"
2350,2020-01-14,Belgium,0,0,0,"rgb(36, 121, 108)"
2351,2020-01-15,Belgium,0,0,0,"rgb(36, 121, 108)"
2352,2020-01-16,Belgium,0,0,0,"rgb(36, 121, 108)"
2353,2020-01-17,Belgium,0,0,0,"rgb(36, 121, 108)"
2354,2020-01-18,Belgium,0,0,0,"rgb(36, 121, 108)"
2355,2020-01-19,Belgium,0,0,0,"rgb(36, 121, 108)"
2356,2020-01-20,Belgium,0,0,0,"rgb(36, 121, 108)"
2357,2020-01-21,Belgium,0,0,0,"rgb(36, 121, 108)"
2358,2020-01-22,Belgium,0,0,0,"rgb(36, 121, 108)"
2359,2020-01-23,Belgium,0,0,0,"rgb(36, 121, 108)"
2360,2020-01-24,Belgium,0,0,0,"rgb(36, 121, 108)"
2361,2020-01-25,Belgium,0,0,0,"rgb(36, 121, 108)"
2362,2020-01-26,Belgium,0,0,0,"rgb(36, 121, 108)"
2363,2020-01-27,Belgium,0,0,0,"rgb(36, 121, 108)"
2364,2020-01-28,Belgium,0,0,0,"rgb(36, 121, 108)"
2365,2020-01-29,Belgium,0,0,0,"rgb(36, 121, 108)"
2366,2020-01-30,Belgium,0,0,0,"rgb(36, 121, 108)"
2367,2020-01-31,Belgium,0,0,0,"rgb(36, 121, 108)"
2368,2020-02-01,Belgium,0,0,0,"rgb(36, 121, 108)"
2369,2020-02-02,Belgium,0,0,0,"rgb(36, 121, 108)"
2370,2020-02-03,Belgium,0,0,0,"rgb(36, 121, 108)"
2371,2020-02-04,Belgium,0,1,1,"rgb(36, 121, 108)"
2372,2020-02-05,Belgium,0,0,1,"rgb(36, 121, 108)"
2373,2020-02-06,Belgium,0,0,1,"rgb(36, 121, 108)"
2374,2020-02-07,Belgium,0,0,1,"rgb(36, 121, 108)"
2375,2020-02-08,Belgium,0,0,1,"rgb(36, 121, 108)"
2376,2020-02-09,Belgium,0,0,1,"rgb(36, 121, 108)"
2377,2020-02-10,Belgium,0,0,1,"rgb(36, 121, 108)"
2378,2020-02-11,Belgium,0,0,1,"rgb(36, 121, 108)"
2379,2020-02-12,Belgium,0,0,1,"rgb(36, 121, 108)"
2380,2020-02-13,Belgium,0,0,1,"rgb(36, 121, 108)"
2381,2020-02-14,Belgium,0,0,1,"rgb(36, 121, 108)"
2382,2020-02-15,Belgium,0,0,1,"rgb(36, 121, 108)"
2383,2020-02-16,Belgium,0,0,1,"rgb(36, 121, 108)"
2384,2020-02-17,Belgium,0,0,1,"rgb(36, 121, 108)"
2385,2020-02-18,Belgium,0,0,1,"rgb(36, 121, 108)"
2386,2020-02-19,Belgium,0,0,1,"rgb(36, 121, 108)"
2387,2020-02-20,Belgium,0,0,1,"rgb(36, 121, 108)"
2388,2020-02-21,Belgium,0,0,1,"rgb(36, 121, 108)"
2389,2020-02-22,Belgium,0,0,1,"rgb(36, 121, 108)"
2390,2020-02-23,Belgium,0,0,1,"rgb(36, 121, 108)"
2391,2020-02-24,Belgium,0,0,1,"rgb(36, 121, 108)"
2392,2020-02-25,Belgium,0,0,1,"rgb(36, 121, 108)"
2393,2020-02-26,Belgium,0,0,1,"rgb(36, 121, 108)"
2394,2020-02-27,Belgium,0,0,1,"rgb(36, 121, 108)"
2395,2020-02-28,Belgium,0,0,1,"rgb(36, 121, 108)"
2396,2020-02-29,Belgium,0,0,1,"rgb(36, 121, 108)"
2397,2020-03-01,Belgium,0,0,1,"rgb(36, 121, 108)"
2398,2020-03-02,Belgium,0,16,17,"rgb(36, 121, 108)"
2399,2020-03-03,Belgium,0,17,34,"rgb(36, 121, 108)"
2400,2020-03-04,Belgium,0,36,70,"rgb(36, 121, 108)"
2401,2020-03-05,Belgium,0,55,125,"rgb(36, 121, 108)"
2402,2020-03-06,Belgium,0,81,206,"rgb(36, 121, 108)"
2403,2020-03-07,Belgium,0,111,317,"rgb(36, 121, 108)"
2404,2020-03-08,Belgium,0,27,344,"rgb(36, 121, 108)"
2405,2020-03-09,Belgium,0,64,408,"rgb(36, 121, 108)"
2406,2020-03-10,Belgium,1,94,502,"rgb(36, 121, 108)"
2407,2020-03-11,Belgium,3,99,601,"rgb(36, 121, 108)"
2408,2020-03-12,Belgium,1,174,775,"rgb(36, 121, 108)"
2409,2020-03-13,Belgium,3,250,1025,"rgb(36, 121, 108)"
2410,2020-03-14,Belgium,5,338,1363,"rgb(36, 121, 108)"
2411,2020-03-15,Belgium,6,179,1542,"rgb(36, 121, 108)"
2412,2020-03-16,Belgium,11,214,1756,"rgb(36, 121, 108)"
2413,2020-03-17,Belgium,12,387,2143,"rgb(36, 121, 108)"
2414,2020-03-18,Belgium,22,422,2565,"rgb(36, 121, 108)"
2415,2020-03-19,Belgium,28,534,3099,"rgb(36, 121, 108)"
2416,2020-03-20,Belgium,31,713,3812,"rgb(36, 121, 108)"
2417,2020-03-21,Belgium,39,663,4475,"rgb(36, 121, 108)"
2418,2020-03-22,Belgium,42,470,4945,"rgb(36, 121, 108)"
2419,2020-03-23,Belgium,77,486,5431,"rgb(36, 121, 108)"
2420,2020-03-24,Belgium,74,1329,6760,"rgb(36, 121, 108)"
2421,2020-03-25,Belgium,97,1195,7955,"rgb(36, 121, 108)"
2422,2020-03-26,Belgium,101,1199,9154,"rgb(36, 121, 108)"
2423,2020-03-27,Belgium,124,1363,10517,"rgb(36, 121, 108)"
2424,2020-03-28,Belgium,134,1519,12036,"rgb(36, 121, 108)"
2425,2020-03-29,Belgium,139,844,12880,"rgb(36, 121, 108)"
2426,2020-03-30,Belgium,170,683,13563,"rgb(36, 121, 108)"
2427,2020-03-31,Belgium,187,1738,15301,"rgb(36, 121, 108)"
2428,2020-04-01,Belgium,249,1681,16982,"rgb(36, 121, 108)"
2429,2020-04-02,Belgium,210,1503,18485,"rgb(36, 121, 108)"
2430,2020-04-03,Belgium,231,1460,19945,"rgb(36, 121, 108)"
2431,2020-04-04,Belgium,273,1691,21636,"rgb(36, 121, 108)"
2432,2020-04-05,Belgium,233,925,22561,"rgb(36, 121, 108)"
2433,2020-04-06,Belgium,273,665,23226,"rgb(36, 121, 108)"
2434,2020-04-07,Belgium,303,1922,25148,"rgb(36, 121, 108)"
2435,2020-04-08,Belgium,317,1500,26648,"rgb(36, 121, 108)"
2436,2020-04-09,Belgium,271,1587,28235,"rgb(36, 121, 108)"
2437,2020-04-10,Belgium,318,2224,30459,"rgb(36, 121, 108)"
2438,2020-04-11,Belgium,288,2319,32778,"rgb(36, 121, 108)"
2439,2020-04-12,Belgium,343,1023,33801,"rgb(36, 121, 108)"
2440,2020-04-13,Belgium,280,517,34318,"rgb(36, 121, 108)"
2441,2020-04-14,Belgium,275,532,34850,"rgb(36, 121, 108)"
2442,2020-04-15,Belgium,275,1562,36412,"rgb(36, 121, 108)"
2443,2020-04-16,Belgium,252,1620,38032,"rgb(36, 121, 108)"
2444,2020-04-17,Belgium,204,1664,39696,"rgb(36, 121, 108)"
2445,2020-04-18,Belgium,209,1382,41078,"rgb(36, 121, 108)"
2446,2020-04-19,Belgium,212,717,41795,"rgb(36, 121, 108)"
2447,2020-04-20,Belgium,199,443,42238,"rgb(36, 121, 108)"
2448,2020-04-21,Belgium,202,1272,43510,"rgb(36, 121, 108)"
2449,2020-04-22,Belgium,192,1263,44773,"rgb(36, 121, 108)"
2450,2020-04-23,Belgium,175,775,45548,"rgb(36, 121, 108)"
2451,2020-04-24,Belgium,147,968,46516,"rgb(36, 121, 108)"
2452,2020-04-25,Belgium,155,803,47319,"rgb(36, 121, 108)"
2453,2020-04-26,Belgium,176,387,47706,"rgb(36, 121, 108)"
2454,2020-04-27,Belgium,127,205,47911,"rgb(36, 121, 108)"
2455,2020-04-28,Belgium,115,748,48659,"rgb(36, 121, 108)"
2456,2020-04-29,Belgium,98,568,49227,"rgb(36, 121, 108)"
2457,2020-04-30,Belgium,84,514,49741,"rgb(36, 121, 108)"
2458,2020-05-01,Belgium,98,587,50328,"rgb(36, 121, 108)"
2459,2020-05-02,Belgium,73,237,50565,"rgb(36, 121, 108)"
2460,2020-05-03,Belgium,96,284,50849,"rgb(36, 121, 108)"
2461,2020-05-04,Belgium,98,141,50990,"rgb(36, 121, 108)"
2462,2020-05-05,Belgium,82,669,51659,"rgb(36, 121, 108)"
2463,2020-05-06,Belgium,75,536,52195,"rgb(36, 121, 108)"
2464,2020-05-07,Belgium,78,551,52746,"rgb(36, 121, 108)"
2465,2020-05-08,Belgium,70,426,53172,"rgb(36, 121, 108)"
2466,2020-05-09,Belgium,68,479,53651,"rgb(36, 121, 108)"
2467,2020-05-10,Belgium,73,240,53891,"rgb(36, 121, 108)"
2468,2020-05-11,Belgium,62,118,54009,"rgb(36, 121, 108)"
2469,2020-05-12,Belgium,48,462,54471,"rgb(36, 121, 108)"
2470,2020-05-13,Belgium,54,395,54866,"rgb(36, 121, 108)"
2471,2020-05-14,Belgium,46,318,55184,"rgb(36, 121, 108)"
2472,2020-05-15,Belgium,37,294,55478,"rgb(36, 121, 108)"
2473,2020-05-16,Belgium,28,340,55818,"rgb(36, 121, 108)"
2474,2020-05-17,Belgium,35,146,55964,"rgb(36, 121, 108)"
2475,2020-05-18,Belgium,35,81,56045,"rgb(36, 121, 108)"
2476,2020-05-19,Belgium,30,307,56352,"rgb(36, 121, 108)"
2477,2020-05-20,Belgium,32,284,56636,"rgb(36, 121, 108)"
2478,2020-05-21,Belgium,29,381,57017,"rgb(36, 121, 108)"
2479,2020-05-22,Belgium,37,71,57088,"rgb(36, 121, 108)"
2480,2020-05-23,Belgium,24,246,57334,"rgb(36, 121, 108)"
2481,2020-05-24,Belgium,35,122,57456,"rgb(36, 121, 108)"
2482,2020-05-25,Belgium,24,75,57531,"rgb(36, 121, 108)"
2483,2020-05-26,Belgium,40,304,57835,"rgb(36, 121, 108)"
2484,2020-05-27,Belgium,24,198,58033,"rgb(36, 121, 108)"
2485,2020-05-28,Belgium,22,181,58214,"rgb(36, 121, 108)"
2486,2020-05-29,Belgium,13,159,58373,"rgb(36, 121, 108)"
2487,2020-05-30,Belgium,24,159,58532,"rgb(36, 121, 108)"
2488,2020-05-31,Belgium,19,60,58592,"rgb(36, 121, 108)"
2489,2020-06-01,Belgium,22,48,58640,"rgb(36, 121, 108)"
2490,2020-06-02,Belgium,20,58,58698,"rgb(36, 121, 108)"
2491,2020-06-03,Belgium,20,178,58876,"rgb(36, 121, 108)"
2492,2020-06-04,Belgium,14,160,59036,"rgb(36, 121, 108)"
2493,2020-06-05,Belgium,12,168,59204,"rgb(36, 121, 108)"
2494,2020-06-06,Belgium,11,155,59359,"rgb(36, 121, 108)"
2495,2020-06-07,Belgium,11,69,59428,"rgb(36, 121, 108)"
2496,2020-06-08,Belgium,9,53,59481,"rgb(36, 121, 108)"
2497,2020-06-09,Belgium,12,150,59631,"rgb(36, 121, 108)"
2498,2020-06-10,Belgium,12,144,59775,"rgb(36, 121, 108)"
2499,2020-06-11,Belgium,7,116,59891,"rgb(36, 121, 108)"
2500,2020-06-12,Belgium,10,94,59985,"rgb(36, 121, 108)"
2501,2020-06-13,Belgium,5,88,60073,"rgb(36, 121, 108)"
2502,2020-06-14,Belgium,3,47,60120,"rgb(36, 121, 108)"
2503,2020-06-15,Belgium,8,22,60142,"rgb(36, 121, 108)"
2504,2020-06-16,Belgium,7,148,60290,"rgb(36, 121, 108)"
2505,2020-06-17,Belgium,7,97,60387,"rgb(36, 121, 108)"
2506,2020-06-18,Belgium,5,122,60509,"rgb(36, 121, 108)"
2507,2020-06-19,Belgium,4,106,60615,"rgb(36, 121, 108)"
2508,2020-06-20,Belgium,3,117,60732,"rgb(36, 121, 108)"
2509,2020-06-21,Belgium,9,49,60781,"rgb(36, 121, 108)"
2510,2020-06-22,Belgium,12,17,60798,"rgb(36, 121, 108)"
2511,2020-06-23,Belgium,4,112,60910,"rgb(36, 121, 108)"
2512,2020-06-24,Belgium,3,90,61000,"rgb(36, 121, 108)"
2513,2020-06-25,Belgium,5,13,61013,"rgb(36, 121, 108)"
2514,2020-06-26,Belgium,2,93,61106,"rgb(36, 121, 108)"
2515,2020-06-27,Belgium,6,0,61106,"rgb(36, 121, 108)"
2516,2020-06-28,Belgium,5,103,61209,"rgb(36, 121, 108)"
2517,2020-06-29,Belgium,2,152,61361,"rgb(36, 121, 108)"
2518,2020-06-30,Belgium,0,66,61427,"rgb(36, 121, 108)"
2519,2020-07-01,Belgium,2,82,61509,"rgb(36, 121, 108)"
2520,2020-07-02,Belgium,7,89,61598,"rgb(36, 121, 108)"
2521,2020-07-03,Belgium,4,129,61727,"rgb(36, 121, 108)"
2522,2020-07-04,Belgium,6,111,61838,"rgb(36, 121, 108)"
2523,2020-07-05,Belgium,0,71,61909,"rgb(36, 121, 108)"
2524,2020-07-06,Belgium,0,107,62016,"rgb(36, 121, 108)"
2525,2020-07-07,Belgium,3,42,62058,"rgb(36, 121, 108)"
2526,2020-07-08,Belgium,2,65,62123,"rgb(36, 121, 108)"
2527,2020-07-09,Belgium,2,87,62210,"rgb(36, 121, 108)"
2528,2020-07-10,Belgium,3,0,62210,"rgb(36, 121, 108)"
2529,2020-07-11,Belgium,1,259,62469,"rgb(36, 121, 108)"
2530,2020-07-12,Belgium,0,137,62606,"rgb(36, 121, 108)"
2531,2020-07-13,Belgium,0,101,62707,"rgb(36, 121, 108)"
2532,2020-03-11,Burkina Faso,0,2,2,"rgb(218, 165, 27)"
2533,2020-03-12,Burkina Faso,0,0,2,"rgb(218, 165, 27)"
2534,2020-03-15,Burkina Faso,0,1,3,"rgb(218, 165, 27)"
2535,2020-03-16,Burkina Faso,0,0,3,"rgb(218, 165, 27)"
2536,2020-03-17,Burkina Faso,0,17,20,"rgb(218, 165, 27)"
2537,2020-03-18,Burkina Faso,0,0,20,"rgb(218, 165, 27)"
2538,2020-03-19,Burkina Faso,1,6,26,"rgb(218, 165, 27)"
2539,2020-03-20,Burkina Faso,0,7,33,"rgb(218, 165, 27)"
2540,2020-03-21,Burkina Faso,0,7,40,"rgb(218, 165, 27)"
2541,2020-03-22,Burkina Faso,2,24,64,"rgb(218, 165, 27)"
2542,2020-03-23,Burkina Faso,0,0,64,"rgb(218, 165, 27)"
2543,2020-03-24,Burkina Faso,0,11,75,"rgb(218, 165, 27)"
2544,2020-03-25,Burkina Faso,0,24,99,"rgb(218, 165, 27)"
2545,2020-03-26,Burkina Faso,0,15,114,"rgb(218, 165, 27)"
2546,2020-03-27,Burkina Faso,0,32,146,"rgb(218, 165, 27)"
2547,2020-03-28,Burkina Faso,0,0,146,"rgb(218, 165, 27)"
2548,2020-03-29,Burkina Faso,6,34,180,"rgb(218, 165, 27)"
2549,2020-03-30,Burkina Faso,0,0,180,"rgb(218, 165, 27)"
2550,2020-03-31,Burkina Faso,3,42,222,"rgb(218, 165, 27)"
2551,2020-04-01,Burkina Faso,0,24,246,"rgb(218, 165, 27)"
2552,2020-04-02,Burkina Faso,2,15,261,"rgb(218, 165, 27)"
2553,2020-04-03,Burkina Faso,2,27,288,"rgb(218, 165, 27)"
2554,2020-04-04,Burkina Faso,0,0,288,"rgb(218, 165, 27)"
2555,2020-04-05,Burkina Faso,0,14,302,"rgb(218, 165, 27)"
2556,2020-04-06,Burkina Faso,1,43,345,"rgb(218, 165, 27)"
2557,2020-04-07,Burkina Faso,0,19,364,"rgb(218, 165, 27)"
2558,2020-04-08,Burkina Faso,2,20,384,"rgb(218, 165, 27)"
2559,2020-04-09,Burkina Faso,4,30,414,"rgb(218, 165, 27)"
2560,2020-04-10,Burkina Faso,1,29,443,"rgb(218, 165, 27)"
2561,2020-04-11,Burkina Faso,2,5,448,"rgb(218, 165, 27)"
2562,2020-04-12,Burkina Faso,1,36,484,"rgb(218, 165, 27)"
2563,2020-04-13,Burkina Faso,0,13,497,"rgb(218, 165, 27)"
2564,2020-04-14,Burkina Faso,1,18,515,"rgb(218, 165, 27)"
2565,2020-04-15,Burkina Faso,2,13,528,"rgb(218, 165, 27)"
2566,2020-04-16,Burkina Faso,2,14,542,"rgb(218, 165, 27)"
2567,2020-04-17,Burkina Faso,0,1,543,"rgb(218, 165, 27)"
2568,2020-04-18,Burkina Faso,3,14,557,"rgb(218, 165, 27)"
2569,2020-04-19,Burkina Faso,1,8,565,"rgb(218, 165, 27)"
2570,2020-04-20,Burkina Faso,0,11,576,"rgb(218, 165, 27)"
2571,2020-04-21,Burkina Faso,2,5,581,"rgb(218, 165, 27)"
2572,2020-04-22,Burkina Faso,0,19,600,"rgb(218, 165, 27)"
2573,2020-04-23,Burkina Faso,1,9,609,"rgb(218, 165, 27)"
2574,2020-04-24,Burkina Faso,2,7,616,"rgb(218, 165, 27)"
2575,2020-04-25,Burkina Faso,0,10,626,"rgb(218, 165, 27)"
2576,2020-04-26,Burkina Faso,0,3,629,"rgb(218, 165, 27)"
2577,2020-04-27,Burkina Faso,1,3,632,"rgb(218, 165, 27)"
2578,2020-04-28,Burkina Faso,0,3,635,"rgb(218, 165, 27)"
2579,2020-04-29,Burkina Faso,0,3,638,"rgb(218, 165, 27)"
2580,2020-04-30,Burkina Faso,1,3,641,"rgb(218, 165, 27)"
2581,2020-05-01,Burkina Faso,0,4,645,"rgb(218, 165, 27)"
2582,2020-05-02,Burkina Faso,1,4,649,"rgb(218, 165, 27)"
2583,2020-05-03,Burkina Faso,0,3,652,"rgb(218, 165, 27)"
2584,2020-05-04,Burkina Faso,1,10,662,"rgb(218, 165, 27)"
2585,2020-05-05,Burkina Faso,1,10,672,"rgb(218, 165, 27)"
2586,2020-05-06,Burkina Faso,2,16,688,"rgb(218, 165, 27)"
2587,2020-05-07,Burkina Faso,0,41,729,"rgb(218, 165, 27)"
2588,2020-05-08,Burkina Faso,0,7,736,"rgb(218, 165, 27)"
2589,2020-05-09,Burkina Faso,0,8,744,"rgb(218, 165, 27)"
2590,2020-05-10,Burkina Faso,0,4,748,"rgb(218, 165, 27)"
2591,2020-05-11,Burkina Faso,1,3,751,"rgb(218, 165, 27)"
2592,2020-05-12,Burkina Faso,1,9,760,"rgb(218, 165, 27)"
2593,2020-05-13,Burkina Faso,1,6,766,"rgb(218, 165, 27)"
2594,2020-05-14,Burkina Faso,0,7,773,"rgb(218, 165, 27)"
2595,2020-05-15,Burkina Faso,0,0,773,"rgb(218, 165, 27)"
2596,2020-05-16,Burkina Faso,0,9,782,"rgb(218, 165, 27)"
2597,2020-05-17,Burkina Faso,0,0,782,"rgb(218, 165, 27)"
2598,2020-05-18,Burkina Faso,0,14,796,"rgb(218, 165, 27)"
2599,2020-05-19,Burkina Faso,0,0,796,"rgb(218, 165, 27)"
2600,2020-05-20,Burkina Faso,1,10,806,"rgb(218, 165, 27)"
2601,2020-05-21,Burkina Faso,0,3,809,"rgb(218, 165, 27)"
2602,2020-05-22,Burkina Faso,0,3,812,"rgb(218, 165, 27)"
2603,2020-05-23,Burkina Faso,0,2,814,"rgb(218, 165, 27)"
2604,2020-05-24,Burkina Faso,0,0,814,"rgb(218, 165, 27)"
2605,2020-05-25,Burkina Faso,0,18,832,"rgb(218, 165, 27)"
2606,2020-05-26,Burkina Faso,0,9,841,"rgb(218, 165, 27)"
2607,2020-05-27,Burkina Faso,1,4,845,"rgb(218, 165, 27)"
2608,2020-05-28,Burkina Faso,0,0,845,"rgb(218, 165, 27)"
2609,2020-05-29,Burkina Faso,0,2,847,"rgb(218, 165, 27)"
2610,2020-05-30,Burkina Faso,0,0,847,"rgb(218, 165, 27)"
2611,2020-05-31,Burkina Faso,0,6,853,"rgb(218, 165, 27)"
2612,2020-06-01,Burkina Faso,0,28,881,"rgb(218, 165, 27)"
2613,2020-06-02,Burkina Faso,0,0,881,"rgb(218, 165, 27)"
2614,2020-06-03,Burkina Faso,0,2,883,"rgb(218, 165, 27)"
2615,2020-06-04,Burkina Faso,0,1,884,"rgb(218, 165, 27)"
2616,2020-06-05,Burkina Faso,0,1,885,"rgb(218, 165, 27)"
2617,2020-06-06,Burkina Faso,0,3,888,"rgb(218, 165, 27)"
2618,2020-06-07,Burkina Faso,0,0,888,"rgb(218, 165, 27)"
2619,2020-06-08,Burkina Faso,0,1,889,"rgb(218, 165, 27)"
2620,2020-06-09,Burkina Faso,0,1,890,"rgb(218, 165, 27)"
2621,2020-06-10,Burkina Faso,0,1,891,"rgb(218, 165, 27)"
2622,2020-06-11,Burkina Faso,0,0,891,"rgb(218, 165, 27)"
2623,2020-06-12,Burkina Faso,0,1,892,"rgb(218, 165, 27)"
2624,2020-06-13,Burkina Faso,0,0,892,"rgb(218, 165, 27)"
2625,2020-06-14,Burkina Faso,0,2,894,"rgb(218, 165, 27)"
2626,2020-06-15,Burkina Faso,0,0,894,"rgb(218, 165, 27)"
2627,2020-06-16,Burkina Faso,0,0,894,"rgb(218, 165, 27)"
2628,2020-06-17,Burkina Faso,0,1,895,"rgb(218, 165, 27)"
2629,2020-06-18,Burkina Faso,0,4,899,"rgb(218, 165, 27)"
2630,2020-06-19,Burkina Faso,0,0,899,"rgb(218, 165, 27)"
2631,2020-06-20,Burkina Faso,0,1,900,"rgb(218, 165, 27)"
2632,2020-06-21,Burkina Faso,0,2,902,"rgb(218, 165, 27)"
2633,2020-06-22,Burkina Faso,0,1,903,"rgb(218, 165, 27)"
2634,2020-06-23,Burkina Faso,0,4,907,"rgb(218, 165, 27)"
2635,2020-06-24,Burkina Faso,0,12,919,"rgb(218, 165, 27)"
2636,2020-06-25,Burkina Faso,0,15,934,"rgb(218, 165, 27)"
2637,2020-06-26,Burkina Faso,0,7,941,"rgb(218, 165, 27)"
2638,2020-06-27,Burkina Faso,0,0,941,"rgb(218, 165, 27)"
2639,2020-06-28,Burkina Faso,0,0,941,"rgb(218, 165, 27)"
2640,2020-06-29,Burkina Faso,0,18,959,"rgb(218, 165, 27)"
2641,2020-06-30,Burkina Faso,0,0,959,"rgb(218, 165, 27)"
2642,2020-07-01,Burkina Faso,0,3,962,"rgb(218, 165, 27)"
2643,2020-07-02,Burkina Faso,0,0,962,"rgb(218, 165, 27)"
2644,2020-07-03,Burkina Faso,0,18,980,"rgb(218, 165, 27)"
2645,2020-07-04,Burkina Faso,0,7,987,"rgb(218, 165, 27)"
2646,2020-07-05,Burkina Faso,0,0,987,"rgb(218, 165, 27)"
2647,2020-07-06,Burkina Faso,0,0,987,"rgb(218, 165, 27)"
2648,2020-07-07,Burkina Faso,0,13,1000,"rgb(218, 165, 27)"
2649,2020-07-08,Burkina Faso,0,3,1003,"rgb(218, 165, 27)"
2650,2020-07-09,Burkina Faso,0,2,1005,"rgb(218, 165, 27)"
2651,2020-07-10,Burkina Faso,0,15,1020,"rgb(218, 165, 27)"
2652,2020-07-11,Burkina Faso,0,0,1020,"rgb(218, 165, 27)"
2653,2020-07-12,Burkina Faso,0,13,1033,"rgb(218, 165, 27)"
2654,2020-07-13,Burkina Faso,0,3,1036,"rgb(218, 165, 27)"
2655,2020-03-08,Bulgaria,0,2,2,"rgb(47, 138, 196)"
2656,2020-03-09,Bulgaria,0,2,4,"rgb(47, 138, 196)"
2657,2020-03-12,Bulgaria,1,3,7,"rgb(47, 138, 196)"
2658,2020-03-13,Bulgaria,0,16,23,"rgb(47, 138, 196)"
2659,2020-03-14,Bulgaria,0,8,31,"rgb(47, 138, 196)"
2660,2020-03-15,Bulgaria,1,10,41,"rgb(47, 138, 196)"
2661,2020-03-16,Bulgaria,0,10,51,"rgb(47, 138, 196)"
2662,2020-03-17,Bulgaria,0,11,62,"rgb(47, 138, 196)"
2663,2020-03-18,Bulgaria,0,19,81,"rgb(47, 138, 196)"
2664,2020-03-19,Bulgaria,0,11,92,"rgb(47, 138, 196)"
2665,2020-03-20,Bulgaria,1,13,105,"rgb(47, 138, 196)"
2666,2020-03-21,Bulgaria,0,22,127,"rgb(47, 138, 196)"
2667,2020-03-22,Bulgaria,0,36,163,"rgb(47, 138, 196)"
2668,2020-03-23,Bulgaria,0,22,185,"rgb(47, 138, 196)"
2669,2020-03-24,Bulgaria,0,16,201,"rgb(47, 138, 196)"
2670,2020-03-25,Bulgaria,0,19,220,"rgb(47, 138, 196)"
2671,2020-03-26,Bulgaria,0,22,242,"rgb(47, 138, 196)"
2672,2020-03-27,Bulgaria,0,22,264,"rgb(47, 138, 196)"
2673,2020-03-28,Bulgaria,0,29,293,"rgb(47, 138, 196)"
2674,2020-03-29,Bulgaria,4,38,331,"rgb(47, 138, 196)"
2675,2020-03-30,Bulgaria,1,15,346,"rgb(47, 138, 196)"
2676,2020-03-31,Bulgaria,0,13,359,"rgb(47, 138, 196)"
2677,2020-04-01,Bulgaria,0,40,399,"rgb(47, 138, 196)"
2678,2020-04-02,Bulgaria,2,23,422,"rgb(47, 138, 196)"
2679,2020-04-03,Bulgaria,0,35,457,"rgb(47, 138, 196)"
2680,2020-04-04,Bulgaria,4,28,485,"rgb(47, 138, 196)"
2681,2020-04-05,Bulgaria,3,18,503,"rgb(47, 138, 196)"
2682,2020-04-06,Bulgaria,3,28,531,"rgb(47, 138, 196)"
2683,2020-04-07,Bulgaria,2,18,549,"rgb(47, 138, 196)"
2684,2020-04-08,Bulgaria,1,28,577,"rgb(47, 138, 196)"
2685,2020-04-09,Bulgaria,1,16,593,"rgb(47, 138, 196)"
2686,2020-04-10,Bulgaria,0,31,624,"rgb(47, 138, 196)"
2687,2020-04-11,Bulgaria,1,11,635,"rgb(47, 138, 196)"
2688,2020-04-12,Bulgaria,3,26,661,"rgb(47, 138, 196)"
2689,2020-04-13,Bulgaria,1,14,675,"rgb(47, 138, 196)"
2690,2020-04-14,Bulgaria,3,10,685,"rgb(47, 138, 196)"
2691,2020-04-15,Bulgaria,3,28,713,"rgb(47, 138, 196)"
2692,2020-04-16,Bulgaria,1,34,747,"rgb(47, 138, 196)"
2693,2020-04-17,Bulgaria,2,53,800,"rgb(47, 138, 196)"
2694,2020-04-18,Bulgaria,3,46,846,"rgb(47, 138, 196)"
2695,2020-04-19,Bulgaria,0,32,878,"rgb(47, 138, 196)"
2696,2020-04-20,Bulgaria,2,37,915,"rgb(47, 138, 196)"
2697,2020-04-21,Bulgaria,0,14,929,"rgb(47, 138, 196)"
2698,2020-04-22,Bulgaria,2,46,975,"rgb(47, 138, 196)"
2699,2020-04-23,Bulgaria,4,49,1024,"rgb(47, 138, 196)"
2700,2020-04-24,Bulgaria,3,73,1097,"rgb(47, 138, 196)"
2701,2020-04-25,Bulgaria,2,91,1188,"rgb(47, 138, 196)"
2702,2020-04-26,Bulgaria,1,59,1247,"rgb(47, 138, 196)"
2703,2020-04-27,Bulgaria,1,53,1300,"rgb(47, 138, 196)"
2704,2020-04-28,Bulgaria,2,63,1363,"rgb(47, 138, 196)"
2705,2020-04-29,Bulgaria,0,36,1399,"rgb(47, 138, 196)"
2706,2020-04-30,Bulgaria,6,48,1447,"rgb(47, 138, 196)"
2707,2020-05-01,Bulgaria,2,59,1506,"rgb(47, 138, 196)"
2708,2020-05-02,Bulgaria,3,82,1588,"rgb(47, 138, 196)"
2709,2020-05-03,Bulgaria,3,6,1594,"rgb(47, 138, 196)"
2710,2020-05-04,Bulgaria,1,24,1618,"rgb(47, 138, 196)"
2711,2020-05-05,Bulgaria,5,34,1652,"rgb(47, 138, 196)"
2712,2020-05-06,Bulgaria,0,37,1689,"rgb(47, 138, 196)"
2713,2020-05-07,Bulgaria,6,89,1778,"rgb(47, 138, 196)"
2714,2020-05-08,Bulgaria,0,51,1829,"rgb(47, 138, 196)"
2715,2020-05-09,Bulgaria,4,82,1911,"rgb(47, 138, 196)"
2716,2020-05-10,Bulgaria,2,44,1955,"rgb(47, 138, 196)"
2717,2020-05-11,Bulgaria,1,10,1965,"rgb(47, 138, 196)"
2718,2020-05-12,Bulgaria,2,25,1990,"rgb(47, 138, 196)"
2719,2020-05-13,Bulgaria,2,33,2023,"rgb(47, 138, 196)"
2720,2020-05-14,Bulgaria,1,46,2069,"rgb(47, 138, 196)"
2721,2020-05-15,Bulgaria,3,31,2100,"rgb(47, 138, 196)"
2722,2020-05-16,Bulgaria,3,38,2138,"rgb(47, 138, 196)"
2723,2020-05-17,Bulgaria,6,73,2211,"rgb(47, 138, 196)"
2724,2020-05-18,Bulgaria,2,24,2235,"rgb(47, 138, 196)"
2725,2020-05-19,Bulgaria,2,24,2259,"rgb(47, 138, 196)"
2726,2020-05-20,Bulgaria,4,33,2292,"rgb(47, 138, 196)"
2727,2020-05-21,Bulgaria,4,39,2331,"rgb(47, 138, 196)"
2728,2020-05-22,Bulgaria,5,41,2372,"rgb(47, 138, 196)"
2729,2020-05-23,Bulgaria,1,36,2408,"rgb(47, 138, 196)"
2730,2020-05-24,Bulgaria,0,0,2408,"rgb(47, 138, 196)"
2731,2020-05-25,Bulgaria,4,25,2433,"rgb(47, 138, 196)"
2732,2020-05-26,Bulgaria,0,0,2433,"rgb(47, 138, 196)"
2733,2020-05-27,Bulgaria,3,27,2460,"rgb(47, 138, 196)"
2734,2020-05-28,Bulgaria,0,0,2460,"rgb(47, 138, 196)"
2735,2020-05-29,Bulgaria,3,25,2485,"rgb(47, 138, 196)"
2736,2020-05-30,Bulgaria,3,14,2499,"rgb(47, 138, 196)"
2737,2020-05-31,Bulgaria,1,14,2513,"rgb(47, 138, 196)"
2738,2020-06-01,Bulgaria,0,0,2513,"rgb(47, 138, 196)"
2739,2020-06-02,Bulgaria,4,0,2513,"rgb(47, 138, 196)"
2740,2020-06-03,Bulgaria,0,25,2538,"rgb(47, 138, 196)"
2741,2020-06-04,Bulgaria,3,47,2585,"rgb(47, 138, 196)"
2742,2020-06-05,Bulgaria,0,0,2585,"rgb(47, 138, 196)"
2743,2020-06-06,Bulgaria,13,83,2668,"rgb(47, 138, 196)"
2744,2020-06-07,Bulgaria,0,43,2711,"rgb(47, 138, 196)"
2745,2020-06-08,Bulgaria,0,16,2727,"rgb(47, 138, 196)"
2746,2020-06-09,Bulgaria,4,83,2810,"rgb(47, 138, 196)"
2747,2020-06-10,Bulgaria,3,79,2889,"rgb(47, 138, 196)"
2748,2020-06-11,Bulgaria,0,0,2889,"rgb(47, 138, 196)"
2749,2020-06-12,Bulgaria,1,197,3086,"rgb(47, 138, 196)"
2750,2020-06-13,Bulgaria,4,105,3191,"rgb(47, 138, 196)"
2751,2020-06-14,Bulgaria,0,75,3266,"rgb(47, 138, 196)"
2752,2020-06-15,Bulgaria,2,24,3290,"rgb(47, 138, 196)"
2753,2020-06-16,Bulgaria,2,51,3341,"rgb(47, 138, 196)"
2754,2020-06-17,Bulgaria,5,112,3453,"rgb(47, 138, 196)"
2755,2020-06-18,Bulgaria,3,89,3542,"rgb(47, 138, 196)"
2756,2020-06-19,Bulgaria,6,132,3674,"rgb(47, 138, 196)"
2757,2020-06-20,Bulgaria,3,81,3755,"rgb(47, 138, 196)"
2758,2020-06-21,Bulgaria,6,117,3872,"rgb(47, 138, 196)"
2759,2020-06-22,Bulgaria,0,33,3905,"rgb(47, 138, 196)"
2760,2020-06-23,Bulgaria,8,79,3984,"rgb(47, 138, 196)"
2761,2020-06-24,Bulgaria,1,130,4114,"rgb(47, 138, 196)"
2762,2020-06-25,Bulgaria,1,128,4242,"rgb(47, 138, 196)"
2763,2020-06-26,Bulgaria,2,166,4408,"rgb(47, 138, 196)"
2764,2020-06-27,Bulgaria,4,105,4513,"rgb(47, 138, 196)"
2765,2020-06-28,Bulgaria,1,112,4625,"rgb(47, 138, 196)"
2766,2020-06-29,Bulgaria,3,66,4691,"rgb(47, 138, 196)"
2767,2020-06-30,Bulgaria,4,140,4831,"rgb(47, 138, 196)"
2768,2020-07-01,Bulgaria,7,158,4989,"rgb(47, 138, 196)"
2769,2020-07-02,Bulgaria,2,165,5154,"rgb(47, 138, 196)"
2770,2020-07-03,Bulgaria,0,161,5315,"rgb(47, 138, 196)"
2771,2020-07-04,Bulgaria,7,182,5497,"rgb(47, 138, 196)"
2772,2020-07-05,Bulgaria,2,180,5677,"rgb(47, 138, 196)"
2773,2020-07-06,Bulgaria,5,63,5740,"rgb(47, 138, 196)"
2774,2020-07-07,Bulgaria,4,174,5914,"rgb(47, 138, 196)"
2775,2020-07-08,Bulgaria,4,188,6102,"rgb(47, 138, 196)"
2776,2020-07-09,Bulgaria,5,240,6342,"rgb(47, 138, 196)"
2777,2020-07-10,Bulgaria,3,330,6672,"rgb(47, 138, 196)"
2778,2020-07-11,Bulgaria,0,0,6672,"rgb(47, 138, 196)"
2779,2020-07-12,Bulgaria,0,0,6672,"rgb(47, 138, 196)"
2780,2020-07-13,Bulgaria,6,853,7525,"rgb(47, 138, 196)"
2781,2019-12-31,Bahrain,0,0,0,"rgb(118, 78, 159)"
2782,2020-01-01,Bahrain,0,0,0,"rgb(118, 78, 159)"
2783,2020-01-02,Bahrain,0,0,0,"rgb(118, 78, 159)"
2784,2020-01-03,Bahrain,0,0,0,"rgb(118, 78, 159)"
2785,2020-01-04,Bahrain,0,0,0,"rgb(118, 78, 159)"
2786,2020-01-05,Bahrain,0,0,0,"rgb(118, 78, 159)"
2787,2020-01-06,Bahrain,0,0,0,"rgb(118, 78, 159)"
2788,2020-01-07,Bahrain,0,0,0,"rgb(118, 78, 159)"
2789,2020-01-08,Bahrain,0,0,0,"rgb(118, 78, 159)"
2790,2020-01-09,Bahrain,0,0,0,"rgb(118, 78, 159)"
2791,2020-01-10,Bahrain,0,0,0,"rgb(118, 78, 159)"
2792,2020-01-11,Bahrain,0,0,0,"rgb(118, 78, 159)"
2793,2020-01-12,Bahrain,0,0,0,"rgb(118, 78, 159)"
2794,2020-01-13,Bahrain,0,0,0,"rgb(118, 78, 159)"
2795,2020-01-14,Bahrain,0,0,0,"rgb(118, 78, 159)"
2796,2020-01-15,Bahrain,0,0,0,"rgb(118, 78, 159)"
2797,2020-01-16,Bahrain,0,0,0,"rgb(118, 78, 159)"
2798,2020-01-17,Bahrain,0,0,0,"rgb(118, 78, 159)"
2799,2020-01-18,Bahrain,0,0,0,"rgb(118, 78, 159)"
2800,2020-01-19,Bahrain,0,0,0,"rgb(118, 78, 159)"
2801,2020-01-20,Bahrain,0,0,0,"rgb(118, 78, 159)"
2802,2020-01-21,Bahrain,0,0,0,"rgb(118, 78, 159)"
2803,2020-01-22,Bahrain,0,0,0,"rgb(118, 78, 159)"
2804,2020-01-23,Bahrain,0,0,0,"rgb(118, 78, 159)"
2805,2020-01-24,Bahrain,0,0,0,"rgb(118, 78, 159)"
2806,2020-01-25,Bahrain,0,0,0,"rgb(118, 78, 159)"
2807,2020-01-26,Bahrain,0,0,0,"rgb(118, 78, 159)"
2808,2020-01-27,Bahrain,0,0,0,"rgb(118, 78, 159)"
2809,2020-01-28,Bahrain,0,0,0,"rgb(118, 78, 159)"
2810,2020-01-29,Bahrain,0,0,0,"rgb(118, 78, 159)"
2811,2020-01-30,Bahrain,0,0,0,"rgb(118, 78, 159)"
2812,2020-01-31,Bahrain,0,0,0,"rgb(118, 78, 159)"
2813,2020-02-01,Bahrain,0,0,0,"rgb(118, 78, 159)"
2814,2020-02-02,Bahrain,0,0,0,"rgb(118, 78, 159)"
2815,2020-02-03,Bahrain,0,0,0,"rgb(118, 78, 159)"
2816,2020-02-04,Bahrain,0,0,0,"rgb(118, 78, 159)"
2817,2020-02-05,Bahrain,0,0,0,"rgb(118, 78, 159)"
2818,2020-02-06,Bahrain,0,0,0,"rgb(118, 78, 159)"
2819,2020-02-07,Bahrain,0,0,0,"rgb(118, 78, 159)"
2820,2020-02-08,Bahrain,0,0,0,"rgb(118, 78, 159)"
2821,2020-02-09,Bahrain,0,0,0,"rgb(118, 78, 159)"
2822,2020-02-10,Bahrain,0,0,0,"rgb(118, 78, 159)"
2823,2020-02-11,Bahrain,0,0,0,"rgb(118, 78, 159)"
2824,2020-02-12,Bahrain,0,0,0,"rgb(118, 78, 159)"
2825,2020-02-13,Bahrain,0,0,0,"rgb(118, 78, 159)"
2826,2020-02-14,Bahrain,0,0,0,"rgb(118, 78, 159)"
2827,2020-02-15,Bahrain,0,0,0,"rgb(118, 78, 159)"
2828,2020-02-16,Bahrain,0,0,0,"rgb(118, 78, 159)"
2829,2020-02-17,Bahrain,0,0,0,"rgb(118, 78, 159)"
2830,2020-02-18,Bahrain,0,0,0,"rgb(118, 78, 159)"
2831,2020-02-19,Bahrain,0,0,0,"rgb(118, 78, 159)"
2832,2020-02-20,Bahrain,0,0,0,"rgb(118, 78, 159)"
2833,2020-02-21,Bahrain,0,0,0,"rgb(118, 78, 159)"
2834,2020-02-22,Bahrain,0,0,0,"rgb(118, 78, 159)"
2835,2020-02-23,Bahrain,0,0,0,"rgb(118, 78, 159)"
2836,2020-02-24,Bahrain,0,1,1,"rgb(118, 78, 159)"
2837,2020-02-25,Bahrain,0,1,2,"rgb(118, 78, 159)"
2838,2020-02-26,Bahrain,0,21,23,"rgb(118, 78, 159)"
2839,2020-02-27,Bahrain,0,10,33,"rgb(118, 78, 159)"
2840,2020-02-28,Bahrain,0,0,33,"rgb(118, 78, 159)"
2841,2020-02-29,Bahrain,0,5,38,"rgb(118, 78, 159)"
2842,2020-03-01,Bahrain,0,3,41,"rgb(118, 78, 159)"
2843,2020-03-02,Bahrain,0,6,47,"rgb(118, 78, 159)"
2844,2020-03-04,Bahrain,0,2,49,"rgb(118, 78, 159)"
2845,2020-03-05,Bahrain,0,3,52,"rgb(118, 78, 159)"
2846,2020-03-06,Bahrain,0,0,52,"rgb(118, 78, 159)"
2847,2020-03-07,Bahrain,0,4,56,"rgb(118, 78, 159)"
2848,2020-03-08,Bahrain,0,7,63,"rgb(118, 78, 159)"
2849,2020-03-09,Bahrain,0,16,79,"rgb(118, 78, 159)"
2850,2020-03-10,Bahrain,0,30,109,"rgb(118, 78, 159)"
2851,2020-03-11,Bahrain,0,1,110,"rgb(118, 78, 159)"
2852,2020-03-12,Bahrain,0,52,162,"rgb(118, 78, 159)"
2853,2020-03-13,Bahrain,0,0,162,"rgb(118, 78, 159)"
2854,2020-03-14,Bahrain,0,48,210,"rgb(118, 78, 159)"
2855,2020-03-15,Bahrain,0,1,211,"rgb(118, 78, 159)"
2856,2020-03-16,Bahrain,0,3,214,"rgb(118, 78, 159)"
2857,2020-03-17,Bahrain,1,7,221,"rgb(118, 78, 159)"
2858,2020-03-18,Bahrain,0,16,237,"rgb(118, 78, 159)"
2859,2020-03-19,Bahrain,0,19,256,"rgb(118, 78, 159)"
2860,2020-03-20,Bahrain,0,13,269,"rgb(118, 78, 159)"
2861,2020-03-21,Bahrain,0,16,285,"rgb(118, 78, 159)"
2862,2020-03-22,Bahrain,0,21,306,"rgb(118, 78, 159)"
2863,2020-03-23,Bahrain,1,28,334,"rgb(118, 78, 159)"
2864,2020-03-24,Bahrain,0,5,339,"rgb(118, 78, 159)"
2865,2020-03-25,Bahrain,1,51,390,"rgb(118, 78, 159)"
2866,2020-03-26,Bahrain,0,29,419,"rgb(118, 78, 159)"
2867,2020-03-27,Bahrain,1,39,458,"rgb(118, 78, 159)"
2868,2020-03-28,Bahrain,0,8,466,"rgb(118, 78, 159)"
2869,2020-03-29,Bahrain,0,7,473,"rgb(118, 78, 159)"
2870,2020-03-30,Bahrain,0,27,500,"rgb(118, 78, 159)"
2871,2020-03-31,Bahrain,0,15,515,"rgb(118, 78, 159)"
2872,2020-04-01,Bahrain,0,52,567,"rgb(118, 78, 159)"
2873,2020-04-02,Bahrain,0,2,569,"rgb(118, 78, 159)"
2874,2020-04-03,Bahrain,0,74,643,"rgb(118, 78, 159)"
2875,2020-04-04,Bahrain,0,0,643,"rgb(118, 78, 159)"
2876,2020-04-05,Bahrain,0,45,688,"rgb(118, 78, 159)"
2877,2020-04-06,Bahrain,0,12,700,"rgb(118, 78, 159)"
2878,2020-04-07,Bahrain,0,56,756,"rgb(118, 78, 159)"
2879,2020-04-08,Bahrain,1,55,811,"rgb(118, 78, 159)"
2880,2020-04-09,Bahrain,0,12,823,"rgb(118, 78, 159)"
2881,2020-04-10,Bahrain,0,64,887,"rgb(118, 78, 159)"
2882,2020-04-11,Bahrain,1,111,998,"rgb(118, 78, 159)"
2883,2020-04-12,Bahrain,0,42,1040,"rgb(118, 78, 159)"
2884,2020-04-13,Bahrain,0,96,1136,"rgb(118, 78, 159)"
2885,2020-04-14,Bahrain,1,225,1361,"rgb(118, 78, 159)"
2886,2020-04-15,Bahrain,0,167,1528,"rgb(118, 78, 159)"
2887,2020-04-16,Bahrain,0,145,1673,"rgb(118, 78, 159)"
2888,2020-04-17,Bahrain,0,27,1700,"rgb(118, 78, 159)"
2889,2020-04-18,Bahrain,0,44,1744,"rgb(118, 78, 159)"
2890,2020-04-19,Bahrain,0,29,1773,"rgb(118, 78, 159)"
2891,2020-04-20,Bahrain,0,100,1873,"rgb(118, 78, 159)"
2892,2020-04-21,Bahrain,0,34,1907,"rgb(118, 78, 159)"
2893,2020-04-22,Bahrain,0,66,1973,"rgb(118, 78, 159)"
2894,2020-04-23,Bahrain,0,34,2007,"rgb(118, 78, 159)"
2895,2020-04-24,Bahrain,1,210,2217,"rgb(118, 78, 159)"
2896,2020-04-25,Bahrain,0,301,2518,"rgb(118, 78, 159)"
2897,2020-04-26,Bahrain,0,71,2589,"rgb(118, 78, 159)"
2898,2020-04-27,Bahrain,0,58,2647,"rgb(118, 78, 159)"
2899,2020-04-28,Bahrain,0,76,2723,"rgb(118, 78, 159)"
2900,2020-04-29,Bahrain,0,88,2811,"rgb(118, 78, 159)"
2901,2020-04-30,Bahrain,0,110,2921,"rgb(118, 78, 159)"
2902,2020-05-01,Bahrain,0,119,3040,"rgb(118, 78, 159)"
2903,2020-05-02,Bahrain,0,130,3170,"rgb(118, 78, 159)"
2904,2020-05-03,Bahrain,0,114,3284,"rgb(118, 78, 159)"
2905,2020-05-04,Bahrain,0,99,3383,"rgb(118, 78, 159)"
2906,2020-05-05,Bahrain,0,150,3533,"rgb(118, 78, 159)"
2907,2020-05-06,Bahrain,0,187,3720,"rgb(118, 78, 159)"
2908,2020-05-07,Bahrain,0,214,3934,"rgb(118, 78, 159)"
2909,2020-05-08,Bahrain,0,265,4199,"rgb(118, 78, 159)"
2910,2020-05-09,Bahrain,0,245,4444,"rgb(118, 78, 159)"
2911,2020-05-10,Bahrain,0,330,4774,"rgb(118, 78, 159)"
2912,2020-05-11,Bahrain,0,167,4941,"rgb(118, 78, 159)"
2913,2020-05-12,Bahrain,0,295,5236,"rgb(118, 78, 159)"
2914,2020-05-13,Bahrain,1,295,5531,"rgb(118, 78, 159)"
2915,2020-05-14,Bahrain,1,285,5816,"rgb(118, 78, 159)"
2916,2020-05-15,Bahrain,0,382,6198,"rgb(118, 78, 159)"
2917,2020-05-16,Bahrain,2,385,6583,"rgb(118, 78, 159)"
2918,2020-05-17,Bahrain,0,164,6747,"rgb(118, 78, 159)"
2919,2020-05-18,Bahrain,0,209,6956,"rgb(118, 78, 159)"
2920,2020-05-19,Bahrain,0,228,7184,"rgb(118, 78, 159)"
2921,2020-05-20,Bahrain,0,348,7532,"rgb(118, 78, 159)"
2922,2020-05-21,Bahrain,0,356,7888,"rgb(118, 78, 159)"
2923,2020-05-22,Bahrain,0,286,8174,"rgb(118, 78, 159)"
2924,2020-05-23,Bahrain,0,240,8414,"rgb(118, 78, 159)"
2925,2020-05-24,Bahrain,1,388,8802,"rgb(118, 78, 159)"
2926,2020-05-25,Bahrain,1,336,9138,"rgb(118, 78, 159)"
2927,2020-05-26,Bahrain,0,33,9171,"rgb(118, 78, 159)"
2928,2020-05-27,Bahrain,0,195,9366,"rgb(118, 78, 159)"
2929,2020-05-28,Bahrain,1,267,9633,"rgb(118, 78, 159)"
2930,2020-05-29,Bahrain,0,419,10052,"rgb(118, 78, 159)"
2931,2020-05-30,Bahrain,0,397,10449,"rgb(118, 78, 159)"
2932,2020-05-31,Bahrain,2,344,10793,"rgb(118, 78, 159)"
2933,2020-06-01,Bahrain,2,605,11398,"rgb(118, 78, 159)"
2934,2020-06-02,Bahrain,0,406,11804,"rgb(118, 78, 159)"
2935,2020-06-03,Bahrain,0,507,12311,"rgb(118, 78, 159)"
2936,2020-06-04,Bahrain,1,504,12815,"rgb(118, 78, 159)"
2937,2020-06-05,Bahrain,1,481,13296,"rgb(118, 78, 159)"
2938,2020-06-06,Bahrain,2,539,13835,"rgb(118, 78, 159)"
2939,2020-06-07,Bahrain,1,548,14383,"rgb(118, 78, 159)"
2940,2020-06-08,Bahrain,2,380,14763,"rgb(118, 78, 159)"
2941,2020-06-09,Bahrain,0,654,15417,"rgb(118, 78, 159)"
2942,2020-06-10,Bahrain,3,783,16200,"rgb(118, 78, 159)"
2943,2020-06-11,Bahrain,2,0,16200,"rgb(118, 78, 159)"
2944,2020-06-12,Bahrain,5,1069,17269,"rgb(118, 78, 159)"
2945,2020-06-13,Bahrain,0,444,17713,"rgb(118, 78, 159)"
2946,2020-06-14,Bahrain,3,514,18227,"rgb(118, 78, 159)"
2947,2020-06-15,Bahrain,4,0,18227,"rgb(118, 78, 159)"
2948,2020-06-16,Bahrain,3,786,19013,"rgb(118, 78, 159)"
2949,2020-06-17,Bahrain,1,540,19553,"rgb(118, 78, 159)"
2950,2020-06-18,Bahrain,2,408,19961,"rgb(118, 78, 159)"
2951,2020-06-19,Bahrain,6,469,20430,"rgb(118, 78, 159)"
2952,2020-06-20,Bahrain,2,486,20916,"rgb(118, 78, 159)"
2953,2020-06-21,Bahrain,3,415,21331,"rgb(118, 78, 159)"
2954,2020-06-22,Bahrain,3,433,21764,"rgb(118, 78, 159)"
2955,2020-06-23,Bahrain,2,643,22407,"rgb(118, 78, 159)"
2956,2020-06-24,Bahrain,2,655,23062,"rgb(118, 78, 159)"
2957,2020-06-25,Bahrain,2,508,23570,"rgb(118, 78, 159)"
2958,2020-06-26,Bahrain,2,511,24081,"rgb(118, 78, 159)"
2959,2020-06-27,Bahrain,7,724,24805,"rgb(118, 78, 159)"
2960,2020-06-28,Bahrain,0,462,25267,"rgb(118, 78, 159)"
2961,2020-06-29,Bahrain,5,438,25705,"rgb(118, 78, 159)"
2962,2020-06-30,Bahrain,1,534,26239,"rgb(118, 78, 159)"
2963,2020-07-01,Bahrain,3,519,26758,"rgb(118, 78, 159)"
2964,2020-07-02,Bahrain,5,656,27414,"rgb(118, 78, 159)"
2965,2020-07-03,Bahrain,2,423,27837,"rgb(118, 78, 159)"
2966,2020-07-04,Bahrain,1,573,28410,"rgb(118, 78, 159)"
2967,2020-07-05,Bahrain,2,447,28857,"rgb(118, 78, 159)"
2968,2020-07-06,Bahrain,0,510,29367,"rgb(118, 78, 159)"
2969,2020-07-07,Bahrain,1,454,29821,"rgb(118, 78, 159)"
2970,2020-07-08,Bahrain,0,500,30321,"rgb(118, 78, 159)"
2971,2020-07-09,Bahrain,2,610,30931,"rgb(118, 78, 159)"
2972,2020-07-10,Bahrain,3,597,31528,"rgb(118, 78, 159)"
2973,2020-07-11,Bahrain,1,511,32039,"rgb(118, 78, 159)"
2974,2020-07-12,Bahrain,0,431,32470,"rgb(118, 78, 159)"
2975,2020-07-13,Bahrain,5,471,32941,"rgb(118, 78, 159)"
2976,2020-04-01,Burundi,0,2,2,"rgb(237, 100, 90)"
2977,2020-04-02,Burundi,0,0,2,"rgb(237, 100, 90)"
2978,2020-04-03,Burundi,0,1,3,"rgb(237, 100, 90)"
2979,2020-04-04,Burundi,0,0,3,"rgb(237, 100, 90)"
2980,2020-04-05,Burundi,0,0,3,"rgb(237, 100, 90)"
2981,2020-04-06,Burundi,0,0,3,"rgb(237, 100, 90)"
2982,2020-04-07,Burundi,0,0,3,"rgb(237, 100, 90)"
2983,2020-04-08,Burundi,0,0,3,"rgb(237, 100, 90)"
2984,2020-04-09,Burundi,0,0,3,"rgb(237, 100, 90)"
2985,2020-04-10,Burundi,0,0,3,"rgb(237, 100, 90)"
2986,2020-04-11,Burundi,0,0,3,"rgb(237, 100, 90)"
2987,2020-04-12,Burundi,0,2,5,"rgb(237, 100, 90)"
2988,2020-04-13,Burundi,0,0,5,"rgb(237, 100, 90)"
2989,2020-04-14,Burundi,0,0,5,"rgb(237, 100, 90)"
2990,2020-04-15,Burundi,1,0,5,"rgb(237, 100, 90)"
2991,2020-04-16,Burundi,0,0,5,"rgb(237, 100, 90)"
2992,2020-04-17,Burundi,0,0,5,"rgb(237, 100, 90)"
2993,2020-04-18,Burundi,0,1,6,"rgb(237, 100, 90)"
2994,2020-04-19,Burundi,0,0,6,"rgb(237, 100, 90)"
2995,2020-04-20,Burundi,0,0,6,"rgb(237, 100, 90)"
2996,2020-04-21,Burundi,0,0,6,"rgb(237, 100, 90)"
2997,2020-04-22,Burundi,0,0,6,"rgb(237, 100, 90)"
2998,2020-04-23,Burundi,0,5,11,"rgb(237, 100, 90)"
2999,2020-04-24,Burundi,0,0,11,"rgb(237, 100, 90)"
3000,2020-04-25,Burundi,0,1,12,"rgb(237, 100, 90)"
3001,2020-04-26,Burundi,0,3,15,"rgb(237, 100, 90)"
3002,2020-04-27,Burundi,0,0,15,"rgb(237, 100, 90)"
3003,2020-04-28,Burundi,0,0,15,"rgb(237, 100, 90)"
3004,2020-04-29,Burundi,0,0,15,"rgb(237, 100, 90)"
3005,2020-04-30,Burundi,0,0,15,"rgb(237, 100, 90)"
3006,2020-05-01,Burundi,0,0,15,"rgb(237, 100, 90)"
3007,2020-05-02,Burundi,0,0,15,"rgb(237, 100, 90)"
3008,2020-05-03,Burundi,0,4,19,"rgb(237, 100, 90)"
3009,2020-05-04,Burundi,0,0,19,"rgb(237, 100, 90)"
3010,2020-05-05,Burundi,0,0,19,"rgb(237, 100, 90)"
3011,2020-05-06,Burundi,0,0,19,"rgb(237, 100, 90)"
3012,2020-05-07,Burundi,0,0,19,"rgb(237, 100, 90)"
3013,2020-05-08,Burundi,0,0,19,"rgb(237, 100, 90)"
3014,2020-05-09,Burundi,0,0,19,"rgb(237, 100, 90)"
3015,2020-05-10,Burundi,0,0,19,"rgb(237, 100, 90)"
3016,2020-05-11,Burundi,0,0,19,"rgb(237, 100, 90)"
3017,2020-05-12,Burundi,0,0,19,"rgb(237, 100, 90)"
3018,2020-05-13,Burundi,0,8,27,"rgb(237, 100, 90)"
3019,2020-05-14,Burundi,0,0,27,"rgb(237, 100, 90)"
3020,2020-05-15,Burundi,0,0,27,"rgb(237, 100, 90)"
3021,2020-05-16,Burundi,0,0,27,"rgb(237, 100, 90)"
3022,2020-05-17,Burundi,0,0,27,"rgb(237, 100, 90)"
3023,2020-05-18,Burundi,0,15,42,"rgb(237, 100, 90)"
3024,2020-05-19,Burundi,0,0,42,"rgb(237, 100, 90)"
3025,2020-05-20,Burundi,0,0,42,"rgb(237, 100, 90)"
3026,2020-05-21,Burundi,0,0,42,"rgb(237, 100, 90)"
3027,2020-05-22,Burundi,0,0,42,"rgb(237, 100, 90)"
3028,2020-05-23,Burundi,0,0,42,"rgb(237, 100, 90)"
3029,2020-05-24,Burundi,0,0,42,"rgb(237, 100, 90)"
3030,2020-05-25,Burundi,0,0,42,"rgb(237, 100, 90)"
3031,2020-05-26,Burundi,0,0,42,"rgb(237, 100, 90)"
3032,2020-05-27,Burundi,0,0,42,"rgb(237, 100, 90)"
3033,2020-05-28,Burundi,0,0,42,"rgb(237, 100, 90)"
3034,2020-05-29,Burundi,0,0,42,"rgb(237, 100, 90)"
3035,2020-05-30,Burundi,0,0,42,"rgb(237, 100, 90)"
3036,2020-05-31,Burundi,0,0,42,"rgb(237, 100, 90)"
3037,2020-06-01,Burundi,0,21,63,"rgb(237, 100, 90)"
3038,2020-06-02,Burundi,0,0,63,"rgb(237, 100, 90)"
3039,2020-06-03,Burundi,0,0,63,"rgb(237, 100, 90)"
3040,2020-06-04,Burundi,0,0,63,"rgb(237, 100, 90)"
3041,2020-06-05,Burundi,0,0,63,"rgb(237, 100, 90)"
3042,2020-06-06,Burundi,0,0,63,"rgb(237, 100, 90)"
3043,2020-06-07,Burundi,0,20,83,"rgb(237, 100, 90)"
3044,2020-06-08,Burundi,0,0,83,"rgb(237, 100, 90)"
3045,2020-06-09,Burundi,0,0,83,"rgb(237, 100, 90)"
3046,2020-06-10,Burundi,0,0,83,"rgb(237, 100, 90)"
3047,2020-06-11,Burundi,0,0,83,"rgb(237, 100, 90)"
3048,2020-06-12,Burundi,0,11,94,"rgb(237, 100, 90)"
3049,2020-06-13,Burundi,0,0,94,"rgb(237, 100, 90)"
3050,2020-06-14,Burundi,0,0,94,"rgb(237, 100, 90)"
3051,2020-06-15,Burundi,0,0,94,"rgb(237, 100, 90)"
3052,2020-06-16,Burundi,0,10,104,"rgb(237, 100, 90)"
3053,2020-06-17,Burundi,0,0,104,"rgb(237, 100, 90)"
3054,2020-06-18,Burundi,0,0,104,"rgb(237, 100, 90)"
3055,2020-06-19,Burundi,0,0,104,"rgb(237, 100, 90)"
3056,2020-06-20,Burundi,0,0,104,"rgb(237, 100, 90)"
3057,2020-06-21,Burundi,0,40,144,"rgb(237, 100, 90)"
3058,2020-06-22,Burundi,0,0,144,"rgb(237, 100, 90)"
3059,2020-06-23,Burundi,0,0,144,"rgb(237, 100, 90)"
3060,2020-06-24,Burundi,0,0,144,"rgb(237, 100, 90)"
3061,2020-06-25,Burundi,0,0,144,"rgb(237, 100, 90)"
3062,2020-06-26,Burundi,0,0,144,"rgb(237, 100, 90)"
3063,2020-06-27,Burundi,0,0,144,"rgb(237, 100, 90)"
3064,2020-06-28,Burundi,0,0,144,"rgb(237, 100, 90)"
3065,2020-06-29,Burundi,0,26,170,"rgb(237, 100, 90)"
3066,2020-06-30,Burundi,0,0,170,"rgb(237, 100, 90)"
3067,2020-07-01,Burundi,0,0,170,"rgb(237, 100, 90)"
3068,2020-07-02,Burundi,0,0,170,"rgb(237, 100, 90)"
3069,2020-07-03,Burundi,0,0,170,"rgb(237, 100, 90)"
3070,2020-07-04,Burundi,0,21,191,"rgb(237, 100, 90)"
3071,2020-07-05,Burundi,0,0,191,"rgb(237, 100, 90)"
3072,2020-07-06,Burundi,0,0,191,"rgb(237, 100, 90)"
3073,2020-07-07,Burundi,0,0,191,"rgb(237, 100, 90)"
3074,2020-07-08,Burundi,0,0,191,"rgb(237, 100, 90)"
3075,2020-07-09,Burundi,0,0,191,"rgb(237, 100, 90)"
3076,2020-07-10,Burundi,0,28,219,"rgb(237, 100, 90)"
3077,2020-07-11,Burundi,0,7,226,"rgb(237, 100, 90)"
3078,2020-07-12,Burundi,0,24,250,"rgb(237, 100, 90)"
3079,2020-07-13,Burundi,0,0,250,"rgb(237, 100, 90)"
3080,2020-03-17,Benin,0,1,1,"rgb(165, 170, 153)"
3081,2020-03-18,Benin,0,0,1,"rgb(165, 170, 153)"
3082,2020-03-19,Benin,0,0,1,"rgb(165, 170, 153)"
3083,2020-03-20,Benin,0,1,2,"rgb(165, 170, 153)"
3084,2020-03-21,Benin,0,0,2,"rgb(165, 170, 153)"
3085,2020-03-22,Benin,0,0,2,"rgb(165, 170, 153)"
3086,2020-03-23,Benin,0,0,2,"rgb(165, 170, 153)"
3087,2020-03-24,Benin,0,3,5,"rgb(165, 170, 153)"
3088,2020-03-25,Benin,0,0,5,"rgb(165, 170, 153)"
3089,2020-03-26,Benin,0,0,5,"rgb(165, 170, 153)"
3090,2020-03-27,Benin,0,1,6,"rgb(165, 170, 153)"
3091,2020-03-28,Benin,0,0,6,"rgb(165, 170, 153)"
3092,2020-03-29,Benin,0,0,6,"rgb(165, 170, 153)"
3093,2020-03-30,Benin,0,0,6,"rgb(165, 170, 153)"
3094,2020-03-31,Benin,0,0,6,"rgb(165, 170, 153)"
3095,2020-04-01,Benin,0,2,8,"rgb(165, 170, 153)"
3096,2020-04-02,Benin,0,5,13,"rgb(165, 170, 153)"
3097,2020-04-03,Benin,0,0,13,"rgb(165, 170, 153)"
3098,2020-04-04,Benin,0,3,16,"rgb(165, 170, 153)"
3099,2020-04-05,Benin,0,0,16,"rgb(165, 170, 153)"
3100,2020-04-06,Benin,0,6,22,"rgb(165, 170, 153)"
3101,2020-04-07,Benin,1,4,26,"rgb(165, 170, 153)"
3102,2020-04-08,Benin,0,0,26,"rgb(165, 170, 153)"
3103,2020-04-09,Benin,0,0,26,"rgb(165, 170, 153)"
3104,2020-04-10,Benin,0,4,30,"rgb(165, 170, 153)"
3105,2020-04-11,Benin,0,5,35,"rgb(165, 170, 153)"
3106,2020-04-12,Benin,0,0,35,"rgb(165, 170, 153)"
3107,2020-04-13,Benin,0,0,35,"rgb(165, 170, 153)"
3108,2020-04-14,Benin,0,0,35,"rgb(165, 170, 153)"
3109,2020-04-15,Benin,0,0,35,"rgb(165, 170, 153)"
3110,2020-04-16,Benin,0,0,35,"rgb(165, 170, 153)"
3111,2020-04-17,Benin,0,2,37,"rgb(165, 170, 153)"
3112,2020-04-18,Benin,0,0,37,"rgb(165, 170, 153)"
3113,2020-04-19,Benin,0,0,37,"rgb(165, 170, 153)"
3114,2020-04-20,Benin,0,0,37,"rgb(165, 170, 153)"
3115,2020-04-21,Benin,0,17,54,"rgb(165, 170, 153)"
3116,2020-04-22,Benin,0,0,54,"rgb(165, 170, 153)"
3117,2020-04-23,Benin,0,0,54,"rgb(165, 170, 153)"
3118,2020-04-24,Benin,0,4,58,"rgb(165, 170, 153)"
3119,2020-04-25,Benin,0,0,58,"rgb(165, 170, 153)"
3120,2020-04-26,Benin,0,0,58,"rgb(165, 170, 153)"
3121,2020-04-27,Benin,0,6,64,"rgb(165, 170, 153)"
3122,2020-04-28,Benin,0,0,64,"rgb(165, 170, 153)"
3123,2020-04-29,Benin,0,0,64,"rgb(165, 170, 153)"
3124,2020-04-30,Benin,1,5,69,"rgb(165, 170, 153)"
3125,2020-05-01,Benin,0,15,84,"rgb(165, 170, 153)"
3126,2020-05-02,Benin,0,6,90,"rgb(165, 170, 153)"
3127,2020-05-03,Benin,0,0,90,"rgb(165, 170, 153)"
3128,2020-05-04,Benin,0,0,90,"rgb(165, 170, 153)"
3129,2020-05-05,Benin,0,6,96,"rgb(165, 170, 153)"
3130,2020-05-06,Benin,0,0,96,"rgb(165, 170, 153)"
3131,2020-05-07,Benin,0,6,102,"rgb(165, 170, 153)"
3132,2020-05-08,Benin,0,38,140,"rgb(165, 170, 153)"
3133,2020-05-09,Benin,0,102,242,"rgb(165, 170, 153)"
3134,2020-05-10,Benin,0,42,284,"rgb(165, 170, 153)"
3135,2020-05-11,Benin,0,35,319,"rgb(165, 170, 153)"
3136,2020-05-12,Benin,0,0,319,"rgb(165, 170, 153)"
3137,2020-05-13,Benin,0,8,327,"rgb(165, 170, 153)"
3138,2020-05-14,Benin,0,0,327,"rgb(165, 170, 153)"
3139,2020-05-15,Benin,0,12,339,"rgb(165, 170, 153)"
3140,2020-05-16,Benin,0,0,339,"rgb(165, 170, 153)"
3141,2020-05-17,Benin,0,0,339,"rgb(165, 170, 153)"
3142,2020-05-18,Benin,0,0,339,"rgb(165, 170, 153)"
3143,2020-05-19,Benin,0,0,339,"rgb(165, 170, 153)"
3144,2020-05-20,Benin,0,-209,130,"rgb(165, 170, 153)"
3145,2020-05-21,Benin,0,0,130,"rgb(165, 170, 153)"
3146,2020-05-22,Benin,1,5,135,"rgb(165, 170, 153)"
3147,2020-05-23,Benin,0,0,135,"rgb(165, 170, 153)"
3148,2020-05-24,Benin,0,0,135,"rgb(165, 170, 153)"
3149,2020-05-25,Benin,0,56,191,"rgb(165, 170, 153)"
3150,2020-05-26,Benin,0,0,191,"rgb(165, 170, 153)"
3151,2020-05-27,Benin,0,17,208,"rgb(165, 170, 153)"
3152,2020-05-28,Benin,0,2,210,"rgb(165, 170, 153)"
3153,2020-05-29,Benin,0,0,210,"rgb(165, 170, 153)"
3154,2020-05-30,Benin,0,14,224,"rgb(165, 170, 153)"
3155,2020-05-31,Benin,0,8,232,"rgb(165, 170, 153)"
3156,2020-06-01,Benin,0,0,232,"rgb(165, 170, 153)"
3157,2020-06-02,Benin,0,11,243,"rgb(165, 170, 153)"
3158,2020-06-03,Benin,0,1,244,"rgb(165, 170, 153)"
3159,2020-06-04,Benin,0,0,244,"rgb(165, 170, 153)"
3160,2020-06-05,Benin,0,17,261,"rgb(165, 170, 153)"
3161,2020-06-06,Benin,0,0,261,"rgb(165, 170, 153)"
3162,2020-06-07,Benin,1,7,268,"rgb(165, 170, 153)"
3163,2020-06-08,Benin,0,0,268,"rgb(165, 170, 153)"
3164,2020-06-09,Benin,0,37,305,"rgb(165, 170, 153)"
3165,2020-06-10,Benin,0,0,305,"rgb(165, 170, 153)"
3166,2020-06-11,Benin,0,0,305,"rgb(165, 170, 153)"
3167,2020-06-12,Benin,0,0,305,"rgb(165, 170, 153)"
3168,2020-06-13,Benin,1,83,388,"rgb(165, 170, 153)"
3169,2020-06-14,Benin,1,24,412,"rgb(165, 170, 153)"
3170,2020-06-15,Benin,1,58,470,"rgb(165, 170, 153)"
3171,2020-06-16,Benin,2,13,483,"rgb(165, 170, 153)"
3172,2020-06-17,Benin,0,49,532,"rgb(165, 170, 153)"
3173,2020-06-18,Benin,0,40,572,"rgb(165, 170, 153)"
3174,2020-06-19,Benin,2,25,597,"rgb(165, 170, 153)"
3175,2020-06-20,Benin,0,53,650,"rgb(165, 170, 153)"
3176,2020-06-21,Benin,0,0,650,"rgb(165, 170, 153)"
3177,2020-06-22,Benin,2,115,765,"rgb(165, 170, 153)"
3178,2020-06-23,Benin,0,42,807,"rgb(165, 170, 153)"
3179,2020-06-24,Benin,0,43,850,"rgb(165, 170, 153)"
3180,2020-06-25,Benin,0,52,902,"rgb(165, 170, 153)"
3181,2020-06-26,Benin,1,115,1017,"rgb(165, 170, 153)"
3182,2020-06-27,Benin,0,36,1053,"rgb(165, 170, 153)"
3183,2020-06-28,Benin,0,71,1124,"rgb(165, 170, 153)"
3184,2020-06-29,Benin,2,25,1149,"rgb(165, 170, 153)"
3185,2020-06-30,Benin,3,38,1187,"rgb(165, 170, 153)"
3186,2020-07-01,Benin,2,12,1199,"rgb(165, 170, 153)"
3187,2020-07-02,Benin,0,0,1199,"rgb(165, 170, 153)"
3188,2020-07-03,Benin,0,0,1199,"rgb(165, 170, 153)"
3189,2020-07-04,Benin,0,0,1199,"rgb(165, 170, 153)"
3190,2020-07-05,Benin,0,0,1199,"rgb(165, 170, 153)"
3191,2020-07-06,Benin,0,0,1199,"rgb(165, 170, 153)"
3192,2020-07-07,Benin,0,0,1199,"rgb(165, 170, 153)"
3193,2020-07-08,Benin,0,0,1199,"rgb(165, 170, 153)"
3194,2020-07-09,Benin,2,86,1285,"rgb(165, 170, 153)"
3195,2020-07-10,Benin,0,0,1285,"rgb(165, 170, 153)"
3196,2020-07-11,Benin,0,0,1285,"rgb(165, 170, 153)"
3197,2020-07-12,Benin,3,93,1378,"rgb(165, 170, 153)"
3198,2020-07-13,Benin,0,0,1378,"rgb(165, 170, 153)"
3199,2020-03-20,Bermuda,0,2,2,"rgb(27,158,119)"
3200,2020-03-21,Bermuda,0,0,2,"rgb(27,158,119)"
3201,2020-03-22,Bermuda,0,0,2,"rgb(27,158,119)"
3202,2020-03-23,Bermuda,0,4,6,"rgb(27,158,119)"
3203,2020-03-24,Bermuda,0,0,6,"rgb(27,158,119)"
3204,2020-03-25,Bermuda,0,0,6,"rgb(27,158,119)"
3205,2020-03-26,Bermuda,0,0,6,"rgb(27,158,119)"
3206,2020-03-27,Bermuda,0,9,15,"rgb(27,158,119)"
3207,2020-03-28,Bermuda,0,2,17,"rgb(27,158,119)"
3208,2020-03-29,Bermuda,0,5,22,"rgb(27,158,119)"
3209,2020-03-30,Bermuda,0,0,22,"rgb(27,158,119)"
3210,2020-03-31,Bermuda,0,5,27,"rgb(27,158,119)"
3211,2020-04-01,Bermuda,0,5,32,"rgb(27,158,119)"
3212,2020-04-02,Bermuda,0,0,32,"rgb(27,158,119)"
3213,2020-04-03,Bermuda,0,3,35,"rgb(27,158,119)"
3214,2020-04-04,Bermuda,0,0,35,"rgb(27,158,119)"
3215,2020-04-05,Bermuda,0,2,37,"rgb(27,158,119)"
3216,2020-04-06,Bermuda,0,0,37,"rgb(27,158,119)"
3217,2020-04-07,Bermuda,2,2,39,"rgb(27,158,119)"
3218,2020-04-08,Bermuda,0,0,39,"rgb(27,158,119)"
3219,2020-04-09,Bermuda,1,0,39,"rgb(27,158,119)"
3220,2020-04-10,Bermuda,1,9,48,"rgb(27,158,119)"
3221,2020-04-11,Bermuda,0,0,48,"rgb(27,158,119)"
3222,2020-04-12,Bermuda,0,2,50,"rgb(27,158,119)"
3223,2020-04-13,Bermuda,0,7,57,"rgb(27,158,119)"
3224,2020-04-14,Bermuda,0,0,57,"rgb(27,158,119)"
3225,2020-04-15,Bermuda,1,0,57,"rgb(27,158,119)"
3226,2020-04-16,Bermuda,0,24,81,"rgb(27,158,119)"
3227,2020-04-17,Bermuda,0,2,83,"rgb(27,158,119)"
3228,2020-04-18,Bermuda,0,0,83,"rgb(27,158,119)"
3229,2020-04-19,Bermuda,0,3,86,"rgb(27,158,119)"
3230,2020-04-20,Bermuda,0,0,86,"rgb(27,158,119)"
3231,2020-04-21,Bermuda,0,0,86,"rgb(27,158,119)"
3232,2020-04-22,Bermuda,0,12,98,"rgb(27,158,119)"
3233,2020-04-23,Bermuda,0,1,99,"rgb(27,158,119)"
3234,2020-04-24,Bermuda,0,0,99,"rgb(27,158,119)"
3235,2020-04-25,Bermuda,0,0,99,"rgb(27,158,119)"
3236,2020-04-26,Bermuda,0,0,99,"rgb(27,158,119)"
3237,2020-04-27,Bermuda,0,10,109,"rgb(27,158,119)"
3238,2020-04-28,Bermuda,1,1,110,"rgb(27,158,119)"
3239,2020-04-29,Bermuda,0,0,110,"rgb(27,158,119)"
3240,2020-04-30,Bermuda,0,1,111,"rgb(27,158,119)"
3241,2020-05-01,Bermuda,0,3,114,"rgb(27,158,119)"
3242,2020-05-02,Bermuda,0,0,114,"rgb(27,158,119)"
3243,2020-05-03,Bermuda,1,0,114,"rgb(27,158,119)"
3244,2020-05-04,Bermuda,0,1,115,"rgb(27,158,119)"
3245,2020-05-05,Bermuda,0,0,115,"rgb(27,158,119)"
3246,2020-05-06,Bermuda,0,0,115,"rgb(27,158,119)"
3247,2020-05-07,Bermuda,0,3,118,"rgb(27,158,119)"
3248,2020-05-08,Bermuda,0,0,118,"rgb(27,158,119)"
3249,2020-05-09,Bermuda,0,0,118,"rgb(27,158,119)"
3250,2020-05-10,Bermuda,0,0,118,"rgb(27,158,119)"
3251,2020-05-11,Bermuda,0,0,118,"rgb(27,158,119)"
3252,2020-05-12,Bermuda,1,1,119,"rgb(27,158,119)"
3253,2020-05-13,Bermuda,0,2,121,"rgb(27,158,119)"
3254,2020-05-14,Bermuda,0,0,121,"rgb(27,158,119)"
3255,2020-05-15,Bermuda,1,1,122,"rgb(27,158,119)"
3256,2020-05-16,Bermuda,0,1,123,"rgb(27,158,119)"
3257,2020-05-17,Bermuda,0,0,123,"rgb(27,158,119)"
3258,2020-05-18,Bermuda,0,0,123,"rgb(27,158,119)"
3259,2020-05-19,Bermuda,0,2,125,"rgb(27,158,119)"
3260,2020-05-20,Bermuda,0,0,125,"rgb(27,158,119)"
3261,2020-05-21,Bermuda,0,0,125,"rgb(27,158,119)"
3262,2020-05-22,Bermuda,0,0,125,"rgb(27,158,119)"
3263,2020-05-23,Bermuda,0,3,128,"rgb(27,158,119)"
3264,2020-05-24,Bermuda,0,5,133,"rgb(27,158,119)"
3265,2020-05-25,Bermuda,0,0,133,"rgb(27,158,119)"
3266,2020-05-26,Bermuda,0,0,133,"rgb(27,158,119)"
3267,2020-05-27,Bermuda,0,6,139,"rgb(27,158,119)"
3268,2020-05-28,Bermuda,0,0,139,"rgb(27,158,119)"
3269,2020-05-29,Bermuda,0,1,140,"rgb(27,158,119)"
3270,2020-05-30,Bermuda,0,0,140,"rgb(27,158,119)"
3271,2020-05-31,Bermuda,0,0,140,"rgb(27,158,119)"
3272,2020-06-01,Bermuda,0,0,140,"rgb(27,158,119)"
3273,2020-06-02,Bermuda,0,1,141,"rgb(27,158,119)"
3274,2020-06-03,Bermuda,0,0,141,"rgb(27,158,119)"
3275,2020-06-04,Bermuda,0,0,141,"rgb(27,158,119)"
3276,2020-06-05,Bermuda,0,0,141,"rgb(27,158,119)"
3277,2020-06-06,Bermuda,0,0,141,"rgb(27,158,119)"
3278,2020-06-07,Bermuda,0,0,141,"rgb(27,158,119)"
3279,2020-06-08,Bermuda,0,0,141,"rgb(27,158,119)"
3280,2020-06-09,Bermuda,0,0,141,"rgb(27,158,119)"
3281,2020-06-10,Bermuda,0,0,141,"rgb(27,158,119)"
3282,2020-06-11,Bermuda,0,0,141,"rgb(27,158,119)"
3283,2020-06-12,Bermuda,0,0,141,"rgb(27,158,119)"
3284,2020-06-13,Bermuda,0,1,142,"rgb(27,158,119)"
3285,2020-06-14,Bermuda,0,2,144,"rgb(27,158,119)"
3286,2020-06-15,Bermuda,0,0,144,"rgb(27,158,119)"
3287,2020-06-16,Bermuda,0,0,144,"rgb(27,158,119)"
3288,2020-06-17,Bermuda,0,0,144,"rgb(27,158,119)"
3289,2020-06-18,Bermuda,0,0,144,"rgb(27,158,119)"
3290,2020-06-19,Bermuda,0,0,144,"rgb(27,158,119)"
3291,2020-06-20,Bermuda,0,2,146,"rgb(27,158,119)"
3292,2020-06-21,Bermuda,0,0,146,"rgb(27,158,119)"
3293,2020-06-22,Bermuda,0,0,146,"rgb(27,158,119)"
3294,2020-06-23,Bermuda,0,0,146,"rgb(27,158,119)"
3295,2020-06-24,Bermuda,0,0,146,"rgb(27,158,119)"
3296,2020-06-25,Bermuda,0,0,146,"rgb(27,158,119)"
3297,2020-06-26,Bermuda,0,0,146,"rgb(27,158,119)"
3298,2020-06-27,Bermuda,0,0,146,"rgb(27,158,119)"
3299,2020-06-28,Bermuda,0,0,146,"rgb(27,158,119)"
3300,2020-06-29,Bermuda,0,0,146,"rgb(27,158,119)"
3301,2020-06-30,Bermuda,0,0,146,"rgb(27,158,119)"
3302,2020-07-01,Bermuda,0,0,146,"rgb(27,158,119)"
3303,2020-07-02,Bermuda,0,0,146,"rgb(27,158,119)"
3304,2020-07-03,Bermuda,0,0,146,"rgb(27,158,119)"
3305,2020-07-04,Bermuda,0,0,146,"rgb(27,158,119)"
3306,2020-07-05,Bermuda,0,0,146,"rgb(27,158,119)"
3307,2020-07-06,Bermuda,0,0,146,"rgb(27,158,119)"
3308,2020-07-07,Bermuda,0,0,146,"rgb(27,158,119)"
3309,2020-07-08,Bermuda,0,2,148,"rgb(27,158,119)"
3310,2020-07-09,Bermuda,0,1,149,"rgb(27,158,119)"
3311,2020-07-10,Bermuda,0,0,149,"rgb(27,158,119)"
3312,2020-07-11,Bermuda,0,1,150,"rgb(27,158,119)"
3313,2020-07-12,Bermuda,0,0,150,"rgb(27,158,119)"
3314,2020-07-13,Bermuda,0,0,150,"rgb(27,158,119)"
3315,2020-03-10,Brunei Darussalam,0,1,1,"rgb(217,95,2)"
3316,2020-03-12,Brunei Darussalam,0,10,11,"rgb(217,95,2)"
3317,2020-03-13,Brunei Darussalam,0,14,25,"rgb(217,95,2)"
3318,2020-03-14,Brunei Darussalam,0,12,37,"rgb(217,95,2)"
3319,2020-03-15,Brunei Darussalam,0,3,40,"rgb(217,95,2)"
3320,2020-03-16,Brunei Darussalam,0,10,50,"rgb(217,95,2)"
3321,2020-03-17,Brunei Darussalam,0,4,54,"rgb(217,95,2)"
3322,2020-03-18,Brunei Darussalam,0,2,56,"rgb(217,95,2)"
3323,2020-03-19,Brunei Darussalam,0,12,68,"rgb(217,95,2)"
3324,2020-03-20,Brunei Darussalam,0,5,73,"rgb(217,95,2)"
3325,2020-03-21,Brunei Darussalam,0,5,78,"rgb(217,95,2)"
3326,2020-03-22,Brunei Darussalam,0,5,83,"rgb(217,95,2)"
3327,2020-03-23,Brunei Darussalam,0,5,88,"rgb(217,95,2)"
3328,2020-03-24,Brunei Darussalam,0,3,91,"rgb(217,95,2)"
3329,2020-03-25,Brunei Darussalam,0,13,104,"rgb(217,95,2)"
3330,2020-03-26,Brunei Darussalam,0,3,107,"rgb(217,95,2)"
3331,2020-03-27,Brunei Darussalam,0,7,114,"rgb(217,95,2)"
3332,2020-03-28,Brunei Darussalam,0,1,115,"rgb(217,95,2)"
3333,2020-03-29,Brunei Darussalam,1,5,120,"rgb(217,95,2)"
3334,2020-03-30,Brunei Darussalam,0,6,126,"rgb(217,95,2)"
3335,2020-03-31,Brunei Darussalam,0,1,127,"rgb(217,95,2)"
3336,2020-04-01,Brunei Darussalam,0,2,129,"rgb(217,95,2)"
3337,2020-04-02,Brunei Darussalam,0,2,131,"rgb(217,95,2)"
3338,2020-04-03,Brunei Darussalam,0,2,133,"rgb(217,95,2)"
3339,2020-04-04,Brunei Darussalam,0,0,133,"rgb(217,95,2)"
3340,2020-04-05,Brunei Darussalam,0,2,135,"rgb(217,95,2)"
3341,2020-04-06,Brunei Darussalam,0,0,135,"rgb(217,95,2)"
3342,2020-04-07,Brunei Darussalam,0,0,135,"rgb(217,95,2)"
3343,2020-04-08,Brunei Darussalam,0,0,135,"rgb(217,95,2)"
3344,2020-04-09,Brunei Darussalam,0,0,135,"rgb(217,95,2)"
3345,2020-04-10,Brunei Darussalam,0,0,135,"rgb(217,95,2)"
3346,2020-04-11,Brunei Darussalam,0,1,136,"rgb(217,95,2)"
3347,2020-04-12,Brunei Darussalam,0,0,136,"rgb(217,95,2)"
3348,2020-04-13,Brunei Darussalam,0,0,136,"rgb(217,95,2)"
3349,2020-04-14,Brunei Darussalam,0,0,136,"rgb(217,95,2)"
3350,2020-04-15,Brunei Darussalam,0,0,136,"rgb(217,95,2)"
3351,2020-04-16,Brunei Darussalam,0,0,136,"rgb(217,95,2)"
3352,2020-04-17,Brunei Darussalam,0,0,136,"rgb(217,95,2)"
3353,2020-04-18,Brunei Darussalam,0,0,136,"rgb(217,95,2)"
3354,2020-04-19,Brunei Darussalam,0,1,137,"rgb(217,95,2)"
3355,2020-04-20,Brunei Darussalam,0,1,138,"rgb(217,95,2)"
3356,2020-04-21,Brunei Darussalam,0,0,138,"rgb(217,95,2)"
3357,2020-04-22,Brunei Darussalam,0,0,138,"rgb(217,95,2)"
3358,2020-04-23,Brunei Darussalam,0,0,138,"rgb(217,95,2)"
3359,2020-04-24,Brunei Darussalam,0,0,138,"rgb(217,95,2)"
3360,2020-04-25,Brunei Darussalam,0,0,138,"rgb(217,95,2)"
3361,2020-04-26,Brunei Darussalam,0,0,138,"rgb(217,95,2)"
3362,2020-04-27,Brunei Darussalam,0,0,138,"rgb(217,95,2)"
3363,2020-04-28,Brunei Darussalam,0,0,138,"rgb(217,95,2)"
3364,2020-04-29,Brunei Darussalam,0,0,138,"rgb(217,95,2)"
3365,2020-04-30,Brunei Darussalam,0,0,138,"rgb(217,95,2)"
3366,2020-05-01,Brunei Darussalam,0,0,138,"rgb(217,95,2)"
3367,2020-05-02,Brunei Darussalam,0,0,138,"rgb(217,95,2)"
3368,2020-05-03,Brunei Darussalam,0,0,138,"rgb(217,95,2)"
3369,2020-05-04,Brunei Darussalam,0,0,138,"rgb(217,95,2)"
3370,2020-05-05,Brunei Darussalam,0,0,138,"rgb(217,95,2)"
3371,2020-05-06,Brunei Darussalam,0,0,138,"rgb(217,95,2)"
3372,2020-05-07,Brunei Darussalam,0,1,139,"rgb(217,95,2)"
3373,2020-05-08,Brunei Darussalam,0,2,141,"rgb(217,95,2)"
3374,2020-05-09,Brunei Darussalam,0,0,141,"rgb(217,95,2)"
3375,2020-05-10,Brunei Darussalam,0,0,141,"rgb(217,95,2)"
3376,2020-05-11,Brunei Darussalam,0,0,141,"rgb(217,95,2)"
3377,2020-05-12,Brunei Darussalam,0,0,141,"rgb(217,95,2)"
3378,2020-05-13,Brunei Darussalam,0,0,141,"rgb(217,95,2)"
3379,2020-05-14,Brunei Darussalam,0,0,141,"rgb(217,95,2)"
3380,2020-05-15,Brunei Darussalam,0,0,141,"rgb(217,95,2)"
3381,2020-05-16,Brunei Darussalam,0,0,141,"rgb(217,95,2)"
3382,2020-05-17,Brunei Darussalam,0,0,141,"rgb(217,95,2)"
3383,2020-05-18,Brunei Darussalam,0,0,141,"rgb(217,95,2)"
3384,2020-05-19,Brunei Darussalam,0,0,141,"rgb(217,95,2)"
3385,2020-05-20,Brunei Darussalam,0,0,141,"rgb(217,95,2)"
3386,2020-05-21,Brunei Darussalam,0,0,141,"rgb(217,95,2)"
3387,2020-05-22,Brunei Darussalam,0,0,141,"rgb(217,95,2)"
3388,2020-05-23,Brunei Darussalam,0,0,141,"rgb(217,95,2)"
3389,2020-05-24,Brunei Darussalam,0,0,141,"rgb(217,95,2)"
3390,2020-05-25,Brunei Darussalam,0,0,141,"rgb(217,95,2)"
3391,2020-05-26,Brunei Darussalam,0,0,141,"rgb(217,95,2)"
3392,2020-05-27,Brunei Darussalam,0,0,141,"rgb(217,95,2)"
3393,2020-05-28,Brunei Darussalam,1,0,141,"rgb(217,95,2)"
3394,2020-05-29,Brunei Darussalam,0,0,141,"rgb(217,95,2)"
3395,2020-05-30,Brunei Darussalam,0,0,141,"rgb(217,95,2)"
3396,2020-05-31,Brunei Darussalam,0,0,141,"rgb(217,95,2)"
3397,2020-06-01,Brunei Darussalam,0,0,141,"rgb(217,95,2)"
3398,2020-06-02,Brunei Darussalam,0,0,141,"rgb(217,95,2)"
3399,2020-06-03,Brunei Darussalam,0,0,141,"rgb(217,95,2)"
3400,2020-06-04,Brunei Darussalam,0,0,141,"rgb(217,95,2)"
3401,2020-06-05,Brunei Darussalam,0,0,141,"rgb(217,95,2)"
3402,2020-06-06,Brunei Darussalam,0,0,141,"rgb(217,95,2)"
3403,2020-06-07,Brunei Darussalam,0,0,141,"rgb(217,95,2)"
3404,2020-06-08,Brunei Darussalam,0,0,141,"rgb(217,95,2)"
3405,2020-06-09,Brunei Darussalam,0,0,141,"rgb(217,95,2)"
3406,2020-06-10,Brunei Darussalam,0,0,141,"rgb(217,95,2)"
3407,2020-06-11,Brunei Darussalam,0,0,141,"rgb(217,95,2)"
3408,2020-06-12,Brunei Darussalam,0,0,141,"rgb(217,95,2)"
3409,2020-06-13,Brunei Darussalam,0,0,141,"rgb(217,95,2)"
3410,2020-06-14,Brunei Darussalam,0,0,141,"rgb(217,95,2)"
3411,2020-06-15,Brunei Darussalam,0,0,141,"rgb(217,95,2)"
3412,2020-06-16,Brunei Darussalam,0,0,141,"rgb(217,95,2)"
3413,2020-06-17,Brunei Darussalam,1,0,141,"rgb(217,95,2)"
3414,2020-06-18,Brunei Darussalam,0,0,141,"rgb(217,95,2)"
3415,2020-06-19,Brunei Darussalam,0,0,141,"rgb(217,95,2)"
3416,2020-06-20,Brunei Darussalam,0,0,141,"rgb(217,95,2)"
3417,2020-06-21,Brunei Darussalam,0,0,141,"rgb(217,95,2)"
3418,2020-06-22,Brunei Darussalam,0,0,141,"rgb(217,95,2)"
3419,2020-06-23,Brunei Darussalam,0,0,141,"rgb(217,95,2)"
3420,2020-06-24,Brunei Darussalam,0,0,141,"rgb(217,95,2)"
3421,2020-06-25,Brunei Darussalam,0,0,141,"rgb(217,95,2)"
3422,2020-06-26,Brunei Darussalam,0,0,141,"rgb(217,95,2)"
3423,2020-06-27,Brunei Darussalam,0,0,141,"rgb(217,95,2)"
3424,2020-06-28,Brunei Darussalam,0,0,141,"rgb(217,95,2)"
3425,2020-06-29,Brunei Darussalam,0,0,141,"rgb(217,95,2)"
3426,2020-06-30,Brunei Darussalam,0,0,141,"rgb(217,95,2)"
3427,2020-07-01,Brunei Darussalam,0,0,141,"rgb(217,95,2)"
3428,2020-07-02,Brunei Darussalam,0,0,141,"rgb(217,95,2)"
3429,2020-07-03,Brunei Darussalam,0,0,141,"rgb(217,95,2)"
3430,2020-07-04,Brunei Darussalam,0,0,141,"rgb(217,95,2)"
3431,2020-07-05,Brunei Darussalam,0,0,141,"rgb(217,95,2)"
3432,2020-07-06,Brunei Darussalam,0,0,141,"rgb(217,95,2)"
3433,2020-07-07,Brunei Darussalam,0,0,141,"rgb(217,95,2)"
3434,2020-07-08,Brunei Darussalam,0,0,141,"rgb(217,95,2)"
3435,2020-07-09,Brunei Darussalam,0,0,141,"rgb(217,95,2)"
3436,2020-07-10,Brunei Darussalam,0,0,141,"rgb(217,95,2)"
3437,2020-07-11,Brunei Darussalam,0,0,141,"rgb(217,95,2)"
3438,2020-07-12,Brunei Darussalam,0,0,141,"rgb(217,95,2)"
3439,2020-07-13,Brunei Darussalam,0,0,141,"rgb(217,95,2)"
3440,2020-03-12,Bolivia,0,2,2,"rgb(117,112,179)"
3441,2020-03-13,Bolivia,0,1,3,"rgb(117,112,179)"
3442,2020-03-14,Bolivia,0,7,10,"rgb(117,112,179)"
3443,2020-03-15,Bolivia,0,0,10,"rgb(117,112,179)"
3444,2020-03-17,Bolivia,0,1,11,"rgb(117,112,179)"
3445,2020-03-18,Bolivia,0,1,12,"rgb(117,112,179)"
3446,2020-03-19,Bolivia,0,0,12,"rgb(117,112,179)"
3447,2020-03-20,Bolivia,0,3,15,"rgb(117,112,179)"
3448,2020-03-21,Bolivia,0,4,19,"rgb(117,112,179)"
3449,2020-03-22,Bolivia,0,1,20,"rgb(117,112,179)"
3450,2020-03-23,Bolivia,0,7,27,"rgb(117,112,179)"
3451,2020-03-24,Bolivia,0,1,28,"rgb(117,112,179)"
3452,2020-03-25,Bolivia,0,4,32,"rgb(117,112,179)"
3453,2020-03-26,Bolivia,0,7,39,"rgb(117,112,179)"
3454,2020-03-27,Bolivia,0,22,61,"rgb(117,112,179)"
3455,2020-03-28,Bolivia,0,13,74,"rgb(117,112,179)"
3456,2020-03-29,Bolivia,0,7,81,"rgb(117,112,179)"
3457,2020-03-30,Bolivia,3,15,96,"rgb(117,112,179)"
3458,2020-03-31,Bolivia,3,11,107,"rgb(117,112,179)"
3459,2020-04-01,Bolivia,1,8,115,"rgb(117,112,179)"
3460,2020-04-02,Bolivia,1,8,123,"rgb(117,112,179)"
3461,2020-04-03,Bolivia,1,9,132,"rgb(117,112,179)"
3462,2020-04-04,Bolivia,1,7,139,"rgb(117,112,179)"
3463,2020-04-05,Bolivia,0,18,157,"rgb(117,112,179)"
3464,2020-04-06,Bolivia,1,26,183,"rgb(117,112,179)"
3465,2020-04-07,Bolivia,3,11,194,"rgb(117,112,179)"
3466,2020-04-08,Bolivia,1,16,210,"rgb(117,112,179)"
3467,2020-04-09,Bolivia,3,54,264,"rgb(117,112,179)"
3468,2020-04-10,Bolivia,1,4,268,"rgb(117,112,179)"
3469,2020-04-11,Bolivia,1,8,276,"rgb(117,112,179)"
3470,2020-04-12,Bolivia,4,24,300,"rgb(117,112,179)"
3471,2020-04-13,Bolivia,3,30,330,"rgb(117,112,179)"
3472,2020-04-14,Bolivia,1,24,354,"rgb(117,112,179)"
3473,2020-04-15,Bolivia,0,43,397,"rgb(117,112,179)"
3474,2020-04-16,Bolivia,1,44,441,"rgb(117,112,179)"
3475,2020-04-17,Bolivia,2,24,465,"rgb(117,112,179)"
3476,2020-04-18,Bolivia,0,28,493,"rgb(117,112,179)"
3477,2020-04-19,Bolivia,1,27,520,"rgb(117,112,179)"
3478,2020-04-20,Bolivia,1,44,564,"rgb(117,112,179)"
3479,2020-04-21,Bolivia,1,34,598,"rgb(117,112,179)"
3480,2020-04-22,Bolivia,3,11,609,"rgb(117,112,179)"
3481,2020-04-23,Bolivia,3,63,672,"rgb(117,112,179)"
3482,2020-04-24,Bolivia,3,31,703,"rgb(117,112,179)"
3483,2020-04-25,Bolivia,1,104,807,"rgb(117,112,179)"
3484,2020-04-26,Bolivia,2,59,866,"rgb(117,112,179)"
3485,2020-04-27,Bolivia,4,84,950,"rgb(117,112,179)"
3486,2020-04-28,Bolivia,3,64,1014,"rgb(117,112,179)"
3487,2020-04-29,Bolivia,2,39,1053,"rgb(117,112,179)"
3488,2020-04-30,Bolivia,4,57,1110,"rgb(117,112,179)"
3489,2020-05-01,Bolivia,3,57,1167,"rgb(117,112,179)"
3490,2020-05-02,Bolivia,4,62,1229,"rgb(117,112,179)"
3491,2020-05-03,Bolivia,5,241,1470,"rgb(117,112,179)"
3492,2020-05-04,Bolivia,5,124,1594,"rgb(117,112,179)"
3493,2020-05-05,Bolivia,6,87,1681,"rgb(117,112,179)"
3494,2020-05-06,Bolivia,4,121,1802,"rgb(117,112,179)"
3495,2020-05-07,Bolivia,5,84,1886,"rgb(117,112,179)"
3496,2020-05-08,Bolivia,11,195,2081,"rgb(117,112,179)"
3497,2020-05-09,Bolivia,4,185,2266,"rgb(117,112,179)"
3498,2020-05-10,Bolivia,8,171,2437,"rgb(117,112,179)"
3499,2020-05-11,Bolivia,4,119,2556,"rgb(117,112,179)"
3500,2020-05-12,Bolivia,4,275,2831,"rgb(117,112,179)"
3501,2020-05-13,Bolivia,6,133,2964,"rgb(117,112,179)"
3502,2020-05-14,Bolivia,14,184,3148,"rgb(117,112,179)"
3503,2020-05-15,Bolivia,10,224,3372,"rgb(117,112,179)"
3504,2020-05-16,Bolivia,12,205,3577,"rgb(117,112,179)"
3505,2020-05-17,Bolivia,1,249,3826,"rgb(117,112,179)"
3506,2020-05-18,Bolivia,4,262,4088,"rgb(117,112,179)"
3507,2020-05-19,Bolivia,5,175,4263,"rgb(117,112,179)"
3508,2020-05-20,Bolivia,15,218,4481,"rgb(117,112,179)"
3509,2020-05-21,Bolivia,10,438,4919,"rgb(117,112,179)"
3510,2020-05-22,Bolivia,16,268,5187,"rgb(117,112,179)"
3511,2020-05-23,Bolivia,15,392,5579,"rgb(117,112,179)"
3512,2020-05-24,Bolivia,10,336,5915,"rgb(117,112,179)"
3513,2020-05-25,Bolivia,10,348,6263,"rgb(117,112,179)"
3514,2020-05-26,Bolivia,11,397,6660,"rgb(117,112,179)"
3515,2020-05-27,Bolivia,13,476,7136,"rgb(117,112,179)"
3516,2020-05-28,Bolivia,6,632,7768,"rgb(117,112,179)"
3517,2020-05-29,Bolivia,13,619,8387,"rgb(117,112,179)"
3518,2020-05-30,Bolivia,7,344,8731,"rgb(117,112,179)"
3519,2020-05-31,Bolivia,10,861,9592,"rgb(117,112,179)"
3520,2020-06-01,Bolivia,3,390,9982,"rgb(117,112,179)"
3521,2020-06-02,Bolivia,30,549,10531,"rgb(117,112,179)"
3522,2020-06-03,Bolivia,33,460,10991,"rgb(117,112,179)"
3523,2020-06-04,Bolivia,24,647,11638,"rgb(117,112,179)"
3524,2020-06-05,Bolivia,15,607,12245,"rgb(117,112,179)"
3525,2020-06-06,Bolivia,12,483,12728,"rgb(117,112,179)"
3526,2020-06-07,Bolivia,27,630,13358,"rgb(117,112,179)"
3527,2020-06-08,Bolivia,11,285,13643,"rgb(117,112,179)"
3528,2020-06-09,Bolivia,10,306,13949,"rgb(117,112,179)"
3529,2020-06-10,Bolivia,12,695,14644,"rgb(117,112,179)"
3530,2020-06-11,Bolivia,25,637,15281,"rgb(117,112,179)"
3531,2020-06-12,Bolivia,21,884,16165,"rgb(117,112,179)"
3532,2020-06-13,Bolivia,26,764,16929,"rgb(117,112,179)"
3533,2020-06-14,Bolivia,26,913,17842,"rgb(117,112,179)"
3534,2020-06-15,Bolivia,26,617,18459,"rgb(117,112,179)"
3535,2020-06-16,Bolivia,21,614,19073,"rgb(117,112,179)"
3536,2020-06-17,Bolivia,27,810,19883,"rgb(117,112,179)"
3537,2020-06-18,Bolivia,20,802,20685,"rgb(117,112,179)"
3538,2020-06-19,Bolivia,18,814,21499,"rgb(117,112,179)"
3539,2020-06-20,Bolivia,18,977,22476,"rgb(117,112,179)"
3540,2020-06-21,Bolivia,25,1036,23512,"rgb(117,112,179)"
3541,2020-06-22,Bolivia,33,876,24388,"rgb(117,112,179)"
3542,2020-06-23,Bolivia,47,1105,25493,"rgb(117,112,179)"
3543,2020-06-24,Bolivia,26,896,26389,"rgb(117,112,179)"
3544,2020-06-25,Bolivia,30,1098,27487,"rgb(117,112,179)"
3545,2020-06-26,Bolivia,37,1016,28503,"rgb(117,112,179)"
3546,2020-06-27,Bolivia,21,920,29423,"rgb(117,112,179)"
3547,2020-06-28,Bolivia,36,1253,30676,"rgb(117,112,179)"
3548,2020-06-29,Bolivia,44,848,31524,"rgb(117,112,179)"
3549,2020-06-30,Bolivia,57,601,32125,"rgb(117,112,179)"
3550,2020-07-01,Bolivia,52,1094,33219,"rgb(117,112,179)"
3551,2020-07-02,Bolivia,78,1008,34227,"rgb(117,112,179)"
3552,2020-07-03,Bolivia,70,1301,35528,"rgb(117,112,179)"
3553,2020-07-04,Bolivia,49,1290,36818,"rgb(117,112,179)"
3554,2020-07-05,Bolivia,58,1253,38071,"rgb(117,112,179)"
3555,2020-07-06,Bolivia,56,1226,39297,"rgb(117,112,179)"
3556,2020-07-07,Bolivia,42,1212,40509,"rgb(117,112,179)"
3557,2020-07-08,Bolivia,54,1036,41545,"rgb(117,112,179)"
3558,2020-07-09,Bolivia,47,1439,42984,"rgb(117,112,179)"
3559,2020-07-10,Bolivia,61,1129,44113,"rgb(117,112,179)"
3560,2020-07-11,Bolivia,64,1452,45565,"rgb(117,112,179)"
3561,2020-07-12,Bolivia,52,1635,47200,"rgb(117,112,179)"
3562,2020-07-13,Bolivia,53,987,48187,"rgb(117,112,179)"
3563,2020-04-02,"Bonaire, Sint Eustatius and Saba",0,2,2,"rgb(231,41,138)"
3564,2020-04-03,"Bonaire, Sint Eustatius and Saba",0,0,2,"rgb(231,41,138)"
3565,2020-04-04,"Bonaire, Sint Eustatius and Saba",0,0,2,"rgb(231,41,138)"
3566,2020-04-05,"Bonaire, Sint Eustatius and Saba",0,0,2,"rgb(231,41,138)"
3567,2020-04-06,"Bonaire, Sint Eustatius and Saba",0,0,2,"rgb(231,41,138)"
3568,2020-04-07,"Bonaire, Sint Eustatius and Saba",0,0,2,"rgb(231,41,138)"
3569,2020-04-08,"Bonaire, Sint Eustatius and Saba",0,0,2,"rgb(231,41,138)"
3570,2020-04-09,"Bonaire, Sint Eustatius and Saba",0,0,2,"rgb(231,41,138)"
3571,2020-04-10,"Bonaire, Sint Eustatius and Saba",0,0,2,"rgb(231,41,138)"
3572,2020-04-11,"Bonaire, Sint Eustatius and Saba",0,0,2,"rgb(231,41,138)"
3573,2020-04-12,"Bonaire, Sint Eustatius and Saba",0,0,2,"rgb(231,41,138)"
3574,2020-04-13,"Bonaire, Sint Eustatius and Saba",0,1,3,"rgb(231,41,138)"
3575,2020-04-14,"Bonaire, Sint Eustatius and Saba",0,1,4,"rgb(231,41,138)"
3576,2020-04-15,"Bonaire, Sint Eustatius and Saba",0,0,4,"rgb(231,41,138)"
3577,2020-04-16,"Bonaire, Sint Eustatius and Saba",0,0,4,"rgb(231,41,138)"
3578,2020-04-17,"Bonaire, Sint Eustatius and Saba",0,0,4,"rgb(231,41,138)"
3579,2020-04-18,"Bonaire, Sint Eustatius and Saba",0,0,4,"rgb(231,41,138)"
3580,2020-04-19,"Bonaire, Sint Eustatius and Saba",0,0,4,"rgb(231,41,138)"
3581,2020-04-20,"Bonaire, Sint Eustatius and Saba",0,1,5,"rgb(231,41,138)"
3582,2020-04-21,"Bonaire, Sint Eustatius and Saba",0,0,5,"rgb(231,41,138)"
3583,2020-04-22,"Bonaire, Sint Eustatius and Saba",0,1,6,"rgb(231,41,138)"
3584,2020-04-23,"Bonaire, Sint Eustatius and Saba",0,0,6,"rgb(231,41,138)"
3585,2020-04-24,"Bonaire, Sint Eustatius and Saba",0,0,6,"rgb(231,41,138)"
3586,2020-04-25,"Bonaire, Sint Eustatius and Saba",0,0,6,"rgb(231,41,138)"
3587,2020-04-26,"Bonaire, Sint Eustatius and Saba",0,0,6,"rgb(231,41,138)"
3588,2020-04-27,"Bonaire, Sint Eustatius and Saba",0,0,6,"rgb(231,41,138)"
3589,2020-04-28,"Bonaire, Sint Eustatius and Saba",0,0,6,"rgb(231,41,138)"
3590,2020-04-29,"Bonaire, Sint Eustatius and Saba",0,0,6,"rgb(231,41,138)"
3591,2020-04-30,"Bonaire, Sint Eustatius and Saba",0,0,6,"rgb(231,41,138)"
3592,2020-05-01,"Bonaire, Sint Eustatius and Saba",0,0,6,"rgb(231,41,138)"
3593,2020-05-02,"Bonaire, Sint Eustatius and Saba",0,0,6,"rgb(231,41,138)"
3594,2020-05-03,"Bonaire, Sint Eustatius and Saba",0,0,6,"rgb(231,41,138)"
3595,2020-05-04,"Bonaire, Sint Eustatius and Saba",0,0,6,"rgb(231,41,138)"
3596,2020-05-05,"Bonaire, Sint Eustatius and Saba",0,0,6,"rgb(231,41,138)"
3597,2020-05-06,"Bonaire, Sint Eustatius and Saba",0,0,6,"rgb(231,41,138)"
3598,2020-05-07,"Bonaire, Sint Eustatius and Saba",0,0,6,"rgb(231,41,138)"
3599,2020-05-08,"Bonaire, Sint Eustatius and Saba",0,0,6,"rgb(231,41,138)"
3600,2020-05-09,"Bonaire, Sint Eustatius and Saba",0,0,6,"rgb(231,41,138)"
3601,2020-05-10,"Bonaire, Sint Eustatius and Saba",0,0,6,"rgb(231,41,138)"
3602,2020-05-11,"Bonaire, Sint Eustatius and Saba",0,0,6,"rgb(231,41,138)"
3603,2020-05-12,"Bonaire, Sint Eustatius and Saba",0,0,6,"rgb(231,41,138)"
3604,2020-05-13,"Bonaire, Sint Eustatius and Saba",0,0,6,"rgb(231,41,138)"
3605,2020-05-14,"Bonaire, Sint Eustatius and Saba",0,0,6,"rgb(231,41,138)"
3606,2020-05-15,"Bonaire, Sint Eustatius and Saba",0,0,6,"rgb(231,41,138)"
3607,2020-05-16,"Bonaire, Sint Eustatius and Saba",0,0,6,"rgb(231,41,138)"
3608,2020-05-17,"Bonaire, Sint Eustatius and Saba",0,0,6,"rgb(231,41,138)"
3609,2020-05-18,"Bonaire, Sint Eustatius and Saba",0,0,6,"rgb(231,41,138)"
3610,2020-05-19,"Bonaire, Sint Eustatius and Saba",0,0,6,"rgb(231,41,138)"
3611,2020-05-20,"Bonaire, Sint Eustatius and Saba",0,0,6,"rgb(231,41,138)"
3612,2020-05-21,"Bonaire, Sint Eustatius and Saba",0,0,6,"rgb(231,41,138)"
3613,2020-05-22,"Bonaire, Sint Eustatius and Saba",0,0,6,"rgb(231,41,138)"
3614,2020-05-23,"Bonaire, Sint Eustatius and Saba",0,0,6,"rgb(231,41,138)"
3615,2020-05-24,"Bonaire, Sint Eustatius and Saba",0,0,6,"rgb(231,41,138)"
3616,2020-05-25,"Bonaire, Sint Eustatius and Saba",0,1,7,"rgb(231,41,138)"
3617,2020-05-26,"Bonaire, Sint Eustatius and Saba",0,0,7,"rgb(231,41,138)"
3618,2020-05-27,"Bonaire, Sint Eustatius and Saba",0,0,7,"rgb(231,41,138)"
3619,2020-05-28,"Bonaire, Sint Eustatius and Saba",0,0,7,"rgb(231,41,138)"
3620,2020-05-29,"Bonaire, Sint Eustatius and Saba",0,0,7,"rgb(231,41,138)"
3621,2020-05-30,"Bonaire, Sint Eustatius and Saba",0,0,7,"rgb(231,41,138)"
3622,2020-05-31,"Bonaire, Sint Eustatius and Saba",0,0,7,"rgb(231,41,138)"
3623,2020-06-01,"Bonaire, Sint Eustatius and Saba",0,0,7,"rgb(231,41,138)"
3624,2020-06-02,"Bonaire, Sint Eustatius and Saba",0,0,7,"rgb(231,41,138)"
3625,2020-06-03,"Bonaire, Sint Eustatius and Saba",0,0,7,"rgb(231,41,138)"
3626,2020-06-04,"Bonaire, Sint Eustatius and Saba",0,0,7,"rgb(231,41,138)"
3627,2020-06-05,"Bonaire, Sint Eustatius and Saba",0,0,7,"rgb(231,41,138)"
3628,2020-06-06,"Bonaire, Sint Eustatius and Saba",0,0,7,"rgb(231,41,138)"
3629,2020-06-07,"Bonaire, Sint Eustatius and Saba",0,0,7,"rgb(231,41,138)"
3630,2020-06-08,"Bonaire, Sint Eustatius and Saba",0,0,7,"rgb(231,41,138)"
3631,2020-06-09,"Bonaire, Sint Eustatius and Saba",0,0,7,"rgb(231,41,138)"
3632,2020-06-10,"Bonaire, Sint Eustatius and Saba",0,0,7,"rgb(231,41,138)"
3633,2020-06-11,"Bonaire, Sint Eustatius and Saba",0,0,7,"rgb(231,41,138)"
3634,2020-06-12,"Bonaire, Sint Eustatius and Saba",0,0,7,"rgb(231,41,138)"
3635,2020-06-13,"Bonaire, Sint Eustatius and Saba",0,0,7,"rgb(231,41,138)"
3636,2020-06-14,"Bonaire, Sint Eustatius and Saba",0,0,7,"rgb(231,41,138)"
3637,2020-06-15,"Bonaire, Sint Eustatius and Saba",0,0,7,"rgb(231,41,138)"
3638,2020-06-16,"Bonaire, Sint Eustatius and Saba",0,0,7,"rgb(231,41,138)"
3639,2020-06-17,"Bonaire, Sint Eustatius and Saba",0,0,7,"rgb(231,41,138)"
3640,2020-06-18,"Bonaire, Sint Eustatius and Saba",0,0,7,"rgb(231,41,138)"
3641,2020-06-19,"Bonaire, Sint Eustatius and Saba",0,0,7,"rgb(231,41,138)"
3642,2020-06-20,"Bonaire, Sint Eustatius and Saba",0,0,7,"rgb(231,41,138)"
3643,2020-06-21,"Bonaire, Sint Eustatius and Saba",0,0,7,"rgb(231,41,138)"
3644,2020-06-22,"Bonaire, Sint Eustatius and Saba",0,0,7,"rgb(231,41,138)"
3645,2020-06-23,"Bonaire, Sint Eustatius and Saba",0,0,7,"rgb(231,41,138)"
3646,2020-06-24,"Bonaire, Sint Eustatius and Saba",0,0,7,"rgb(231,41,138)"
3647,2020-06-25,"Bonaire, Sint Eustatius and Saba",0,0,7,"rgb(231,41,138)"
3648,2020-06-26,"Bonaire, Sint Eustatius and Saba",0,0,7,"rgb(231,41,138)"
3649,2020-06-27,"Bonaire, Sint Eustatius and Saba",0,0,7,"rgb(231,41,138)"
3650,2020-06-28,"Bonaire, Sint Eustatius and Saba",0,0,7,"rgb(231,41,138)"
3651,2020-06-29,"Bonaire, Sint Eustatius and Saba",0,0,7,"rgb(231,41,138)"
3652,2020-06-30,"Bonaire, Sint Eustatius and Saba",0,0,7,"rgb(231,41,138)"
3653,2020-07-01,"Bonaire, Sint Eustatius and Saba",0,0,7,"rgb(231,41,138)"
3654,2020-07-02,"Bonaire, Sint Eustatius and Saba",0,0,7,"rgb(231,41,138)"
3655,2020-07-03,"Bonaire, Sint Eustatius and Saba",0,0,7,"rgb(231,41,138)"
3656,2020-07-04,"Bonaire, Sint Eustatius and Saba",0,0,7,"rgb(231,41,138)"
3657,2020-07-05,"Bonaire, Sint Eustatius and Saba",0,0,7,"rgb(231,41,138)"
3658,2020-07-06,"Bonaire, Sint Eustatius and Saba",0,0,7,"rgb(231,41,138)"
3659,2020-07-07,"Bonaire, Sint Eustatius and Saba",0,0,7,"rgb(231,41,138)"
3660,2020-07-08,"Bonaire, Sint Eustatius and Saba",0,0,7,"rgb(231,41,138)"
3661,2020-07-09,"Bonaire, Sint Eustatius and Saba",0,0,7,"rgb(231,41,138)"
3662,2020-07-10,"Bonaire, Sint Eustatius and Saba",0,0,7,"rgb(231,41,138)"
3663,2020-07-11,"Bonaire, Sint Eustatius and Saba",0,0,7,"rgb(231,41,138)"
3664,2020-07-12,"Bonaire, Sint Eustatius and Saba",0,0,7,"rgb(231,41,138)"
3665,2020-07-13,"Bonaire, Sint Eustatius and Saba",0,0,7,"rgb(231,41,138)"
3666,2019-12-31,Brazil,0,0,0,"rgb(102,166,30)"
3667,2020-01-01,Brazil,0,0,0,"rgb(102,166,30)"
3668,2020-01-02,Brazil,0,0,0,"rgb(102,166,30)"
3669,2020-01-03,Brazil,0,0,0,"rgb(102,166,30)"
3670,2020-01-04,Brazil,0,0,0,"rgb(102,166,30)"
3671,2020-01-05,Brazil,0,0,0,"rgb(102,166,30)"
3672,2020-01-06,Brazil,0,0,0,"rgb(102,166,30)"
3673,2020-01-07,Brazil,0,0,0,"rgb(102,166,30)"
3674,2020-01-08,Brazil,0,0,0,"rgb(102,166,30)"
3675,2020-01-09,Brazil,0,0,0,"rgb(102,166,30)"
3676,2020-01-10,Brazil,0,0,0,"rgb(102,166,30)"
3677,2020-01-11,Brazil,0,0,0,"rgb(102,166,30)"
3678,2020-01-12,Brazil,0,0,0,"rgb(102,166,30)"
3679,2020-01-13,Brazil,0,0,0,"rgb(102,166,30)"
3680,2020-01-14,Brazil,0,0,0,"rgb(102,166,30)"
3681,2020-01-15,Brazil,0,0,0,"rgb(102,166,30)"
3682,2020-01-16,Brazil,0,0,0,"rgb(102,166,30)"
3683,2020-01-17,Brazil,0,0,0,"rgb(102,166,30)"
3684,2020-01-18,Brazil,0,0,0,"rgb(102,166,30)"
3685,2020-01-19,Brazil,0,0,0,"rgb(102,166,30)"
3686,2020-01-20,Brazil,0,0,0,"rgb(102,166,30)"
3687,2020-01-21,Brazil,0,0,0,"rgb(102,166,30)"
3688,2020-01-22,Brazil,0,0,0,"rgb(102,166,30)"
3689,2020-01-23,Brazil,0,0,0,"rgb(102,166,30)"
3690,2020-01-24,Brazil,0,0,0,"rgb(102,166,30)"
3691,2020-01-25,Brazil,0,0,0,"rgb(102,166,30)"
3692,2020-01-26,Brazil,0,0,0,"rgb(102,166,30)"
3693,2020-01-27,Brazil,0,0,0,"rgb(102,166,30)"
3694,2020-01-28,Brazil,0,0,0,"rgb(102,166,30)"
3695,2020-01-29,Brazil,0,0,0,"rgb(102,166,30)"
3696,2020-01-30,Brazil,0,0,0,"rgb(102,166,30)"
3697,2020-01-31,Brazil,0,0,0,"rgb(102,166,30)"
3698,2020-02-01,Brazil,0,0,0,"rgb(102,166,30)"
3699,2020-02-02,Brazil,0,0,0,"rgb(102,166,30)"
3700,2020-02-03,Brazil,0,0,0,"rgb(102,166,30)"
3701,2020-02-04,Brazil,0,0,0,"rgb(102,166,30)"
3702,2020-02-05,Brazil,0,0,0,"rgb(102,166,30)"
3703,2020-02-06,Brazil,0,0,0,"rgb(102,166,30)"
3704,2020-02-07,Brazil,0,0,0,"rgb(102,166,30)"
3705,2020-02-08,Brazil,0,0,0,"rgb(102,166,30)"
3706,2020-02-09,Brazil,0,0,0,"rgb(102,166,30)"
3707,2020-02-10,Brazil,0,0,0,"rgb(102,166,30)"
3708,2020-02-11,Brazil,0,0,0,"rgb(102,166,30)"
3709,2020-02-12,Brazil,0,0,0,"rgb(102,166,30)"
3710,2020-02-13,Brazil,0,0,0,"rgb(102,166,30)"
3711,2020-02-14,Brazil,0,0,0,"rgb(102,166,30)"
3712,2020-02-15,Brazil,0,0,0,"rgb(102,166,30)"
3713,2020-02-16,Brazil,0,0,0,"rgb(102,166,30)"
3714,2020-02-17,Brazil,0,0,0,"rgb(102,166,30)"
3715,2020-02-18,Brazil,0,0,0,"rgb(102,166,30)"
3716,2020-02-19,Brazil,0,0,0,"rgb(102,166,30)"
3717,2020-02-20,Brazil,0,0,0,"rgb(102,166,30)"
3718,2020-02-21,Brazil,0,0,0,"rgb(102,166,30)"
3719,2020-02-22,Brazil,0,0,0,"rgb(102,166,30)"
3720,2020-02-23,Brazil,0,0,0,"rgb(102,166,30)"
3721,2020-02-24,Brazil,0,0,0,"rgb(102,166,30)"
3722,2020-02-25,Brazil,0,0,0,"rgb(102,166,30)"
3723,2020-02-26,Brazil,0,1,1,"rgb(102,166,30)"
3724,2020-02-27,Brazil,0,0,1,"rgb(102,166,30)"
3725,2020-02-28,Brazil,0,0,1,"rgb(102,166,30)"
3726,2020-02-29,Brazil,0,0,1,"rgb(102,166,30)"
3727,2020-03-01,Brazil,0,1,2,"rgb(102,166,30)"
3728,2020-03-02,Brazil,0,0,2,"rgb(102,166,30)"
3729,2020-03-03,Brazil,0,0,2,"rgb(102,166,30)"
3730,2020-03-04,Brazil,0,0,2,"rgb(102,166,30)"
3731,2020-03-05,Brazil,0,1,3,"rgb(102,166,30)"
3732,2020-03-06,Brazil,0,5,8,"rgb(102,166,30)"
3733,2020-03-07,Brazil,0,5,13,"rgb(102,166,30)"
3734,2020-03-08,Brazil,0,0,13,"rgb(102,166,30)"
3735,2020-03-09,Brazil,0,12,25,"rgb(102,166,30)"
3736,2020-03-10,Brazil,0,0,25,"rgb(102,166,30)"
3737,2020-03-11,Brazil,0,9,34,"rgb(102,166,30)"
3738,2020-03-12,Brazil,0,18,52,"rgb(102,166,30)"
3739,2020-03-13,Brazil,0,25,77,"rgb(102,166,30)"
3740,2020-03-14,Brazil,0,21,98,"rgb(102,166,30)"
3741,2020-03-15,Brazil,0,23,121,"rgb(102,166,30)"
3742,2020-03-16,Brazil,0,79,200,"rgb(102,166,30)"
3743,2020-03-17,Brazil,0,34,234,"rgb(102,166,30)"
3744,2020-03-18,Brazil,1,57,291,"rgb(102,166,30)"
3745,2020-03-19,Brazil,3,137,428,"rgb(102,166,30)"
3746,2020-03-20,Brazil,2,193,621,"rgb(102,166,30)"
3747,2020-03-21,Brazil,5,283,904,"rgb(102,166,30)"
3748,2020-03-22,Brazil,7,224,1128,"rgb(102,166,30)"
3749,2020-03-23,Brazil,7,418,1546,"rgb(102,166,30)"
3750,2020-03-24,Brazil,9,345,1891,"rgb(102,166,30)"
3751,2020-03-25,Brazil,12,310,2201,"rgb(102,166,30)"
3752,2020-03-26,Brazil,11,232,2433,"rgb(102,166,30)"
3753,2020-03-27,Brazil,20,482,2915,"rgb(102,166,30)"
3754,2020-03-28,Brazil,15,502,3417,"rgb(102,166,30)"
3755,2020-03-29,Brazil,22,487,3904,"rgb(102,166,30)"
3756,2020-03-30,Brazil,22,352,4256,"rgb(102,166,30)"
3757,2020-03-31,Brazil,23,323,4579,"rgb(102,166,30)"
3758,2020-04-01,Brazil,42,1138,5717,"rgb(102,166,30)"
3759,2020-04-02,Brazil,40,1119,6836,"rgb(102,166,30)"
3760,2020-04-03,Brazil,58,1074,7910,"rgb(102,166,30)"
3761,2020-04-04,Brazil,60,1146,9056,"rgb(102,166,30)"
3762,2020-04-05,Brazil,73,1222,10278,"rgb(102,166,30)"
3763,2020-04-06,Brazil,54,852,11130,"rgb(102,166,30)"
3764,2020-04-07,Brazil,67,926,12056,"rgb(102,166,30)"
3765,2020-04-08,Brazil,114,1661,13717,"rgb(102,166,30)"
3766,2020-04-09,Brazil,133,2210,15927,"rgb(102,166,30)"
3767,2020-04-10,Brazil,141,1930,17857,"rgb(102,166,30)"
3768,2020-04-11,Brazil,115,1781,19638,"rgb(102,166,30)"
3769,2020-04-12,Brazil,68,1089,20727,"rgb(102,166,30)"
3770,2020-04-13,Brazil,99,1442,22169,"rgb(102,166,30)"
3771,2020-04-14,Brazil,105,1261,23430,"rgb(102,166,30)"
3772,2020-04-15,Brazil,204,1832,25262,"rgb(102,166,30)"
3773,2020-04-16,Brazil,204,3058,28320,"rgb(102,166,30)"
3774,2020-04-17,Brazil,188,2105,30425,"rgb(102,166,30)"
3775,2020-04-18,Brazil,217,3257,33682,"rgb(102,166,30)"
3776,2020-04-19,Brazil,206,2917,36599,"rgb(102,166,30)"
3777,2020-04-20,Brazil,115,2055,38654,"rgb(102,166,30)"
3778,2020-04-21,Brazil,113,1927,40581,"rgb(102,166,30)"
3779,2020-04-22,Brazil,166,2498,43079,"rgb(102,166,30)"
3780,2020-04-23,Brazil,165,2678,45757,"rgb(102,166,30)"
3781,2020-04-24,Brazil,407,3735,49492,"rgb(102,166,30)"
3782,2020-04-25,Brazil,357,3503,52995,"rgb(102,166,30)"
3783,2020-04-26,Brazil,346,5514,58509,"rgb(102,166,30)"
3784,2020-04-27,Brazil,189,3379,61888,"rgb(102,166,30)"
3785,2020-04-28,Brazil,338,4613,66501,"rgb(102,166,30)"
3786,2020-04-29,Brazil,474,5385,71886,"rgb(102,166,30)"
3787,2020-04-30,Brazil,449,6276,78162,"rgb(102,166,30)"
3788,2020-05-01,Brazil,435,7218,85380,"rgb(102,166,30)"
3789,2020-05-02,Brazil,428,6209,91589,"rgb(102,166,30)"
3790,2020-05-03,Brazil,421,4970,96559,"rgb(102,166,30)"
3791,2020-05-04,Brazil,275,4588,101147,"rgb(102,166,30)"
3792,2020-05-05,Brazil,296,6633,107780,"rgb(102,166,30)"
3793,2020-05-06,Brazil,600,6935,114715,"rgb(102,166,30)"
3794,2020-05-07,Brazil,615,10503,125218,"rgb(102,166,30)"
3795,2020-05-08,Brazil,610,9888,135106,"rgb(102,166,30)"
3796,2020-05-09,Brazil,751,10222,145328,"rgb(102,166,30)"
3797,2020-05-10,Brazil,730,10611,155939,"rgb(102,166,30)"
3798,2020-05-11,Brazil,496,6760,162699,"rgb(102,166,30)"
3799,2020-05-12,Brazil,396,5632,168331,"rgb(102,166,30)"
3800,2020-05-13,Brazil,881,9258,177589,"rgb(102,166,30)"
3801,2020-05-14,Brazil,749,11385,188974,"rgb(102,166,30)"
3802,2020-05-15,Brazil,844,13944,202918,"rgb(102,166,30)"
3803,2020-05-16,Brazil,824,15305,218223,"rgb(102,166,30)"
3804,2020-05-17,Brazil,816,14919,233142,"rgb(102,166,30)"
3805,2020-05-18,Brazil,485,7938,241080,"rgb(102,166,30)"
3806,2020-05-19,Brazil,674,13140,254220,"rgb(102,166,30)"
3807,2020-05-20,Brazil,1179,17408,271628,"rgb(102,166,30)"
3808,2020-05-21,Brazil,888,19951,291579,"rgb(102,166,30)"
3809,2020-05-22,Brazil,1188,18508,310087,"rgb(102,166,30)"
3810,2020-05-23,Brazil,1001,20803,330890,"rgb(102,166,30)"
3811,2020-05-24,Brazil,965,16508,347398,"rgb(102,166,30)"
3812,2020-05-25,Brazil,653,15813,363211,"rgb(102,166,30)"
3813,2020-05-26,Brazil,807,11687,374898,"rgb(102,166,30)"
3814,2020-05-27,Brazil,1039,16324,391222,"rgb(102,166,30)"
3815,2020-05-28,Brazil,1086,20599,411821,"rgb(102,166,30)"
3816,2020-05-29,Brazil,1156,26417,438238,"rgb(102,166,30)"
3817,2020-05-30,Brazil,1124,26928,465166,"rgb(102,166,30)"
3818,2020-05-31,Brazil,956,33274,498440,"rgb(102,166,30)"
3819,2020-06-01,Brazil,480,16409,514849,"rgb(102,166,30)"
3820,2020-06-02,Brazil,623,11598,526447,"rgb(102,166,30)"
3821,2020-06-03,Brazil,1262,28936,555383,"rgb(102,166,30)"
3822,2020-06-04,Brazil,1349,28633,584016,"rgb(102,166,30)"
3823,2020-06-05,Brazil,1473,30916,614932,"rgb(102,166,30)"
3824,2020-06-06,Brazil,1005,30830,645762,"rgb(102,166,30)"
3825,2020-06-07,Brazil,904,27075,672837,"rgb(102,166,30)"
3826,2020-06-08,Brazil,525,18921,691758,"rgb(102,166,30)"
3827,2020-06-09,Brazil,679,15654,707412,"rgb(102,166,30)"
3828,2020-06-10,Brazil,1272,32091,739503,"rgb(102,166,30)"
3829,2020-06-11,Brazil,1274,32913,772416,"rgb(102,166,30)"
3830,2020-06-12,Brazil,1239,30412,802828,"rgb(102,166,30)"
3831,2020-06-13,Brazil,909,25982,828810,"rgb(102,166,30)"
3832,2020-06-14,Brazil,892,21704,850514,"rgb(102,166,30)"
3833,2020-06-15,Brazil,612,17110,867624,"rgb(102,166,30)"
3834,2020-06-16,Brazil,627,20647,888271,"rgb(102,166,30)"
3835,2020-06-17,Brazil,1282,34918,923189,"rgb(102,166,30)"
3836,2020-06-18,Brazil,1269,32188,955377,"rgb(102,166,30)"
3837,2020-06-19,Brazil,1238,22765,978142,"rgb(102,166,30)"
3838,2020-06-20,Brazil,1206,54771,1032913,"rgb(102,166,30)"
3839,2020-06-21,Brazil,1022,34666,1067579,"rgb(102,166,30)"
3840,2020-06-22,Brazil,641,17459,1085038,"rgb(102,166,30)"
3841,2020-06-23,Brazil,654,21432,1106470,"rgb(102,166,30)"
3842,2020-06-24,Brazil,1374,39436,1145906,"rgb(102,166,30)"
3843,2020-06-25,Brazil,1185,42725,1188631,"rgb(102,166,30)"
3844,2020-06-26,Brazil,1141,39483,1228114,"rgb(102,166,30)"
3845,2020-06-27,Brazil,990,46860,1274974,"rgb(102,166,30)"
3846,2020-06-28,Brazil,1109,38693,1313667,"rgb(102,166,30)"
3847,2020-06-29,Brazil,552,30476,1344143,"rgb(102,166,30)"
3848,2020-06-30,Brazil,692,24052,1368195,"rgb(102,166,30)"
3849,2020-07-01,Brazil,1280,33846,1402041,"rgb(102,166,30)"
3850,2020-07-02,Brazil,1038,46712,1448753,"rgb(102,166,30)"
3851,2020-07-03,Brazil,1252,48105,1496858,"rgb(102,166,30)"
3852,2020-07-04,Brazil,1290,42223,1539081,"rgb(102,166,30)"
3853,2020-07-05,Brazil,1091,37923,1577004,"rgb(102,166,30)"
3854,2020-07-06,Brazil,602,26051,1603055,"rgb(102,166,30)"
3855,2020-07-07,Brazil,620,20229,1623284,"rgb(102,166,30)"
3856,2020-07-08,Brazil,1254,45305,1668589,"rgb(102,166,30)"
3857,2020-07-09,Brazil,1223,44571,1713160,"rgb(102,166,30)"
3858,2020-07-10,Brazil,1220,42619,1755779,"rgb(102,166,30)"
3859,2020-07-11,Brazil,1214,45048,1800827,"rgb(102,166,30)"
3860,2020-07-12,Brazil,1071,39023,1839850,"rgb(102,166,30)"
3861,2020-07-13,Brazil,631,24831,1864681,"rgb(102,166,30)"
3862,2020-03-16,Bahamas,0,1,1,"rgb(230,171,2)"
3863,2020-03-17,Bahamas,0,0,1,"rgb(230,171,2)"
3864,2020-03-20,Bahamas,0,2,3,"rgb(230,171,2)"
3865,2020-03-21,Bahamas,0,1,4,"rgb(230,171,2)"
3866,2020-03-22,Bahamas,0,0,4,"rgb(230,171,2)"
3867,2020-03-23,Bahamas,0,0,4,"rgb(230,171,2)"
3868,2020-03-24,Bahamas,0,0,4,"rgb(230,171,2)"
3869,2020-03-25,Bahamas,0,0,4,"rgb(230,171,2)"
3870,2020-03-26,Bahamas,0,1,5,"rgb(230,171,2)"
3871,2020-03-27,Bahamas,0,4,9,"rgb(230,171,2)"
3872,2020-03-28,Bahamas,0,0,9,"rgb(230,171,2)"
3873,2020-03-29,Bahamas,0,2,11,"rgb(230,171,2)"
3874,2020-03-30,Bahamas,0,3,14,"rgb(230,171,2)"
3875,2020-03-31,Bahamas,0,0,14,"rgb(230,171,2)"
3876,2020-04-01,Bahamas,0,1,15,"rgb(230,171,2)"
3877,2020-04-02,Bahamas,1,6,21,"rgb(230,171,2)"
3878,2020-04-03,Bahamas,0,3,24,"rgb(230,171,2)"
3879,2020-04-04,Bahamas,2,0,24,"rgb(230,171,2)"
3880,2020-04-05,Bahamas,1,4,28,"rgb(230,171,2)"
3881,2020-04-06,Bahamas,1,1,29,"rgb(230,171,2)"
3882,2020-04-07,Bahamas,0,4,33,"rgb(230,171,2)"
3883,2020-04-08,Bahamas,1,3,36,"rgb(230,171,2)"
3884,2020-04-09,Bahamas,1,4,40,"rgb(230,171,2)"
3885,2020-04-10,Bahamas,1,1,41,"rgb(230,171,2)"
3886,2020-04-11,Bahamas,0,1,42,"rgb(230,171,2)"
3887,2020-04-12,Bahamas,0,4,46,"rgb(230,171,2)"
3888,2020-04-13,Bahamas,0,1,47,"rgb(230,171,2)"
3889,2020-04-14,Bahamas,0,2,49,"rgb(230,171,2)"
3890,2020-04-15,Bahamas,0,0,49,"rgb(230,171,2)"
3891,2020-04-16,Bahamas,0,4,53,"rgb(230,171,2)"
3892,2020-04-17,Bahamas,1,1,54,"rgb(230,171,2)"
3893,2020-04-18,Bahamas,0,1,55,"rgb(230,171,2)"
3894,2020-04-19,Bahamas,0,3,58,"rgb(230,171,2)"
3895,2020-04-20,Bahamas,0,2,60,"rgb(230,171,2)"
3896,2020-04-21,Bahamas,0,4,64,"rgb(230,171,2)"
3897,2020-04-22,Bahamas,0,1,65,"rgb(230,171,2)"
3898,2020-04-23,Bahamas,0,5,70,"rgb(230,171,2)"
3899,2020-04-24,Bahamas,2,2,72,"rgb(230,171,2)"
3900,2020-04-25,Bahamas,0,1,73,"rgb(230,171,2)"
3901,2020-04-26,Bahamas,0,5,78,"rgb(230,171,2)"
3902,2020-04-27,Bahamas,0,2,80,"rgb(230,171,2)"
3903,2020-04-28,Bahamas,0,0,80,"rgb(230,171,2)"
3904,2020-04-29,Bahamas,0,0,80,"rgb(230,171,2)"
3905,2020-04-30,Bahamas,0,0,80,"rgb(230,171,2)"
3906,2020-05-01,Bahamas,0,1,81,"rgb(230,171,2)"
3907,2020-05-02,Bahamas,0,1,82,"rgb(230,171,2)"
3908,2020-05-03,Bahamas,0,1,83,"rgb(230,171,2)"
3909,2020-05-04,Bahamas,0,0,83,"rgb(230,171,2)"
3910,2020-05-05,Bahamas,0,0,83,"rgb(230,171,2)"
3911,2020-05-06,Bahamas,0,6,89,"rgb(230,171,2)"
3912,2020-05-07,Bahamas,0,3,92,"rgb(230,171,2)"
3913,2020-05-08,Bahamas,0,0,92,"rgb(230,171,2)"
3914,2020-05-09,Bahamas,0,0,92,"rgb(230,171,2)"
3915,2020-05-10,Bahamas,0,0,92,"rgb(230,171,2)"
3916,2020-05-11,Bahamas,0,0,92,"rgb(230,171,2)"
3917,2020-05-12,Bahamas,0,1,93,"rgb(230,171,2)"
3918,2020-05-13,Bahamas,0,0,93,"rgb(230,171,2)"
3919,2020-05-14,Bahamas,0,1,94,"rgb(230,171,2)"
3920,2020-05-15,Bahamas,0,2,96,"rgb(230,171,2)"
3921,2020-05-16,Bahamas,0,0,96,"rgb(230,171,2)"
3922,2020-05-17,Bahamas,0,0,96,"rgb(230,171,2)"
3923,2020-05-18,Bahamas,0,0,96,"rgb(230,171,2)"
3924,2020-05-19,Bahamas,0,0,96,"rgb(230,171,2)"
3925,2020-05-20,Bahamas,0,0,96,"rgb(230,171,2)"
3926,2020-05-21,Bahamas,0,1,97,"rgb(230,171,2)"
3927,2020-05-22,Bahamas,0,0,97,"rgb(230,171,2)"
3928,2020-05-23,Bahamas,0,0,97,"rgb(230,171,2)"
3929,2020-05-24,Bahamas,0,3,100,"rgb(230,171,2)"
3930,2020-05-25,Bahamas,0,0,100,"rgb(230,171,2)"
3931,2020-05-26,Bahamas,0,0,100,"rgb(230,171,2)"
3932,2020-05-27,Bahamas,0,0,100,"rgb(230,171,2)"
3933,2020-05-28,Bahamas,0,0,100,"rgb(230,171,2)"
3934,2020-05-29,Bahamas,0,1,101,"rgb(230,171,2)"
3935,2020-05-30,Bahamas,0,1,102,"rgb(230,171,2)"
3936,2020-05-31,Bahamas,0,0,102,"rgb(230,171,2)"
3937,2020-06-01,Bahamas,0,0,102,"rgb(230,171,2)"
3938,2020-06-02,Bahamas,0,0,102,"rgb(230,171,2)"
3939,2020-06-03,Bahamas,0,0,102,"rgb(230,171,2)"
3940,2020-06-04,Bahamas,0,0,102,"rgb(230,171,2)"
3941,2020-06-05,Bahamas,0,0,102,"rgb(230,171,2)"
3942,2020-06-06,Bahamas,0,0,102,"rgb(230,171,2)"
3943,2020-06-07,Bahamas,0,1,103,"rgb(230,171,2)"
3944,2020-06-08,Bahamas,0,0,103,"rgb(230,171,2)"
3945,2020-06-09,Bahamas,0,0,103,"rgb(230,171,2)"
3946,2020-06-10,Bahamas,0,0,103,"rgb(230,171,2)"
3947,2020-06-11,Bahamas,0,0,103,"rgb(230,171,2)"
3948,2020-06-12,Bahamas,0,0,103,"rgb(230,171,2)"
3949,2020-06-13,Bahamas,0,0,103,"rgb(230,171,2)"
3950,2020-06-14,Bahamas,0,0,103,"rgb(230,171,2)"
3951,2020-06-15,Bahamas,0,0,103,"rgb(230,171,2)"
3952,2020-06-16,Bahamas,0,1,104,"rgb(230,171,2)"
3953,2020-06-17,Bahamas,0,0,104,"rgb(230,171,2)"
3954,2020-06-18,Bahamas,0,0,104,"rgb(230,171,2)"
3955,2020-06-19,Bahamas,0,0,104,"rgb(230,171,2)"
3956,2020-06-20,Bahamas,0,0,104,"rgb(230,171,2)"
3957,2020-06-21,Bahamas,0,0,104,"rgb(230,171,2)"
3958,2020-06-22,Bahamas,0,0,104,"rgb(230,171,2)"
3959,2020-06-23,Bahamas,0,0,104,"rgb(230,171,2)"
3960,2020-06-24,Bahamas,0,0,104,"rgb(230,171,2)"
3961,2020-06-25,Bahamas,0,0,104,"rgb(230,171,2)"
3962,2020-06-26,Bahamas,0,0,104,"rgb(230,171,2)"
3963,2020-06-27,Bahamas,0,0,104,"rgb(230,171,2)"
3964,2020-06-28,Bahamas,0,0,104,"rgb(230,171,2)"
3965,2020-06-29,Bahamas,0,0,104,"rgb(230,171,2)"
3966,2020-06-30,Bahamas,0,0,104,"rgb(230,171,2)"
3967,2020-07-01,Bahamas,0,0,104,"rgb(230,171,2)"
3968,2020-07-02,Bahamas,0,0,104,"rgb(230,171,2)"
3969,2020-07-03,Bahamas,0,0,104,"rgb(230,171,2)"
3970,2020-07-04,Bahamas,0,0,104,"rgb(230,171,2)"
3971,2020-07-05,Bahamas,0,0,104,"rgb(230,171,2)"
3972,2020-07-06,Bahamas,0,0,104,"rgb(230,171,2)"
3973,2020-07-07,Bahamas,0,0,104,"rgb(230,171,2)"
3974,2020-07-08,Bahamas,0,0,104,"rgb(230,171,2)"
3975,2020-07-09,Bahamas,0,2,106,"rgb(230,171,2)"
3976,2020-07-10,Bahamas,0,1,107,"rgb(230,171,2)"
3977,2020-07-11,Bahamas,0,1,108,"rgb(230,171,2)"
3978,2020-07-12,Bahamas,0,3,111,"rgb(230,171,2)"
3979,2020-07-13,Bahamas,0,0,111,"rgb(230,171,2)"
3980,2020-03-06,Bhutan,0,1,1,"rgb(166,118,29)"
3981,2020-03-13,Bhutan,0,0,1,"rgb(166,118,29)"
3982,2020-03-15,Bhutan,0,0,1,"rgb(166,118,29)"
3983,2020-03-17,Bhutan,0,0,1,"rgb(166,118,29)"
3984,2020-03-18,Bhutan,0,0,1,"rgb(166,118,29)"
3985,2020-03-19,Bhutan,0,0,1,"rgb(166,118,29)"
3986,2020-03-20,Bhutan,0,0,1,"rgb(166,118,29)"
3987,2020-03-21,Bhutan,0,1,2,"rgb(166,118,29)"
3988,2020-03-22,Bhutan,0,0,2,"rgb(166,118,29)"
3989,2020-03-23,Bhutan,0,0,2,"rgb(166,118,29)"
3990,2020-03-24,Bhutan,0,0,2,"rgb(166,118,29)"
3991,2020-03-25,Bhutan,0,0,2,"rgb(166,118,29)"
3992,2020-03-26,Bhutan,0,1,3,"rgb(166,118,29)"
3993,2020-03-27,Bhutan,0,0,3,"rgb(166,118,29)"
3994,2020-03-28,Bhutan,0,0,3,"rgb(166,118,29)"
3995,2020-03-29,Bhutan,0,1,4,"rgb(166,118,29)"
3996,2020-03-30,Bhutan,0,0,4,"rgb(166,118,29)"
3997,2020-03-31,Bhutan,0,0,4,"rgb(166,118,29)"
3998,2020-04-01,Bhutan,0,0,4,"rgb(166,118,29)"
3999,2020-04-02,Bhutan,0,1,5,"rgb(166,118,29)"
4000,2020-04-03,Bhutan,0,0,5,"rgb(166,118,29)"
4001,2020-04-04,Bhutan,0,0,5,"rgb(166,118,29)"
4002,2020-04-05,Bhutan,0,0,5,"rgb(166,118,29)"
4003,2020-04-06,Bhutan,0,0,5,"rgb(166,118,29)"
4004,2020-04-07,Bhutan,0,0,5,"rgb(166,118,29)"
4005,2020-04-08,Bhutan,0,0,5,"rgb(166,118,29)"
4006,2020-04-09,Bhutan,0,0,5,"rgb(166,118,29)"
4007,2020-04-10,Bhutan,0,0,5,"rgb(166,118,29)"
4008,2020-04-11,Bhutan,0,0,5,"rgb(166,118,29)"
4009,2020-04-12,Bhutan,0,0,5,"rgb(166,118,29)"
4010,2020-04-13,Bhutan,0,0,5,"rgb(166,118,29)"
4011,2020-04-14,Bhutan,0,0,5,"rgb(166,118,29)"
4012,2020-04-15,Bhutan,0,0,5,"rgb(166,118,29)"
4013,2020-04-16,Bhutan,0,0,5,"rgb(166,118,29)"
4014,2020-04-17,Bhutan,0,0,5,"rgb(166,118,29)"
4015,2020-04-18,Bhutan,0,0,5,"rgb(166,118,29)"
4016,2020-04-19,Bhutan,0,0,5,"rgb(166,118,29)"
4017,2020-04-20,Bhutan,0,0,5,"rgb(166,118,29)"
4018,2020-04-21,Bhutan,0,1,6,"rgb(166,118,29)"
4019,2020-04-22,Bhutan,0,0,6,"rgb(166,118,29)"
4020,2020-04-23,Bhutan,0,1,7,"rgb(166,118,29)"
4021,2020-04-24,Bhutan,0,0,7,"rgb(166,118,29)"
4022,2020-04-25,Bhutan,0,0,7,"rgb(166,118,29)"
4023,2020-04-26,Bhutan,0,0,7,"rgb(166,118,29)"
4024,2020-04-27,Bhutan,0,0,7,"rgb(166,118,29)"
4025,2020-04-28,Bhutan,0,0,7,"rgb(166,118,29)"
4026,2020-04-29,Bhutan,0,0,7,"rgb(166,118,29)"
4027,2020-04-30,Bhutan,0,0,7,"rgb(166,118,29)"
4028,2020-05-01,Bhutan,0,0,7,"rgb(166,118,29)"
4029,2020-05-02,Bhutan,0,0,7,"rgb(166,118,29)"
4030,2020-05-03,Bhutan,0,0,7,"rgb(166,118,29)"
4031,2020-05-04,Bhutan,0,0,7,"rgb(166,118,29)"
4032,2020-05-05,Bhutan,0,0,7,"rgb(166,118,29)"
4033,2020-05-06,Bhutan,0,0,7,"rgb(166,118,29)"
4034,2020-05-07,Bhutan,0,0,7,"rgb(166,118,29)"
4035,2020-05-08,Bhutan,0,0,7,"rgb(166,118,29)"
4036,2020-05-09,Bhutan,0,0,7,"rgb(166,118,29)"
4037,2020-05-10,Bhutan,0,0,7,"rgb(166,118,29)"
4038,2020-05-11,Bhutan,0,2,9,"rgb(166,118,29)"
4039,2020-05-12,Bhutan,0,2,11,"rgb(166,118,29)"
4040,2020-05-13,Bhutan,0,0,11,"rgb(166,118,29)"
4041,2020-05-14,Bhutan,0,4,15,"rgb(166,118,29)"
4042,2020-05-15,Bhutan,0,5,20,"rgb(166,118,29)"
4043,2020-05-16,Bhutan,0,1,21,"rgb(166,118,29)"
4044,2020-05-17,Bhutan,0,0,21,"rgb(166,118,29)"
4045,2020-05-18,Bhutan,0,0,21,"rgb(166,118,29)"
4046,2020-05-19,Bhutan,0,0,21,"rgb(166,118,29)"
4047,2020-05-20,Bhutan,0,0,21,"rgb(166,118,29)"
4048,2020-05-21,Bhutan,0,0,21,"rgb(166,118,29)"
4049,2020-05-22,Bhutan,0,0,21,"rgb(166,118,29)"
4050,2020-05-23,Bhutan,0,3,24,"rgb(166,118,29)"
4051,2020-05-24,Bhutan,0,0,24,"rgb(166,118,29)"
4052,2020-05-25,Bhutan,0,3,27,"rgb(166,118,29)"
4053,2020-05-26,Bhutan,0,0,27,"rgb(166,118,29)"
4054,2020-05-27,Bhutan,0,0,27,"rgb(166,118,29)"
4055,2020-05-28,Bhutan,0,1,28,"rgb(166,118,29)"
4056,2020-05-29,Bhutan,0,3,31,"rgb(166,118,29)"
4057,2020-05-30,Bhutan,0,2,33,"rgb(166,118,29)"
4058,2020-05-31,Bhutan,0,10,43,"rgb(166,118,29)"
4059,2020-06-01,Bhutan,0,0,43,"rgb(166,118,29)"
4060,2020-06-02,Bhutan,0,4,47,"rgb(166,118,29)"
4061,2020-06-03,Bhutan,0,0,47,"rgb(166,118,29)"
4062,2020-06-04,Bhutan,0,0,47,"rgb(166,118,29)"
4063,2020-06-05,Bhutan,0,1,48,"rgb(166,118,29)"
4064,2020-06-06,Bhutan,0,0,48,"rgb(166,118,29)"
4065,2020-06-07,Bhutan,0,0,48,"rgb(166,118,29)"
4066,2020-06-08,Bhutan,0,11,59,"rgb(166,118,29)"
4067,2020-06-09,Bhutan,0,0,59,"rgb(166,118,29)"
4068,2020-06-10,Bhutan,0,0,59,"rgb(166,118,29)"
4069,2020-06-11,Bhutan,0,3,62,"rgb(166,118,29)"
4070,2020-06-12,Bhutan,0,0,62,"rgb(166,118,29)"
4071,2020-06-13,Bhutan,0,0,62,"rgb(166,118,29)"
4072,2020-06-14,Bhutan,0,4,66,"rgb(166,118,29)"
4073,2020-06-15,Bhutan,0,0,66,"rgb(166,118,29)"
4074,2020-06-16,Bhutan,0,1,67,"rgb(166,118,29)"
4075,2020-06-17,Bhutan,0,0,67,"rgb(166,118,29)"
4076,2020-06-18,Bhutan,0,0,67,"rgb(166,118,29)"
4077,2020-06-19,Bhutan,0,0,67,"rgb(166,118,29)"
4078,2020-06-20,Bhutan,0,1,68,"rgb(166,118,29)"
4079,2020-06-21,Bhutan,0,0,68,"rgb(166,118,29)"
4080,2020-06-22,Bhutan,0,0,68,"rgb(166,118,29)"
4081,2020-06-23,Bhutan,0,1,69,"rgb(166,118,29)"
4082,2020-06-24,Bhutan,0,1,70,"rgb(166,118,29)"
4083,2020-06-25,Bhutan,0,0,70,"rgb(166,118,29)"
4084,2020-06-26,Bhutan,0,0,70,"rgb(166,118,29)"
4085,2020-06-27,Bhutan,0,5,75,"rgb(166,118,29)"
4086,2020-06-28,Bhutan,0,1,76,"rgb(166,118,29)"
4087,2020-06-29,Bhutan,0,0,76,"rgb(166,118,29)"
4088,2020-06-30,Bhutan,0,1,77,"rgb(166,118,29)"
4089,2020-07-01,Bhutan,0,0,77,"rgb(166,118,29)"
4090,2020-07-02,Bhutan,0,0,77,"rgb(166,118,29)"
4091,2020-07-03,Bhutan,0,0,77,"rgb(166,118,29)"
4092,2020-07-04,Bhutan,0,1,78,"rgb(166,118,29)"
4093,2020-07-05,Bhutan,0,0,78,"rgb(166,118,29)"
4094,2020-07-06,Bhutan,0,2,80,"rgb(166,118,29)"
4095,2020-07-07,Bhutan,0,0,80,"rgb(166,118,29)"
4096,2020-07-08,Bhutan,0,0,80,"rgb(166,118,29)"
4097,2020-07-09,Bhutan,0,0,80,"rgb(166,118,29)"
4098,2020-07-10,Bhutan,0,0,80,"rgb(166,118,29)"
4099,2020-07-11,Bhutan,0,2,82,"rgb(166,118,29)"
4100,2020-07-12,Bhutan,0,0,82,"rgb(166,118,29)"
4101,2020-07-13,Bhutan,0,2,84,"rgb(166,118,29)"
4102,2020-04-01,Botswana,0,3,3,"rgb(102,102,102)"
4103,2020-04-02,Botswana,1,1,4,"rgb(102,102,102)"
4104,2020-04-03,Botswana,0,0,4,"rgb(102,102,102)"
4105,2020-04-04,Botswana,0,0,4,"rgb(102,102,102)"
4106,2020-04-05,Botswana,0,0,4,"rgb(102,102,102)"
4107,2020-04-06,Botswana,0,2,6,"rgb(102,102,102)"
4108,2020-04-07,Botswana,0,0,6,"rgb(102,102,102)"
4109,2020-04-08,Botswana,0,0,6,"rgb(102,102,102)"
4110,2020-04-09,Botswana,0,1,7,"rgb(102,102,102)"
4111,2020-04-10,Botswana,0,6,13,"rgb(102,102,102)"
4112,2020-04-11,Botswana,0,0,13,"rgb(102,102,102)"
4113,2020-04-12,Botswana,0,0,13,"rgb(102,102,102)"
4114,2020-04-13,Botswana,0,0,13,"rgb(102,102,102)"
4115,2020-04-14,Botswana,0,0,13,"rgb(102,102,102)"
4116,2020-04-15,Botswana,0,0,13,"rgb(102,102,102)"
4117,2020-04-16,Botswana,0,0,13,"rgb(102,102,102)"
4118,2020-04-17,Botswana,0,2,15,"rgb(102,102,102)"
4119,2020-04-18,Botswana,0,0,15,"rgb(102,102,102)"
4120,2020-04-19,Botswana,0,0,15,"rgb(102,102,102)"
4121,2020-04-20,Botswana,0,5,20,"rgb(102,102,102)"
4122,2020-04-21,Botswana,0,0,20,"rgb(102,102,102)"
4123,2020-04-22,Botswana,0,0,20,"rgb(102,102,102)"
4124,2020-04-23,Botswana,0,2,22,"rgb(102,102,102)"
4125,2020-04-24,Botswana,0,0,22,"rgb(102,102,102)"
4126,2020-04-25,Botswana,0,0,22,"rgb(102,102,102)"
4127,2020-04-26,Botswana,0,0,22,"rgb(102,102,102)"
4128,2020-04-27,Botswana,0,0,22,"rgb(102,102,102)"
4129,2020-04-28,Botswana,0,0,22,"rgb(102,102,102)"
4130,2020-04-29,Botswana,0,1,23,"rgb(102,102,102)"
4131,2020-04-30,Botswana,0,0,23,"rgb(102,102,102)"
4132,2020-05-01,Botswana,0,0,23,"rgb(102,102,102)"
4133,2020-05-02,Botswana,0,0,23,"rgb(102,102,102)"
4134,2020-05-03,Botswana,0,0,23,"rgb(102,102,102)"
4135,2020-05-04,Botswana,0,0,23,"rgb(102,102,102)"
4136,2020-05-05,Botswana,0,0,23,"rgb(102,102,102)"
4137,2020-05-06,Botswana,0,0,23,"rgb(102,102,102)"
4138,2020-05-07,Botswana,0,0,23,"rgb(102,102,102)"
4139,2020-05-08,Botswana,0,0,23,"rgb(102,102,102)"
4140,2020-05-09,Botswana,0,0,23,"rgb(102,102,102)"
4141,2020-05-10,Botswana,0,0,23,"rgb(102,102,102)"
4142,2020-05-11,Botswana,0,0,23,"rgb(102,102,102)"
4143,2020-05-12,Botswana,0,1,24,"rgb(102,102,102)"
4144,2020-05-13,Botswana,0,0,24,"rgb(102,102,102)"
4145,2020-05-14,Botswana,0,0,24,"rgb(102,102,102)"
4146,2020-05-15,Botswana,0,0,24,"rgb(102,102,102)"
4147,2020-05-16,Botswana,0,0,24,"rgb(102,102,102)"
4148,2020-05-17,Botswana,0,0,24,"rgb(102,102,102)"
4149,2020-05-18,Botswana,0,1,25,"rgb(102,102,102)"
4150,2020-05-19,Botswana,0,0,25,"rgb(102,102,102)"
4151,2020-05-20,Botswana,0,0,25,"rgb(102,102,102)"
4152,2020-05-21,Botswana,0,4,29,"rgb(102,102,102)"
4153,2020-05-22,Botswana,0,0,29,"rgb(102,102,102)"
4154,2020-05-23,Botswana,0,1,30,"rgb(102,102,102)"
4155,2020-05-24,Botswana,0,0,30,"rgb(102,102,102)"
4156,2020-05-25,Botswana,0,5,35,"rgb(102,102,102)"
4157,2020-05-26,Botswana,0,0,35,"rgb(102,102,102)"
4158,2020-05-27,Botswana,0,0,35,"rgb(102,102,102)"
4159,2020-05-28,Botswana,0,0,35,"rgb(102,102,102)"
4160,2020-05-29,Botswana,0,0,35,"rgb(102,102,102)"
4161,2020-05-30,Botswana,0,0,35,"rgb(102,102,102)"
4162,2020-05-31,Botswana,0,0,35,"rgb(102,102,102)"
4163,2020-06-01,Botswana,0,3,38,"rgb(102,102,102)"
4164,2020-06-02,Botswana,0,0,38,"rgb(102,102,102)"
4165,2020-06-03,Botswana,0,0,38,"rgb(102,102,102)"
4166,2020-06-04,Botswana,0,2,40,"rgb(102,102,102)"
4167,2020-06-05,Botswana,0,0,40,"rgb(102,102,102)"
4168,2020-06-06,Botswana,0,0,40,"rgb(102,102,102)"
4169,2020-06-07,Botswana,0,0,40,"rgb(102,102,102)"
4170,2020-06-08,Botswana,0,0,40,"rgb(102,102,102)"
4171,2020-06-09,Botswana,0,2,42,"rgb(102,102,102)"
4172,2020-06-10,Botswana,0,0,42,"rgb(102,102,102)"
4173,2020-06-11,Botswana,0,6,48,"rgb(102,102,102)"
4174,2020-06-12,Botswana,0,0,48,"rgb(102,102,102)"
4175,2020-06-13,Botswana,0,12,60,"rgb(102,102,102)"
4176,2020-06-14,Botswana,0,0,60,"rgb(102,102,102)"
4177,2020-06-15,Botswana,0,0,60,"rgb(102,102,102)"
4178,2020-06-16,Botswana,0,0,60,"rgb(102,102,102)"
4179,2020-06-17,Botswana,0,0,60,"rgb(102,102,102)"
4180,2020-06-18,Botswana,0,0,60,"rgb(102,102,102)"
4181,2020-06-19,Botswana,0,19,79,"rgb(102,102,102)"
4182,2020-06-20,Botswana,0,10,89,"rgb(102,102,102)"
4183,2020-06-21,Botswana,0,0,89,"rgb(102,102,102)"
4184,2020-06-22,Botswana,0,0,89,"rgb(102,102,102)"
4185,2020-06-23,Botswana,0,0,89,"rgb(102,102,102)"
4186,2020-06-24,Botswana,0,0,89,"rgb(102,102,102)"
4187,2020-06-25,Botswana,0,0,89,"rgb(102,102,102)"
4188,2020-06-26,Botswana,0,0,89,"rgb(102,102,102)"
4189,2020-06-27,Botswana,0,36,125,"rgb(102,102,102)"
4190,2020-06-28,Botswana,0,0,125,"rgb(102,102,102)"
4191,2020-06-29,Botswana,0,0,125,"rgb(102,102,102)"
4192,2020-06-30,Botswana,0,50,175,"rgb(102,102,102)"
4193,2020-07-01,Botswana,0,52,227,"rgb(102,102,102)"
4194,2020-07-02,Botswana,0,0,227,"rgb(102,102,102)"
4195,2020-07-03,Botswana,0,0,227,"rgb(102,102,102)"
4196,2020-07-04,Botswana,0,48,275,"rgb(102,102,102)"
4197,2020-07-05,Botswana,0,0,275,"rgb(102,102,102)"
4198,2020-07-06,Botswana,0,0,275,"rgb(102,102,102)"
4199,2020-07-07,Botswana,0,0,275,"rgb(102,102,102)"
4200,2020-07-08,Botswana,0,39,314,"rgb(102,102,102)"
4201,2020-07-09,Botswana,0,0,314,"rgb(102,102,102)"
4202,2020-07-10,Botswana,0,0,314,"rgb(102,102,102)"
4203,2020-07-11,Botswana,0,0,314,"rgb(102,102,102)"
4204,2020-07-12,Botswana,0,0,314,"rgb(102,102,102)"
4205,2020-07-13,Botswana,0,85,399,"rgb(102,102,102)"
4206,2019-12-31,Belarus,0,0,0,"rgb(102, 197, 204)"
4207,2020-01-01,Belarus,0,0,0,"rgb(102, 197, 204)"
4208,2020-01-02,Belarus,0,0,0,"rgb(102, 197, 204)"
4209,2020-01-03,Belarus,0,0,0,"rgb(102, 197, 204)"
4210,2020-01-04,Belarus,0,0,0,"rgb(102, 197, 204)"
4211,2020-01-05,Belarus,0,0,0,"rgb(102, 197, 204)"
4212,2020-01-06,Belarus,0,0,0,"rgb(102, 197, 204)"
4213,2020-01-07,Belarus,0,0,0,"rgb(102, 197, 204)"
4214,2020-01-08,Belarus,0,0,0,"rgb(102, 197, 204)"
4215,2020-01-09,Belarus,0,0,0,"rgb(102, 197, 204)"
4216,2020-01-10,Belarus,0,0,0,"rgb(102, 197, 204)"
4217,2020-01-11,Belarus,0,0,0,"rgb(102, 197, 204)"
4218,2020-01-12,Belarus,0,0,0,"rgb(102, 197, 204)"
4219,2020-01-13,Belarus,0,0,0,"rgb(102, 197, 204)"
4220,2020-01-14,Belarus,0,0,0,"rgb(102, 197, 204)"
4221,2020-01-15,Belarus,0,0,0,"rgb(102, 197, 204)"
4222,2020-01-16,Belarus,0,0,0,"rgb(102, 197, 204)"
4223,2020-01-17,Belarus,0,0,0,"rgb(102, 197, 204)"
4224,2020-01-18,Belarus,0,0,0,"rgb(102, 197, 204)"
4225,2020-01-19,Belarus,0,0,0,"rgb(102, 197, 204)"
4226,2020-01-20,Belarus,0,0,0,"rgb(102, 197, 204)"
4227,2020-01-21,Belarus,0,0,0,"rgb(102, 197, 204)"
4228,2020-01-22,Belarus,0,0,0,"rgb(102, 197, 204)"
4229,2020-01-23,Belarus,0,0,0,"rgb(102, 197, 204)"
4230,2020-01-24,Belarus,0,0,0,"rgb(102, 197, 204)"
4231,2020-01-25,Belarus,0,0,0,"rgb(102, 197, 204)"
4232,2020-01-26,Belarus,0,0,0,"rgb(102, 197, 204)"
4233,2020-01-27,Belarus,0,0,0,"rgb(102, 197, 204)"
4234,2020-01-28,Belarus,0,0,0,"rgb(102, 197, 204)"
4235,2020-01-29,Belarus,0,0,0,"rgb(102, 197, 204)"
4236,2020-01-30,Belarus,0,0,0,"rgb(102, 197, 204)"
4237,2020-01-31,Belarus,0,0,0,"rgb(102, 197, 204)"
4238,2020-02-01,Belarus,0,0,0,"rgb(102, 197, 204)"
4239,2020-02-02,Belarus,0,0,0,"rgb(102, 197, 204)"
4240,2020-02-03,Belarus,0,0,0,"rgb(102, 197, 204)"
4241,2020-02-04,Belarus,0,0,0,"rgb(102, 197, 204)"
4242,2020-02-05,Belarus,0,0,0,"rgb(102, 197, 204)"
4243,2020-02-06,Belarus,0,0,0,"rgb(102, 197, 204)"
4244,2020-02-07,Belarus,0,0,0,"rgb(102, 197, 204)"
4245,2020-02-08,Belarus,0,0,0,"rgb(102, 197, 204)"
4246,2020-02-09,Belarus,0,0,0,"rgb(102, 197, 204)"
4247,2020-02-10,Belarus,0,0,0,"rgb(102, 197, 204)"
4248,2020-02-11,Belarus,0,0,0,"rgb(102, 197, 204)"
4249,2020-02-12,Belarus,0,0,0,"rgb(102, 197, 204)"
4250,2020-02-13,Belarus,0,0,0,"rgb(102, 197, 204)"
4251,2020-02-14,Belarus,0,0,0,"rgb(102, 197, 204)"
4252,2020-02-15,Belarus,0,0,0,"rgb(102, 197, 204)"
4253,2020-02-16,Belarus,0,0,0,"rgb(102, 197, 204)"
4254,2020-02-17,Belarus,0,0,0,"rgb(102, 197, 204)"
4255,2020-02-18,Belarus,0,0,0,"rgb(102, 197, 204)"
4256,2020-02-19,Belarus,0,0,0,"rgb(102, 197, 204)"
4257,2020-02-20,Belarus,0,0,0,"rgb(102, 197, 204)"
4258,2020-02-21,Belarus,0,0,0,"rgb(102, 197, 204)"
4259,2020-02-22,Belarus,0,0,0,"rgb(102, 197, 204)"
4260,2020-02-23,Belarus,0,0,0,"rgb(102, 197, 204)"
4261,2020-02-24,Belarus,0,0,0,"rgb(102, 197, 204)"
4262,2020-02-25,Belarus,0,0,0,"rgb(102, 197, 204)"
4263,2020-02-26,Belarus,0,0,0,"rgb(102, 197, 204)"
4264,2020-02-27,Belarus,0,0,0,"rgb(102, 197, 204)"
4265,2020-02-28,Belarus,0,1,1,"rgb(102, 197, 204)"
4266,2020-02-29,Belarus,0,0,1,"rgb(102, 197, 204)"
4267,2020-03-01,Belarus,0,0,1,"rgb(102, 197, 204)"
4268,2020-03-02,Belarus,0,0,1,"rgb(102, 197, 204)"
4269,2020-03-04,Belarus,0,3,4,"rgb(102, 197, 204)"
4270,2020-03-05,Belarus,0,2,6,"rgb(102, 197, 204)"
4271,2020-03-11,Belarus,0,3,9,"rgb(102, 197, 204)"
4272,2020-03-12,Belarus,0,3,12,"rgb(102, 197, 204)"
4273,2020-03-13,Belarus,0,9,21,"rgb(102, 197, 204)"
4274,2020-03-16,Belarus,0,6,27,"rgb(102, 197, 204)"
4275,2020-03-17,Belarus,0,9,36,"rgb(102, 197, 204)"
4276,2020-03-18,Belarus,0,0,36,"rgb(102, 197, 204)"
4277,2020-03-19,Belarus,0,10,46,"rgb(102, 197, 204)"
4278,2020-03-20,Belarus,0,11,57,"rgb(102, 197, 204)"
4279,2020-03-21,Belarus,0,0,57,"rgb(102, 197, 204)"
4280,2020-03-22,Belarus,0,19,76,"rgb(102, 197, 204)"
4281,2020-03-23,Belarus,0,0,76,"rgb(102, 197, 204)"
4282,2020-03-24,Belarus,0,5,81,"rgb(102, 197, 204)"
4283,2020-03-25,Belarus,0,0,81,"rgb(102, 197, 204)"
4284,2020-03-26,Belarus,0,5,86,"rgb(102, 197, 204)"
4285,2020-03-27,Belarus,0,0,86,"rgb(102, 197, 204)"
4286,2020-03-28,Belarus,0,8,94,"rgb(102, 197, 204)"
4287,2020-03-29,Belarus,0,0,94,"rgb(102, 197, 204)"
4288,2020-03-30,Belarus,0,0,94,"rgb(102, 197, 204)"
4289,2020-03-31,Belarus,0,11,105,"rgb(102, 197, 204)"
4290,2020-04-01,Belarus,0,47,152,"rgb(102, 197, 204)"
4291,2020-04-02,Belarus,0,0,152,"rgb(102, 197, 204)"
4292,2020-04-03,Belarus,4,102,254,"rgb(102, 197, 204)"
4293,2020-04-04,Belarus,0,97,351,"rgb(102, 197, 204)"
4294,2020-04-05,Belarus,1,43,394,"rgb(102, 197, 204)"
4295,2020-04-06,Belarus,3,170,564,"rgb(102, 197, 204)"
4296,2020-04-07,Belarus,5,136,700,"rgb(102, 197, 204)"
4297,2020-04-08,Belarus,0,161,861,"rgb(102, 197, 204)"
4298,2020-04-09,Belarus,0,205,1066,"rgb(102, 197, 204)"
4299,2020-04-10,Belarus,3,420,1486,"rgb(102, 197, 204)"
4300,2020-04-11,Belarus,3,495,1981,"rgb(102, 197, 204)"
4301,2020-04-12,Belarus,4,245,2226,"rgb(102, 197, 204)"
4302,2020-04-13,Belarus,3,352,2578,"rgb(102, 197, 204)"
4303,2020-04-14,Belarus,3,341,2919,"rgb(102, 197, 204)"
4304,2020-04-15,Belarus,4,362,3281,"rgb(102, 197, 204)"
4305,2020-04-16,Belarus,3,447,3728,"rgb(102, 197, 204)"
4306,2020-04-17,Belarus,4,476,4204,"rgb(102, 197, 204)"
4307,2020-04-18,Belarus,2,575,4779,"rgb(102, 197, 204)"
4308,2020-04-19,Belarus,3,0,4779,"rgb(102, 197, 204)"
4309,2020-04-20,Belarus,2,0,4779,"rgb(102, 197, 204)"
4310,2020-04-21,Belarus,4,1485,6264,"rgb(102, 197, 204)"
4311,2020-04-22,Belarus,4,459,6723,"rgb(102, 197, 204)"
4312,2020-04-23,Belarus,3,558,7281,"rgb(102, 197, 204)"
4313,2020-04-24,Belarus,2,741,8022,"rgb(102, 197, 204)"
4314,2020-04-25,Belarus,3,751,8773,"rgb(102, 197, 204)"
4315,2020-04-26,Belarus,4,817,9590,"rgb(102, 197, 204)"
4316,2020-04-27,Belarus,5,873,10463,"rgb(102, 197, 204)"
4317,2020-04-28,Belarus,3,826,11289,"rgb(102, 197, 204)"
4318,2020-04-29,Belarus,4,919,12208,"rgb(102, 197, 204)"
4319,2020-04-30,Belarus,5,973,13181,"rgb(102, 197, 204)"
4320,2020-05-01,Belarus,5,846,14027,"rgb(102, 197, 204)"
4321,2020-05-02,Belarus,4,890,14917,"rgb(102, 197, 204)"
4322,2020-05-03,Belarus,4,911,15828,"rgb(102, 197, 204)"
4323,2020-05-04,Belarus,2,877,16705,"rgb(102, 197, 204)"
4324,2020-05-05,Belarus,4,784,17489,"rgb(102, 197, 204)"
4325,2020-05-06,Belarus,4,861,18350,"rgb(102, 197, 204)"
4326,2020-05-07,Belarus,5,905,19255,"rgb(102, 197, 204)"
4327,2020-05-08,Belarus,4,913,20168,"rgb(102, 197, 204)"
4328,2020-05-09,Belarus,5,933,21101,"rgb(102, 197, 204)"
4329,2020-05-10,Belarus,5,951,22052,"rgb(102, 197, 204)"
4330,2020-05-11,Belarus,5,921,22973,"rgb(102, 197, 204)"
4331,2020-05-12,Belarus,4,933,23906,"rgb(102, 197, 204)"
4332,2020-05-13,Belarus,7,967,24873,"rgb(102, 197, 204)"
4333,2020-05-14,Belarus,4,952,25825,"rgb(102, 197, 204)"
4334,2020-05-15,Belarus,5,947,26772,"rgb(102, 197, 204)"
4335,2020-05-16,Belarus,5,958,27730,"rgb(102, 197, 204)"
4336,2020-05-17,Belarus,4,951,28681,"rgb(102, 197, 204)"
4337,2020-05-18,Belarus,5,969,29650,"rgb(102, 197, 204)"
4338,2020-05-19,Belarus,6,922,30572,"rgb(102, 197, 204)"
4339,2020-05-20,Belarus,4,936,31508,"rgb(102, 197, 204)"
4340,2020-05-21,Belarus,4,918,32426,"rgb(102, 197, 204)"
4341,2020-05-22,Belarus,6,945,33371,"rgb(102, 197, 204)"
4342,2020-05-23,Belarus,5,932,34303,"rgb(102, 197, 204)"
4343,2020-05-24,Belarus,4,941,35244,"rgb(102, 197, 204)"
4344,2020-05-25,Belarus,5,954,36198,"rgb(102, 197, 204)"
4345,2020-05-26,Belarus,5,946,37144,"rgb(102, 197, 204)"
4346,2020-05-27,Belarus,4,915,38059,"rgb(102, 197, 204)"
4347,2020-05-28,Belarus,6,897,38956,"rgb(102, 197, 204)"
4348,2020-05-29,Belarus,5,902,39858,"rgb(102, 197, 204)"
4349,2020-05-30,Belarus,5,906,40764,"rgb(102, 197, 204)"
4350,2020-05-31,Belarus,5,894,41658,"rgb(102, 197, 204)"
4351,2020-06-01,Belarus,6,898,42556,"rgb(102, 197, 204)"
4352,2020-06-02,Belarus,5,847,43403,"rgb(102, 197, 204)"
4353,2020-06-03,Belarus,3,852,44255,"rgb(102, 197, 204)"
4354,2020-06-04,Belarus,5,861,45116,"rgb(102, 197, 204)"
4355,2020-06-05,Belarus,5,865,45981,"rgb(102, 197, 204)"
4356,2020-06-06,Belarus,6,887,46868,"rgb(102, 197, 204)"
4357,2020-06-07,Belarus,4,883,47751,"rgb(102, 197, 204)"
4358,2020-06-08,Belarus,6,879,48630,"rgb(102, 197, 204)"
4359,2020-06-09,Belarus,7,823,49453,"rgb(102, 197, 204)"
4360,2020-06-10,Belarus,6,812,50265,"rgb(102, 197, 204)"
4361,2020-06-11,Belarus,6,801,51066,"rgb(102, 197, 204)"
4362,2020-06-12,Belarus,5,750,51816,"rgb(102, 197, 204)"
4363,2020-06-13,Belarus,5,704,52520,"rgb(102, 197, 204)"
4364,2020-06-14,Belarus,5,721,53241,"rgb(102, 197, 204)"
4365,2020-06-15,Belarus,5,732,53973,"rgb(102, 197, 204)"
4366,2020-06-16,Belarus,4,707,54680,"rgb(102, 197, 204)"
4367,2020-06-17,Belarus,6,689,55369,"rgb(102, 197, 204)"
4368,2020-06-18,Belarus,6,663,56032,"rgb(102, 197, 204)"
4369,2020-06-19,Belarus,7,625,56657,"rgb(102, 197, 204)"
4370,2020-06-20,Belarus,2,676,57333,"rgb(102, 197, 204)"
4371,2020-06-21,Belarus,10,603,57936,"rgb(102, 197, 204)"
4372,2020-06-22,Belarus,3,569,58505,"rgb(102, 197, 204)"
4373,2020-06-23,Belarus,5,518,59023,"rgb(102, 197, 204)"
4374,2020-06-24,Belarus,6,464,59487,"rgb(102, 197, 204)"
4375,2020-06-25,Belarus,5,458,59945,"rgb(102, 197, 204)"
4376,2020-06-26,Belarus,5,437,60382,"rgb(102, 197, 204)"
4377,2020-06-27,Belarus,6,331,60713,"rgb(102, 197, 204)"
4378,2020-06-28,Belarus,4,382,61095,"rgb(102, 197, 204)"
4379,2020-06-29,Belarus,6,380,61475,"rgb(102, 197, 204)"
4380,2020-06-30,Belarus,4,315,61790,"rgb(102, 197, 204)"
4381,2020-07-01,Belarus,5,328,62118,"rgb(102, 197, 204)"
4382,2020-07-02,Belarus,6,306,62424,"rgb(102, 197, 204)"
4383,2020-07-03,Belarus,7,274,62698,"rgb(102, 197, 204)"
4384,2020-07-04,Belarus,7,299,62997,"rgb(102, 197, 204)"
4385,2020-07-05,Belarus,6,273,63270,"rgb(102, 197, 204)"
4386,2020-07-06,Belarus,5,284,63554,"rgb(102, 197, 204)"
4387,2020-07-07,Belarus,6,250,63804,"rgb(102, 197, 204)"
4388,2020-07-08,Belarus,7,199,64003,"rgb(102, 197, 204)"
4389,2020-07-09,Belarus,7,221,64224,"rgb(102, 197, 204)"
4390,2020-07-10,Belarus,6,187,64411,"rgb(102, 197, 204)"
4391,2020-07-11,Belarus,5,193,64604,"rgb(102, 197, 204)"
4392,2020-07-12,Belarus,5,163,64767,"rgb(102, 197, 204)"
4393,2020-07-13,Belarus,5,165,64932,"rgb(102, 197, 204)"
4394,2020-03-24,Belize,0,1,1,"rgb(246, 207, 113)"
4395,2020-03-25,Belize,0,0,1,"rgb(246, 207, 113)"
4396,2020-03-26,Belize,0,1,2,"rgb(246, 207, 113)"
4397,2020-03-27,Belize,0,0,2,"rgb(246, 207, 113)"
4398,2020-03-28,Belize,0,0,2,"rgb(246, 207, 113)"
4399,2020-03-29,Belize,0,0,2,"rgb(246, 207, 113)"
4400,2020-03-30,Belize,0,0,2,"rgb(246, 207, 113)"
4401,2020-03-31,Belize,0,1,3,"rgb(246, 207, 113)"
4402,2020-04-01,Belize,0,0,3,"rgb(246, 207, 113)"
4403,2020-04-02,Belize,0,0,3,"rgb(246, 207, 113)"
4404,2020-04-03,Belize,0,0,3,"rgb(246, 207, 113)"
4405,2020-04-04,Belize,0,1,4,"rgb(246, 207, 113)"
4406,2020-04-05,Belize,0,0,4,"rgb(246, 207, 113)"
4407,2020-04-06,Belize,1,1,5,"rgb(246, 207, 113)"
4408,2020-04-07,Belize,0,2,7,"rgb(246, 207, 113)"
4409,2020-04-08,Belize,0,0,7,"rgb(246, 207, 113)"
4410,2020-04-09,Belize,0,1,8,"rgb(246, 207, 113)"
4411,2020-04-10,Belize,0,1,9,"rgb(246, 207, 113)"
4412,2020-04-11,Belize,1,1,10,"rgb(246, 207, 113)"
4413,2020-04-12,Belize,0,3,13,"rgb(246, 207, 113)"
4414,2020-04-13,Belize,0,1,14,"rgb(246, 207, 113)"
4415,2020-04-14,Belize,0,4,18,"rgb(246, 207, 113)"
4416,2020-04-15,Belize,0,0,18,"rgb(246, 207, 113)"
4417,2020-04-16,Belize,0,0,18,"rgb(246, 207, 113)"
4418,2020-04-17,Belize,0,0,18,"rgb(246, 207, 113)"
4419,2020-04-18,Belize,0,0,18,"rgb(246, 207, 113)"
4420,2020-04-19,Belize,0,0,18,"rgb(246, 207, 113)"
4421,2020-04-20,Belize,0,0,18,"rgb(246, 207, 113)"
4422,2020-04-21,Belize,0,0,18,"rgb(246, 207, 113)"
4423,2020-04-22,Belize,0,0,18,"rgb(246, 207, 113)"
4424,2020-04-23,Belize,0,0,18,"rgb(246, 207, 113)"
4425,2020-04-24,Belize,0,0,18,"rgb(246, 207, 113)"
4426,2020-04-25,Belize,0,0,18,"rgb(246, 207, 113)"
4427,2020-04-26,Belize,0,0,18,"rgb(246, 207, 113)"
4428,2020-04-27,Belize,0,0,18,"rgb(246, 207, 113)"
4429,2020-04-28,Belize,0,0,18,"rgb(246, 207, 113)"
4430,2020-04-29,Belize,0,0,18,"rgb(246, 207, 113)"
4431,2020-04-30,Belize,0,0,18,"rgb(246, 207, 113)"
4432,2020-05-01,Belize,0,0,18,"rgb(246, 207, 113)"
4433,2020-05-02,Belize,0,0,18,"rgb(246, 207, 113)"
4434,2020-05-03,Belize,0,0,18,"rgb(246, 207, 113)"
4435,2020-05-04,Belize,0,0,18,"rgb(246, 207, 113)"
4436,2020-05-05,Belize,0,0,18,"rgb(246, 207, 113)"
4437,2020-05-06,Belize,0,0,18,"rgb(246, 207, 113)"
4438,2020-05-07,Belize,0,0,18,"rgb(246, 207, 113)"
4439,2020-05-08,Belize,0,0,18,"rgb(246, 207, 113)"
4440,2020-05-09,Belize,0,0,18,"rgb(246, 207, 113)"
4441,2020-05-10,Belize,0,0,18,"rgb(246, 207, 113)"
4442,2020-05-11,Belize,0,0,18,"rgb(246, 207, 113)"
4443,2020-05-12,Belize,0,0,18,"rgb(246, 207, 113)"
4444,2020-05-13,Belize,0,0,18,"rgb(246, 207, 113)"
4445,2020-05-14,Belize,0,0,18,"rgb(246, 207, 113)"
4446,2020-05-15,Belize,0,0,18,"rgb(246, 207, 113)"
4447,2020-05-16,Belize,0,0,18,"rgb(246, 207, 113)"
4448,2020-05-17,Belize,0,0,18,"rgb(246, 207, 113)"
4449,2020-05-18,Belize,0,0,18,"rgb(246, 207, 113)"
4450,2020-05-19,Belize,0,0,18,"rgb(246, 207, 113)"
4451,2020-05-20,Belize,0,0,18,"rgb(246, 207, 113)"
4452,2020-05-21,Belize,0,0,18,"rgb(246, 207, 113)"
4453,2020-05-22,Belize,0,0,18,"rgb(246, 207, 113)"
4454,2020-05-23,Belize,0,0,18,"rgb(246, 207, 113)"
4455,2020-05-24,Belize,0,0,18,"rgb(246, 207, 113)"
4456,2020-05-25,Belize,0,0,18,"rgb(246, 207, 113)"
4457,2020-05-26,Belize,0,0,18,"rgb(246, 207, 113)"
4458,2020-05-27,Belize,0,0,18,"rgb(246, 207, 113)"
4459,2020-05-28,Belize,0,0,18,"rgb(246, 207, 113)"
4460,2020-05-29,Belize,0,0,18,"rgb(246, 207, 113)"
4461,2020-05-30,Belize,0,0,18,"rgb(246, 207, 113)"
4462,2020-05-31,Belize,0,0,18,"rgb(246, 207, 113)"
4463,2020-06-01,Belize,0,0,18,"rgb(246, 207, 113)"
4464,2020-06-02,Belize,0,0,18,"rgb(246, 207, 113)"
4465,2020-06-03,Belize,0,0,18,"rgb(246, 207, 113)"
4466,2020-06-04,Belize,0,0,18,"rgb(246, 207, 113)"
4467,2020-06-05,Belize,0,0,18,"rgb(246, 207, 113)"
4468,2020-06-06,Belize,0,0,18,"rgb(246, 207, 113)"
4469,2020-06-07,Belize,0,0,18,"rgb(246, 207, 113)"
4470,2020-06-08,Belize,0,0,18,"rgb(246, 207, 113)"
4471,2020-06-09,Belize,0,1,19,"rgb(246, 207, 113)"
4472,2020-06-10,Belize,0,1,20,"rgb(246, 207, 113)"
4473,2020-06-11,Belize,0,0,20,"rgb(246, 207, 113)"
4474,2020-06-12,Belize,0,0,20,"rgb(246, 207, 113)"
4475,2020-06-13,Belize,0,0,20,"rgb(246, 207, 113)"
4476,2020-06-14,Belize,0,0,20,"rgb(246, 207, 113)"
4477,2020-06-15,Belize,0,1,21,"rgb(246, 207, 113)"
4478,2020-06-16,Belize,0,0,21,"rgb(246, 207, 113)"
4479,2020-06-17,Belize,0,0,21,"rgb(246, 207, 113)"
4480,2020-06-18,Belize,0,1,22,"rgb(246, 207, 113)"
4481,2020-06-19,Belize,0,0,22,"rgb(246, 207, 113)"
4482,2020-06-20,Belize,0,0,22,"rgb(246, 207, 113)"
4483,2020-06-21,Belize,0,0,22,"rgb(246, 207, 113)"
4484,2020-06-22,Belize,0,0,22,"rgb(246, 207, 113)"
4485,2020-06-23,Belize,0,1,23,"rgb(246, 207, 113)"
4486,2020-06-24,Belize,0,0,23,"rgb(246, 207, 113)"
4487,2020-06-25,Belize,0,0,23,"rgb(246, 207, 113)"
4488,2020-06-26,Belize,0,0,23,"rgb(246, 207, 113)"
4489,2020-06-27,Belize,0,1,24,"rgb(246, 207, 113)"
4490,2020-06-28,Belize,0,0,24,"rgb(246, 207, 113)"
4491,2020-06-29,Belize,0,0,24,"rgb(246, 207, 113)"
4492,2020-06-30,Belize,0,0,24,"rgb(246, 207, 113)"
4493,2020-07-01,Belize,0,4,28,"rgb(246, 207, 113)"
4494,2020-07-02,Belize,0,0,28,"rgb(246, 207, 113)"
4495,2020-07-03,Belize,0,0,28,"rgb(246, 207, 113)"
4496,2020-07-04,Belize,0,2,30,"rgb(246, 207, 113)"
4497,2020-07-05,Belize,0,0,30,"rgb(246, 207, 113)"
4498,2020-07-06,Belize,0,0,30,"rgb(246, 207, 113)"
4499,2020-07-07,Belize,0,0,30,"rgb(246, 207, 113)"
4500,2020-07-08,Belize,0,0,30,"rgb(246, 207, 113)"
4501,2020-07-09,Belize,0,0,30,"rgb(246, 207, 113)"
4502,2020-07-10,Belize,0,3,33,"rgb(246, 207, 113)"
4503,2020-07-11,Belize,0,4,37,"rgb(246, 207, 113)"
4504,2020-07-12,Belize,0,0,37,"rgb(246, 207, 113)"
4505,2020-07-13,Belize,0,0,37,"rgb(246, 207, 113)"
4506,2019-12-31,Canada,0,0,0,"rgb(248, 156, 116)"
4507,2020-01-01,Canada,0,0,0,"rgb(248, 156, 116)"
4508,2020-01-02,Canada,0,0,0,"rgb(248, 156, 116)"
4509,2020-01-03,Canada,0,0,0,"rgb(248, 156, 116)"
4510,2020-01-04,Canada,0,0,0,"rgb(248, 156, 116)"
4511,2020-01-05,Canada,0,0,0,"rgb(248, 156, 116)"
4512,2020-01-06,Canada,0,0,0,"rgb(248, 156, 116)"
4513,2020-01-07,Canada,0,0,0,"rgb(248, 156, 116)"
4514,2020-01-08,Canada,0,0,0,"rgb(248, 156, 116)"
4515,2020-01-09,Canada,0,0,0,"rgb(248, 156, 116)"
4516,2020-01-10,Canada,0,0,0,"rgb(248, 156, 116)"
4517,2020-01-11,Canada,0,0,0,"rgb(248, 156, 116)"
4518,2020-01-12,Canada,0,0,0,"rgb(248, 156, 116)"
4519,2020-01-13,Canada,0,0,0,"rgb(248, 156, 116)"
4520,2020-01-14,Canada,0,0,0,"rgb(248, 156, 116)"
4521,2020-01-15,Canada,0,0,0,"rgb(248, 156, 116)"
4522,2020-01-16,Canada,0,0,0,"rgb(248, 156, 116)"
4523,2020-01-17,Canada,0,0,0,"rgb(248, 156, 116)"
4524,2020-01-18,Canada,0,0,0,"rgb(248, 156, 116)"
4525,2020-01-19,Canada,0,0,0,"rgb(248, 156, 116)"
4526,2020-01-20,Canada,0,0,0,"rgb(248, 156, 116)"
4527,2020-01-21,Canada,0,0,0,"rgb(248, 156, 116)"
4528,2020-01-22,Canada,0,0,0,"rgb(248, 156, 116)"
4529,2020-01-23,Canada,0,0,0,"rgb(248, 156, 116)"
4530,2020-01-24,Canada,0,0,0,"rgb(248, 156, 116)"
4531,2020-01-25,Canada,0,0,0,"rgb(248, 156, 116)"
4532,2020-01-26,Canada,0,1,1,"rgb(248, 156, 116)"
4533,2020-01-27,Canada,0,0,1,"rgb(248, 156, 116)"
4534,2020-01-28,Canada,0,1,2,"rgb(248, 156, 116)"
4535,2020-01-29,Canada,0,1,3,"rgb(248, 156, 116)"
4536,2020-01-30,Canada,0,0,3,"rgb(248, 156, 116)"
4537,2020-01-31,Canada,0,0,3,"rgb(248, 156, 116)"
4538,2020-02-01,Canada,0,1,4,"rgb(248, 156, 116)"
4539,2020-02-02,Canada,0,0,4,"rgb(248, 156, 116)"
4540,2020-02-03,Canada,0,0,4,"rgb(248, 156, 116)"
4541,2020-02-04,Canada,0,0,4,"rgb(248, 156, 116)"
4542,2020-02-05,Canada,0,1,5,"rgb(248, 156, 116)"
4543,2020-02-06,Canada,0,0,5,"rgb(248, 156, 116)"
4544,2020-02-07,Canada,0,2,7,"rgb(248, 156, 116)"
4545,2020-02-08,Canada,0,0,7,"rgb(248, 156, 116)"
4546,2020-02-09,Canada,0,0,7,"rgb(248, 156, 116)"
4547,2020-02-10,Canada,0,0,7,"rgb(248, 156, 116)"
4548,2020-02-11,Canada,0,0,7,"rgb(248, 156, 116)"
4549,2020-02-12,Canada,0,0,7,"rgb(248, 156, 116)"
4550,2020-02-13,Canada,0,0,7,"rgb(248, 156, 116)"
4551,2020-02-14,Canada,0,0,7,"rgb(248, 156, 116)"
4552,2020-02-15,Canada,0,1,8,"rgb(248, 156, 116)"
4553,2020-02-16,Canada,0,0,8,"rgb(248, 156, 116)"
4554,2020-02-17,Canada,0,0,8,"rgb(248, 156, 116)"
4555,2020-02-18,Canada,0,0,8,"rgb(248, 156, 116)"
4556,2020-02-19,Canada,0,0,8,"rgb(248, 156, 116)"
4557,2020-02-20,Canada,0,0,8,"rgb(248, 156, 116)"
4558,2020-02-21,Canada,0,1,9,"rgb(248, 156, 116)"
4559,2020-02-22,Canada,0,0,9,"rgb(248, 156, 116)"
4560,2020-02-23,Canada,0,0,9,"rgb(248, 156, 116)"
4561,2020-02-24,Canada,0,0,9,"rgb(248, 156, 116)"
4562,2020-02-25,Canada,0,2,11,"rgb(248, 156, 116)"
4563,2020-02-26,Canada,0,0,11,"rgb(248, 156, 116)"
4564,2020-02-27,Canada,0,1,12,"rgb(248, 156, 116)"
4565,2020-02-28,Canada,0,2,14,"rgb(248, 156, 116)"
4566,2020-02-29,Canada,0,2,16,"rgb(248, 156, 116)"
4567,2020-03-01,Canada,0,4,20,"rgb(248, 156, 116)"
4568,2020-03-02,Canada,0,4,24,"rgb(248, 156, 116)"
4569,2020-03-03,Canada,0,3,27,"rgb(248, 156, 116)"
4570,2020-03-04,Canada,0,3,30,"rgb(248, 156, 116)"
4571,2020-03-05,Canada,0,3,33,"rgb(248, 156, 116)"
4572,2020-03-06,Canada,0,12,45,"rgb(248, 156, 116)"
4573,2020-03-07,Canada,0,6,51,"rgb(248, 156, 116)"
4574,2020-03-08,Canada,0,6,57,"rgb(248, 156, 116)"
4575,2020-03-09,Canada,0,5,62,"rgb(248, 156, 116)"
4576,2020-03-10,Canada,1,15,77,"rgb(248, 156, 116)"
4577,2020-03-11,Canada,0,16,93,"rgb(248, 156, 116)"
4578,2020-03-12,Canada,0,10,103,"rgb(248, 156, 116)"
4579,2020-03-13,Canada,0,35,138,"rgb(248, 156, 116)"
4580,2020-03-14,Canada,0,38,176,"rgb(248, 156, 116)"
4581,2020-03-15,Canada,0,68,244,"rgb(248, 156, 116)"
4582,2020-03-16,Canada,0,60,304,"rgb(248, 156, 116)"
4583,2020-03-17,Canada,3,120,424,"rgb(248, 156, 116)"
4584,2020-03-18,Canada,4,145,569,"rgb(248, 156, 116)"
4585,2020-03-19,Canada,1,121,690,"rgb(248, 156, 116)"
4586,2020-03-20,Canada,1,156,846,"rgb(248, 156, 116)"
4587,2020-03-21,Canada,2,125,971,"rgb(248, 156, 116)"
4588,2020-03-22,Canada,6,331,1302,"rgb(248, 156, 116)"
4589,2020-03-23,Canada,2,128,1430,"rgb(248, 156, 116)"
4590,2020-03-24,Canada,4,216,1646,"rgb(248, 156, 116)"
4591,2020-03-25,Canada,3,313,1959,"rgb(248, 156, 116)"
4592,2020-03-26,Canada,8,1426,3385,"rgb(248, 156, 116)"
4593,2020-03-27,Canada,4,633,4018,"rgb(248, 156, 116)"
4594,2020-03-28,Canada,14,657,4675,"rgb(248, 156, 116)"
4595,2020-03-29,Canada,7,711,5386,"rgb(248, 156, 116)"
4596,2020-03-30,Canada,1,869,6255,"rgb(248, 156, 116)"
4597,2020-03-31,Canada,28,1169,7424,"rgb(248, 156, 116)"
4598,2020-04-01,Canada,7,1112,8536,"rgb(248, 156, 116)"
4599,2020-04-02,Canada,13,1059,9595,"rgb(248, 156, 116)"
4600,2020-04-03,Canada,29,1673,11268,"rgb(248, 156, 116)"
4601,2020-04-04,Canada,49,1251,12519,"rgb(248, 156, 116)"
4602,2020-04-05,Canada,44,1363,13882,"rgb(248, 156, 116)"
4603,2020-04-06,Canada,49,1614,15496,"rgb(248, 156, 116)"
4604,2020-04-07,Canada,43,1157,16653,"rgb(248, 156, 116)"
4605,2020-04-08,Canada,57,1230,17883,"rgb(248, 156, 116)"
4606,2020-04-09,Canada,55,1391,19274,"rgb(248, 156, 116)"
4607,2020-04-10,Canada,74,1474,20748,"rgb(248, 156, 116)"
4608,2020-04-11,Canada,60,1385,22133,"rgb(248, 156, 116)"
4609,2020-04-12,Canada,84,1168,23301,"rgb(248, 156, 116)"
4610,2020-04-13,Canada,64,1064,24365,"rgb(248, 156, 116)"
4611,2020-04-14,Canada,63,1298,25663,"rgb(248, 156, 116)"
4612,2020-04-15,Canada,123,1383,27046,"rgb(248, 156, 116)"
4613,2020-04-16,Canada,107,1318,28364,"rgb(248, 156, 116)"
4614,2020-04-17,Canada,183,1717,30081,"rgb(248, 156, 116)"
4615,2020-04-18,Canada,116,1791,31872,"rgb(248, 156, 116)"
4616,2020-04-19,Canada,158,1469,33341,"rgb(248, 156, 116)"
4617,2020-04-20,Canada,113,1436,34777,"rgb(248, 156, 116)"
4618,2020-04-21,Canada,110,2046,36823,"rgb(248, 156, 116)"
4619,2020-04-22,Canada,144,1590,38413,"rgb(248, 156, 116)"
4620,2020-04-23,Canada,140,1766,40179,"rgb(248, 156, 116)"
4621,2020-04-24,Canada,172,1920,42099,"rgb(248, 156, 116)"
4622,2020-04-25,Canada,156,1778,43877,"rgb(248, 156, 116)"
4623,2020-04-26,Canada,163,1464,45341,"rgb(248, 156, 116)"
4624,2020-04-27,Canada,95,1543,46884,"rgb(248, 156, 116)"
4625,2020-04-28,Canada,147,1605,48489,"rgb(248, 156, 116)"
4626,2020-04-29,Canada,152,1526,50015,"rgb(248, 156, 116)"
4627,2020-04-30,Canada,137,1572,51587,"rgb(248, 156, 116)"
4628,2020-05-01,Canada,188,1649,53236,"rgb(248, 156, 116)"
4629,2020-05-02,Canada,207,1825,55061,"rgb(248, 156, 116)"
4630,2020-05-03,Canada,175,1653,56714,"rgb(248, 156, 116)"
4631,2020-05-04,Canada,116,2760,59474,"rgb(248, 156, 116)"
4632,2020-05-05,Canada,172,1298,60772,"rgb(248, 156, 116)"
4633,2020-05-06,Canada,189,1274,62046,"rgb(248, 156, 116)"
4634,2020-05-07,Canada,189,1450,63496,"rgb(248, 156, 116)"
4635,2020-05-08,Canada,176,1426,64922,"rgb(248, 156, 116)"
4636,2020-05-09,Canada,161,1512,66434,"rgb(248, 156, 116)"
4637,2020-05-10,Canada,124,1268,67702,"rgb(248, 156, 116)"
4638,2020-05-11,Canada,178,1146,68848,"rgb(248, 156, 116)"
4639,2020-05-12,Canada,122,1133,69981,"rgb(248, 156, 116)"
4640,2020-05-13,Canada,176,1176,71157,"rgb(248, 156, 116)"
4641,2020-05-14,Canada,135,1121,72278,"rgb(248, 156, 116)"
4642,2020-05-15,Canada,168,1123,73401,"rgb(248, 156, 116)"
4643,2020-05-16,Canada,90,1201,74602,"rgb(248, 156, 116)"
4644,2020-05-17,Canada,117,1251,75853,"rgb(248, 156, 116)"
4645,2020-05-18,Canada,103,1138,76991,"rgb(248, 156, 116)"
4646,2020-05-19,Canada,60,1070,78061,"rgb(248, 156, 116)"
4647,2020-05-20,Canada,70,1040,79101,"rgb(248, 156, 116)"
4648,2020-05-21,Canada,118,990,80091,"rgb(248, 156, 116)"
4649,2020-05-22,Canada,122,1222,81313,"rgb(248, 156, 116)"
4650,2020-05-23,Canada,98,1156,82469,"rgb(248, 156, 116)"
4651,2020-05-24,Canada,105,1141,83610,"rgb(248, 156, 116)"
4652,2020-05-25,Canada,69,1078,84688,"rgb(248, 156, 116)"
4653,2020-05-26,Canada,121,1012,85700,"rgb(248, 156, 116)"
4654,2020-05-27,Canada,94,936,86636,"rgb(248, 156, 116)"
4655,2020-05-28,Canada,126,872,87508,"rgb(248, 156, 116)"
4656,2020-05-29,Canada,112,993,88501,"rgb(248, 156, 116)"
4657,2020-05-30,Canada,102,906,89407,"rgb(248, 156, 116)"
4658,2020-05-31,Canada,94,772,90179,"rgb(248, 156, 116)"
4659,2020-06-01,Canada,222,757,90936,"rgb(248, 156, 116)"
4660,2020-06-02,Canada,31,758,91694,"rgb(248, 156, 116)"
4661,2020-06-03,Canada,69,705,92399,"rgb(248, 156, 116)"
4662,2020-06-04,Canada,103,675,93074,"rgb(248, 156, 116)"
4663,2020-06-05,Canada,139,641,93715,"rgb(248, 156, 116)"
4664,2020-06-06,Canada,66,609,94324,"rgb(248, 156, 116)"
4665,2020-06-07,Canada,70,722,95046,"rgb(248, 156, 116)"
4666,2020-06-08,Canada,27,642,95688,"rgb(248, 156, 116)"
4667,2020-06-09,Canada,35,545,96233,"rgb(248, 156, 116)"
4668,2020-06-10,Canada,62,409,96642,"rgb(248, 156, 116)"
4669,2020-06-11,Canada,63,472,97114,"rgb(248, 156, 116)"
4670,2020-06-12,Canada,34,405,97519,"rgb(248, 156, 116)"
4671,2020-06-13,Canada,55,413,97932,"rgb(248, 156, 116)"
4672,2020-06-14,Canada,58,467,98399,"rgb(248, 156, 116)"
4673,2020-06-15,Canada,39,377,98776,"rgb(248, 156, 116)"
4674,2020-06-16,Canada,29,360,99136,"rgb(248, 156, 116)"
4675,2020-06-17,Canada,38,320,99456,"rgb(248, 156, 116)"
4676,2020-06-18,Canada,41,386,99842,"rgb(248, 156, 116)"
4677,2020-06-19,Canada,46,367,100209,"rgb(248, 156, 116)"
4678,2020-06-20,Canada,46,409,100618,"rgb(248, 156, 116)"
4679,2020-06-21,Canada,64,390,101008,"rgb(248, 156, 116)"
4680,2020-06-22,Canada,20,318,101326,"rgb(248, 156, 116)"
4681,2020-06-23,Canada,6,311,101637,"rgb(248, 156, 116)"
4682,2020-06-24,Canada,18,326,101963,"rgb(248, 156, 116)"
4683,2020-06-25,Canada,30,279,102242,"rgb(248, 156, 116)"
4684,2020-06-26,Canada,20,369,102611,"rgb(248, 156, 116)"
4685,2020-06-27,Canada,4,172,102783,"rgb(248, 156, 116)"
4686,2020-06-28,Canada,8,238,103021,"rgb(248, 156, 116)"
4687,2020-06-29,Canada,6,218,103239,"rgb(248, 156, 116)"
4688,2020-06-30,Canada,44,668,103907,"rgb(248, 156, 116)"
4689,2020-07-01,Canada,25,286,104193,"rgb(248, 156, 116)"
4690,2020-07-02,Canada,0,0,104193,"rgb(248, 156, 116)"
4691,2020-07-03,Canada,51,567,104760,"rgb(248, 156, 116)"
4692,2020-07-04,Canada,21,319,105079,"rgb(248, 156, 116)"
4693,2020-07-05,Canada,11,226,105305,"rgb(248, 156, 116)"
4694,2020-07-06,Canada,10,219,105524,"rgb(248, 156, 116)"
4695,2020-07-07,Canada,9,399,105923,"rgb(248, 156, 116)"
4696,2020-07-08,Canada,18,232,106155,"rgb(248, 156, 116)"
4697,2020-07-09,Canada,26,267,106422,"rgb(248, 156, 116)"
4698,2020-07-10,Canada,12,371,106793,"rgb(248, 156, 116)"
4699,2020-07-11,Canada,10,321,107114,"rgb(248, 156, 116)"
4700,2020-07-12,Canada,14,221,107335,"rgb(248, 156, 116)"
4701,2020-07-13,Canada,10,244,107579,"rgb(248, 156, 116)"
4702,2020-03-11,Democratic Republic of Congo,0,1,1,"rgb(220, 176, 242)"
4703,2020-03-14,Democratic Republic of Congo,0,1,2,"rgb(220, 176, 242)"
4704,2020-03-15,Democratic Republic of Congo,0,0,2,"rgb(220, 176, 242)"
4705,2020-03-16,Democratic Republic of Congo,0,0,2,"rgb(220, 176, 242)"
4706,2020-03-17,Democratic Republic of Congo,0,1,3,"rgb(220, 176, 242)"
4707,2020-03-18,Democratic Republic of Congo,0,0,3,"rgb(220, 176, 242)"
4708,2020-03-19,Democratic Republic of Congo,0,11,14,"rgb(220, 176, 242)"
4709,2020-03-20,Democratic Republic of Congo,0,0,14,"rgb(220, 176, 242)"
4710,2020-03-21,Democratic Republic of Congo,0,0,14,"rgb(220, 176, 242)"
4711,2020-03-22,Democratic Republic of Congo,1,9,23,"rgb(220, 176, 242)"
4712,2020-03-23,Democratic Republic of Congo,1,3,26,"rgb(220, 176, 242)"
4713,2020-03-24,Democratic Republic of Congo,0,0,26,"rgb(220, 176, 242)"
4714,2020-03-25,Democratic Republic of Congo,1,19,45,"rgb(220, 176, 242)"
4715,2020-03-26,Democratic Republic of Congo,0,0,45,"rgb(220, 176, 242)"
4716,2020-03-27,Democratic Republic of Congo,1,9,54,"rgb(220, 176, 242)"
4717,2020-03-28,Democratic Republic of Congo,0,4,58,"rgb(220, 176, 242)"
4718,2020-03-29,Democratic Republic of Congo,2,0,58,"rgb(220, 176, 242)"
4719,2020-03-30,Democratic Republic of Congo,2,23,81,"rgb(220, 176, 242)"
4720,2020-03-31,Democratic Republic of Congo,0,17,98,"rgb(220, 176, 242)"
4721,2020-04-01,Democratic Republic of Congo,0,0,98,"rgb(220, 176, 242)"
4722,2020-04-02,Democratic Republic of Congo,3,25,123,"rgb(220, 176, 242)"
4723,2020-04-03,Democratic Republic of Congo,0,0,123,"rgb(220, 176, 242)"
4724,2020-04-04,Democratic Republic of Congo,2,11,134,"rgb(220, 176, 242)"
4725,2020-04-05,Democratic Republic of Congo,5,20,154,"rgb(220, 176, 242)"
4726,2020-04-06,Democratic Republic of Congo,0,0,154,"rgb(220, 176, 242)"
4727,2020-04-07,Democratic Republic of Congo,0,7,161,"rgb(220, 176, 242)"
4728,2020-04-08,Democratic Republic of Congo,0,19,180,"rgb(220, 176, 242)"
4729,2020-04-09,Democratic Republic of Congo,2,3,183,"rgb(220, 176, 242)"
4730,2020-04-10,Democratic Republic of Congo,0,32,215,"rgb(220, 176, 242)"
4731,2020-04-11,Democratic Republic of Congo,0,8,223,"rgb(220, 176, 242)"
4732,2020-04-12,Democratic Republic of Congo,0,11,234,"rgb(220, 176, 242)"
4733,2020-04-13,Democratic Republic of Congo,0,0,234,"rgb(220, 176, 242)"
4734,2020-04-14,Democratic Republic of Congo,0,1,235,"rgb(220, 176, 242)"
4735,2020-04-15,Democratic Republic of Congo,1,19,254,"rgb(220, 176, 242)"
4736,2020-04-16,Democratic Republic of Congo,1,13,267,"rgb(220, 176, 242)"
4737,2020-04-17,Democratic Republic of Congo,1,20,287,"rgb(220, 176, 242)"
4738,2020-04-18,Democratic Republic of Congo,2,20,307,"rgb(220, 176, 242)"
4739,2020-04-19,Democratic Republic of Congo,0,20,327,"rgb(220, 176, 242)"
4740,2020-04-20,Democratic Republic of Congo,0,5,332,"rgb(220, 176, 242)"
4741,2020-04-21,Democratic Republic of Congo,0,18,350,"rgb(220, 176, 242)"
4742,2020-04-22,Democratic Republic of Congo,0,9,359,"rgb(220, 176, 242)"
4743,2020-04-23,Democratic Republic of Congo,0,18,377,"rgb(220, 176, 242)"
4744,2020-04-24,Democratic Republic of Congo,0,17,394,"rgb(220, 176, 242)"
4745,2020-04-25,Democratic Republic of Congo,3,22,416,"rgb(220, 176, 242)"
4746,2020-04-26,Democratic Republic of Congo,0,26,442,"rgb(220, 176, 242)"
4747,2020-04-27,Democratic Republic of Congo,0,17,459,"rgb(220, 176, 242)"
4748,2020-04-28,Democratic Republic of Congo,2,12,471,"rgb(220, 176, 242)"
4749,2020-04-29,Democratic Republic of Congo,0,20,491,"rgb(220, 176, 242)"
4750,2020-04-30,Democratic Republic of Congo,1,9,500,"rgb(220, 176, 242)"
4751,2020-05-01,Democratic Republic of Congo,0,72,572,"rgb(220, 176, 242)"
4752,2020-05-02,Democratic Republic of Congo,1,32,604,"rgb(220, 176, 242)"
4753,2020-05-03,Democratic Republic of Congo,1,70,674,"rgb(220, 176, 242)"
4754,2020-05-04,Democratic Republic of Congo,1,10,684,"rgb(220, 176, 242)"
4755,2020-05-05,Democratic Republic of Congo,0,0,684,"rgb(220, 176, 242)"
4756,2020-05-06,Democratic Republic of Congo,0,21,705,"rgb(220, 176, 242)"
4757,2020-05-07,Democratic Republic of Congo,2,158,863,"rgb(220, 176, 242)"
4758,2020-05-08,Democratic Republic of Congo,0,34,897,"rgb(220, 176, 242)"
4759,2020-05-09,Democratic Republic of Congo,3,40,937,"rgb(220, 176, 242)"
4760,2020-05-10,Democratic Republic of Congo,2,54,991,"rgb(220, 176, 242)"
4761,2020-05-11,Democratic Republic of Congo,0,33,1024,"rgb(220, 176, 242)"
4762,2020-05-12,Democratic Republic of Congo,3,78,1102,"rgb(220, 176, 242)"
4763,2020-05-13,Democratic Republic of Congo,6,67,1169,"rgb(220, 176, 242)"
4764,2020-05-14,Democratic Republic of Congo,0,73,1242,"rgb(220, 176, 242)"
4765,2020-05-15,Democratic Republic of Congo,0,56,1298,"rgb(220, 176, 242)"
4766,2020-05-16,Democratic Republic of Congo,10,71,1369,"rgb(220, 176, 242)"
4767,2020-05-17,Democratic Republic of Congo,0,85,1454,"rgb(220, 176, 242)"
4768,2020-05-18,Democratic Republic of Congo,0,0,1454,"rgb(220, 176, 242)"
4769,2020-05-19,Democratic Republic of Congo,1,175,1629,"rgb(220, 176, 242)"
4770,2020-05-20,Democratic Republic of Congo,0,102,1731,"rgb(220, 176, 242)"
4771,2020-05-21,Democratic Republic of Congo,0,104,1835,"rgb(220, 176, 242)"
4772,2020-05-22,Democratic Republic of Congo,2,110,1945,"rgb(220, 176, 242)"
4773,2020-05-23,Democratic Republic of Congo,0,80,2025,"rgb(220, 176, 242)"
4774,2020-05-24,Democratic Republic of Congo,0,116,2141,"rgb(220, 176, 242)"
4775,2020-05-25,Democratic Republic of Congo,4,156,2297,"rgb(220, 176, 242)"
4776,2020-05-26,Democratic Republic of Congo,0,0,2297,"rgb(220, 176, 242)"
4777,2020-05-27,Democratic Republic of Congo,0,248,2545,"rgb(220, 176, 242)"
4778,2020-05-28,Democratic Republic of Congo,1,114,2659,"rgb(220, 176, 242)"
4779,2020-05-29,Democratic Republic of Congo,1,173,2832,"rgb(220, 176, 242)"
4780,2020-05-30,Democratic Republic of Congo,0,1,2833,"rgb(220, 176, 242)"
4781,2020-05-31,Democratic Republic of Congo,0,133,2966,"rgb(220, 176, 242)"
4782,2020-06-01,Democratic Republic of Congo,2,83,3049,"rgb(220, 176, 242)"
4783,2020-06-02,Democratic Republic of Congo,1,145,3194,"rgb(220, 176, 242)"
4784,2020-06-03,Democratic Republic of Congo,0,131,3325,"rgb(220, 176, 242)"
4785,2020-06-04,Democratic Republic of Congo,3,169,3494,"rgb(220, 176, 242)"
4786,2020-06-05,Democratic Republic of Congo,3,149,3643,"rgb(220, 176, 242)"
4787,2020-06-06,Democratic Republic of Congo,3,121,3764,"rgb(220, 176, 242)"
4788,2020-06-07,Democratic Republic of Congo,0,114,3878,"rgb(220, 176, 242)"
4789,2020-06-08,Democratic Republic of Congo,4,138,4016,"rgb(220, 176, 242)"
4790,2020-06-09,Democratic Republic of Congo,2,89,4105,"rgb(220, 176, 242)"
4791,2020-06-10,Democratic Republic of Congo,2,153,4258,"rgb(220, 176, 242)"
4792,2020-06-11,Democratic Republic of Congo,6,131,4389,"rgb(220, 176, 242)"
4793,2020-06-12,Democratic Republic of Congo,2,125,4514,"rgb(220, 176, 242)"
4794,2020-06-13,Democratic Republic of Congo,3,122,4636,"rgb(220, 176, 242)"
4795,2020-06-14,Democratic Republic of Congo,5,87,4723,"rgb(220, 176, 242)"
4796,2020-06-15,Democratic Republic of Congo,1,54,4777,"rgb(220, 176, 242)"
4797,2020-06-16,Democratic Republic of Congo,6,60,4837,"rgb(220, 176, 242)"
4798,2020-06-17,Democratic Republic of Congo,0,137,4974,"rgb(220, 176, 242)"
4799,2020-06-18,Democratic Republic of Congo,3,125,5099,"rgb(220, 176, 242)"
4800,2020-06-19,Democratic Republic of Congo,2,183,5282,"rgb(220, 176, 242)"
4801,2020-06-20,Democratic Republic of Congo,4,194,5476,"rgb(220, 176, 242)"
4802,2020-06-21,Democratic Republic of Congo,3,195,5671,"rgb(220, 176, 242)"
4803,2020-06-22,Democratic Republic of Congo,6,155,5826,"rgb(220, 176, 242)"
4804,2020-06-23,Democratic Republic of Congo,5,99,5925,"rgb(220, 176, 242)"
4805,2020-06-24,Democratic Republic of Congo,0,102,6027,"rgb(220, 176, 242)"
4806,2020-06-25,Democratic Republic of Congo,0,0,6027,"rgb(220, 176, 242)"
4807,2020-06-26,Democratic Republic of Congo,7,384,6411,"rgb(220, 176, 242)"
4808,2020-06-27,Democratic Republic of Congo,7,141,6552,"rgb(220, 176, 242)"
4809,2020-06-28,Democratic Republic of Congo,0,0,6552,"rgb(220, 176, 242)"
4810,2020-06-29,Democratic Republic of Congo,8,274,6826,"rgb(220, 176, 242)"
4811,2020-06-30,Democratic Republic of Congo,10,113,6939,"rgb(220, 176, 242)"
4812,2020-07-01,Democratic Republic of Congo,2,99,7038,"rgb(220, 176, 242)"
4813,2020-07-02,Democratic Republic of Congo,5,83,7121,"rgb(220, 176, 242)"
4814,2020-07-03,Democratic Republic of Congo,1,67,7188,"rgb(220, 176, 242)"
4815,2020-07-04,Democratic Republic of Congo,0,0,7188,"rgb(220, 176, 242)"
4816,2020-07-05,Democratic Republic of Congo,6,190,7378,"rgb(220, 176, 242)"
4817,2020-07-06,Democratic Republic of Congo,0,32,7410,"rgb(220, 176, 242)"
4818,2020-07-07,Democratic Republic of Congo,1,22,7432,"rgb(220, 176, 242)"
4819,2020-07-08,Democratic Republic of Congo,0,228,7660,"rgb(220, 176, 242)"
4820,2020-07-09,Democratic Republic of Congo,2,77,7737,"rgb(220, 176, 242)"
4821,2020-07-10,Democratic Republic of Congo,4,108,7845,"rgb(220, 176, 242)"
4822,2020-07-11,Democratic Republic of Congo,0,59,7904,"rgb(220, 176, 242)"
4823,2020-07-12,Democratic Republic of Congo,0,66,7970,"rgb(220, 176, 242)"
4824,2020-07-13,Democratic Republic of Congo,0,62,8032,"rgb(220, 176, 242)"
4825,2020-03-16,Central African Republic,0,1,1,"rgb(135, 197, 95)"
4826,2020-03-17,Central African Republic,0,0,1,"rgb(135, 197, 95)"
4827,2020-03-18,Central African Republic,0,0,1,"rgb(135, 197, 95)"
4828,2020-03-19,Central African Republic,0,0,1,"rgb(135, 197, 95)"
4829,2020-03-20,Central African Republic,0,0,1,"rgb(135, 197, 95)"
4830,2020-03-21,Central African Republic,0,0,1,"rgb(135, 197, 95)"
4831,2020-03-22,Central African Republic,0,2,3,"rgb(135, 197, 95)"
4832,2020-03-23,Central African Republic,0,1,4,"rgb(135, 197, 95)"
4833,2020-03-24,Central African Republic,0,0,4,"rgb(135, 197, 95)"
4834,2020-03-25,Central African Republic,0,0,4,"rgb(135, 197, 95)"
4835,2020-03-26,Central African Republic,0,0,4,"rgb(135, 197, 95)"
4836,2020-03-27,Central African Republic,0,1,5,"rgb(135, 197, 95)"
4837,2020-03-28,Central African Republic,0,0,5,"rgb(135, 197, 95)"
4838,2020-03-29,Central African Republic,0,1,6,"rgb(135, 197, 95)"
4839,2020-03-30,Central African Republic,0,0,6,"rgb(135, 197, 95)"
4840,2020-03-31,Central African Republic,0,0,6,"rgb(135, 197, 95)"
4841,2020-04-01,Central African Republic,0,0,6,"rgb(135, 197, 95)"
4842,2020-04-02,Central African Republic,0,2,8,"rgb(135, 197, 95)"
4843,2020-04-03,Central African Republic,0,0,8,"rgb(135, 197, 95)"
4844,2020-04-04,Central African Republic,0,0,8,"rgb(135, 197, 95)"
4845,2020-04-05,Central African Republic,0,1,9,"rgb(135, 197, 95)"
4846,2020-04-06,Central African Republic,0,0,9,"rgb(135, 197, 95)"
4847,2020-04-07,Central African Republic,0,0,9,"rgb(135, 197, 95)"
4848,2020-04-08,Central African Republic,0,0,9,"rgb(135, 197, 95)"
4849,2020-04-09,Central African Republic,0,1,10,"rgb(135, 197, 95)"
4850,2020-04-10,Central African Republic,0,1,11,"rgb(135, 197, 95)"
4851,2020-04-11,Central African Republic,0,0,11,"rgb(135, 197, 95)"
4852,2020-04-12,Central African Republic,0,0,11,"rgb(135, 197, 95)"
4853,2020-04-13,Central African Republic,0,0,11,"rgb(135, 197, 95)"
4854,2020-04-14,Central African Republic,0,0,11,"rgb(135, 197, 95)"
4855,2020-04-15,Central African Republic,0,0,11,"rgb(135, 197, 95)"
4856,2020-04-16,Central African Republic,0,0,11,"rgb(135, 197, 95)"
4857,2020-04-17,Central African Republic,0,1,12,"rgb(135, 197, 95)"
4858,2020-04-18,Central African Republic,0,0,12,"rgb(135, 197, 95)"
4859,2020-04-19,Central African Republic,0,0,12,"rgb(135, 197, 95)"
4860,2020-04-20,Central African Republic,0,0,12,"rgb(135, 197, 95)"
4861,2020-04-21,Central African Republic,0,0,12,"rgb(135, 197, 95)"
4862,2020-04-22,Central African Republic,0,2,14,"rgb(135, 197, 95)"
4863,2020-04-23,Central African Republic,0,2,16,"rgb(135, 197, 95)"
4864,2020-04-24,Central African Republic,0,1,17,"rgb(135, 197, 95)"
4865,2020-04-25,Central African Republic,0,2,19,"rgb(135, 197, 95)"
4866,2020-04-26,Central African Republic,0,0,19,"rgb(135, 197, 95)"
4867,2020-04-27,Central African Republic,0,0,19,"rgb(135, 197, 95)"
4868,2020-04-28,Central African Republic,0,31,50,"rgb(135, 197, 95)"
4869,2020-04-29,Central African Republic,0,0,50,"rgb(135, 197, 95)"
4870,2020-04-30,Central African Republic,0,0,50,"rgb(135, 197, 95)"
4871,2020-05-01,Central African Republic,0,0,50,"rgb(135, 197, 95)"
4872,2020-05-02,Central African Republic,0,22,72,"rgb(135, 197, 95)"
4873,2020-05-03,Central African Republic,0,0,72,"rgb(135, 197, 95)"
4874,2020-05-04,Central African Republic,0,0,72,"rgb(135, 197, 95)"
4875,2020-05-05,Central African Republic,0,22,94,"rgb(135, 197, 95)"
4876,2020-05-06,Central African Republic,0,0,94,"rgb(135, 197, 95)"
4877,2020-05-07,Central African Republic,0,0,94,"rgb(135, 197, 95)"
4878,2020-05-08,Central African Republic,0,0,94,"rgb(135, 197, 95)"
4879,2020-05-09,Central African Republic,0,49,143,"rgb(135, 197, 95)"
4880,2020-05-10,Central African Republic,0,0,143,"rgb(135, 197, 95)"
4881,2020-05-11,Central African Republic,0,36,179,"rgb(135, 197, 95)"
4882,2020-05-12,Central African Republic,0,0,179,"rgb(135, 197, 95)"
4883,2020-05-13,Central African Republic,0,0,179,"rgb(135, 197, 95)"
4884,2020-05-14,Central African Republic,0,18,197,"rgb(135, 197, 95)"
4885,2020-05-15,Central African Republic,0,24,221,"rgb(135, 197, 95)"
4886,2020-05-16,Central African Republic,0,80,301,"rgb(135, 197, 95)"
4887,2020-05-17,Central African Republic,0,26,327,"rgb(135, 197, 95)"
4888,2020-05-18,Central African Republic,0,0,327,"rgb(135, 197, 95)"
4889,2020-05-19,Central African Republic,0,9,336,"rgb(135, 197, 95)"
4890,2020-05-20,Central African Republic,0,75,411,"rgb(135, 197, 95)"
4891,2020-05-21,Central African Republic,0,0,411,"rgb(135, 197, 95)"
4892,2020-05-22,Central African Republic,0,25,436,"rgb(135, 197, 95)"
4893,2020-05-23,Central African Republic,0,43,479,"rgb(135, 197, 95)"
4894,2020-05-24,Central African Republic,1,73,552,"rgb(135, 197, 95)"
4895,2020-05-25,Central African Republic,0,52,604,"rgb(135, 197, 95)"
4896,2020-05-26,Central African Republic,0,48,652,"rgb(135, 197, 95)"
4897,2020-05-27,Central African Republic,0,19,671,"rgb(135, 197, 95)"
4898,2020-05-28,Central African Republic,0,31,702,"rgb(135, 197, 95)"
4899,2020-05-29,Central African Republic,0,53,755,"rgb(135, 197, 95)"
4900,2020-05-30,Central African Republic,0,119,874,"rgb(135, 197, 95)"
4901,2020-05-31,Central African Republic,0,88,962,"rgb(135, 197, 95)"
4902,2020-06-01,Central African Republic,1,49,1011,"rgb(135, 197, 95)"
4903,2020-06-02,Central African Republic,2,58,1069,"rgb(135, 197, 95)"
4904,2020-06-03,Central African Republic,0,104,1173,"rgb(135, 197, 95)"
4905,2020-06-04,Central African Republic,0,16,1189,"rgb(135, 197, 95)"
4906,2020-06-05,Central African Republic,0,99,1288,"rgb(135, 197, 95)"
4907,2020-06-06,Central African Republic,0,163,1451,"rgb(135, 197, 95)"
4908,2020-06-07,Central African Republic,1,119,1570,"rgb(135, 197, 95)"
4909,2020-06-08,Central African Republic,0,64,1634,"rgb(135, 197, 95)"
4910,2020-06-09,Central African Republic,0,216,1850,"rgb(135, 197, 95)"
4911,2020-06-10,Central African Republic,0,38,1888,"rgb(135, 197, 95)"
4912,2020-06-11,Central African Republic,1,64,1952,"rgb(135, 197, 95)"
4913,2020-06-12,Central African Republic,1,92,2044,"rgb(135, 197, 95)"
4914,2020-06-13,Central African Republic,0,13,2057,"rgb(135, 197, 95)"
4915,2020-06-14,Central African Republic,0,0,2057,"rgb(135, 197, 95)"
4916,2020-06-15,Central African Republic,0,165,2222,"rgb(135, 197, 95)"
4917,2020-06-16,Central African Republic,3,67,2289,"rgb(135, 197, 95)"
4918,2020-06-17,Central African Republic,4,121,2410,"rgb(135, 197, 95)"
4919,2020-06-18,Central African Republic,4,154,2564,"rgb(135, 197, 95)"
4920,2020-06-19,Central African Republic,1,41,2605,"rgb(135, 197, 95)"
4921,2020-06-20,Central African Republic,0,0,2605,"rgb(135, 197, 95)"
4922,2020-06-21,Central African Republic,4,203,2808,"rgb(135, 197, 95)"
4923,2020-06-22,Central African Republic,0,0,2808,"rgb(135, 197, 95)"
4924,2020-06-23,Central African Republic,7,155,2963,"rgb(135, 197, 95)"
4925,2020-06-24,Central African Republic,7,88,3051,"rgb(135, 197, 95)"
4926,2020-06-25,Central African Republic,1,48,3099,"rgb(135, 197, 95)"
4927,2020-06-26,Central African Republic,2,145,3244,"rgb(135, 197, 95)"
4928,2020-06-27,Central African Republic,0,96,3340,"rgb(135, 197, 95)"
4929,2020-06-28,Central African Republic,5,89,3429,"rgb(135, 197, 95)"
4930,2020-06-29,Central African Republic,0,0,3429,"rgb(135, 197, 95)"
4931,2020-06-30,Central African Republic,2,184,3613,"rgb(135, 197, 95)"
4932,2020-07-01,Central African Republic,0,132,3745,"rgb(135, 197, 95)"
4933,2020-07-02,Central African Republic,0,0,3745,"rgb(135, 197, 95)"
4934,2020-07-03,Central African Republic,1,78,3823,"rgb(135, 197, 95)"
4935,2020-07-04,Central African Republic,0,95,3918,"rgb(135, 197, 95)"
4936,2020-07-05,Central African Republic,0,51,3969,"rgb(135, 197, 95)"
4937,2020-07-06,Central African Republic,0,0,3969,"rgb(135, 197, 95)"
4938,2020-07-07,Central African Republic,4,64,4033,"rgb(135, 197, 95)"
4939,2020-07-08,Central African Republic,0,38,4071,"rgb(135, 197, 95)"
4940,2020-07-09,Central African Republic,0,38,4109,"rgb(135, 197, 95)"
4941,2020-07-10,Central African Republic,0,91,4200,"rgb(135, 197, 95)"
4942,2020-07-11,Central African Republic,1,59,4259,"rgb(135, 197, 95)"
4943,2020-07-12,Central African Republic,0,29,4288,"rgb(135, 197, 95)"
4944,2020-07-13,Central African Republic,0,0,4288,"rgb(135, 197, 95)"
4945,2020-03-16,Congo,0,1,1,"rgb(158, 185, 243)"
4946,2020-03-17,Congo,0,0,1,"rgb(158, 185, 243)"
4947,2020-03-18,Congo,0,0,1,"rgb(158, 185, 243)"
4948,2020-03-19,Congo,0,2,3,"rgb(158, 185, 243)"
4949,2020-03-20,Congo,0,0,3,"rgb(158, 185, 243)"
4950,2020-03-21,Congo,0,0,3,"rgb(158, 185, 243)"
4951,2020-03-22,Congo,0,1,4,"rgb(158, 185, 243)"
4952,2020-03-23,Congo,0,0,4,"rgb(158, 185, 243)"
4953,2020-03-24,Congo,0,0,4,"rgb(158, 185, 243)"
4954,2020-03-25,Congo,0,0,4,"rgb(158, 185, 243)"
4955,2020-03-26,Congo,0,0,4,"rgb(158, 185, 243)"
4956,2020-03-27,Congo,0,0,4,"rgb(158, 185, 243)"
4957,2020-03-28,Congo,0,0,4,"rgb(158, 185, 243)"
4958,2020-03-29,Congo,0,15,19,"rgb(158, 185, 243)"
4959,2020-03-30,Congo,0,0,19,"rgb(158, 185, 243)"
4960,2020-03-31,Congo,0,0,19,"rgb(158, 185, 243)"
4961,2020-04-01,Congo,2,3,22,"rgb(158, 185, 243)"
4962,2020-04-02,Congo,0,0,22,"rgb(158, 185, 243)"
4963,2020-04-03,Congo,1,19,41,"rgb(158, 185, 243)"
4964,2020-04-04,Congo,0,0,41,"rgb(158, 185, 243)"
4965,2020-04-05,Congo,2,4,45,"rgb(158, 185, 243)"
4966,2020-04-06,Congo,0,0,45,"rgb(158, 185, 243)"
4967,2020-04-07,Congo,0,0,45,"rgb(158, 185, 243)"
4968,2020-04-08,Congo,0,0,45,"rgb(158, 185, 243)"
4969,2020-04-09,Congo,0,15,60,"rgb(158, 185, 243)"
4970,2020-04-10,Congo,0,0,60,"rgb(158, 185, 243)"
4971,2020-04-11,Congo,0,0,60,"rgb(158, 185, 243)"
4972,2020-04-12,Congo,0,0,60,"rgb(158, 185, 243)"
4973,2020-04-13,Congo,0,10,70,"rgb(158, 185, 243)"
4974,2020-04-14,Congo,0,0,70,"rgb(158, 185, 243)"
4975,2020-04-15,Congo,0,4,74,"rgb(158, 185, 243)"
4976,2020-04-16,Congo,0,43,117,"rgb(158, 185, 243)"
4977,2020-04-17,Congo,0,0,117,"rgb(158, 185, 243)"
4978,2020-04-18,Congo,1,26,143,"rgb(158, 185, 243)"
4979,2020-04-19,Congo,0,0,143,"rgb(158, 185, 243)"
4980,2020-04-20,Congo,0,17,160,"rgb(158, 185, 243)"
4981,2020-04-21,Congo,0,0,160,"rgb(158, 185, 243)"
4982,2020-04-22,Congo,0,5,165,"rgb(158, 185, 243)"
4983,2020-04-23,Congo,0,21,186,"rgb(158, 185, 243)"
4984,2020-04-24,Congo,0,0,186,"rgb(158, 185, 243)"
4985,2020-04-25,Congo,0,14,200,"rgb(158, 185, 243)"
4986,2020-04-26,Congo,2,0,200,"rgb(158, 185, 243)"
4987,2020-04-27,Congo,0,0,200,"rgb(158, 185, 243)"
4988,2020-04-28,Congo,0,7,207,"rgb(158, 185, 243)"
4989,2020-04-29,Congo,0,0,207,"rgb(158, 185, 243)"
4990,2020-04-30,Congo,1,13,220,"rgb(158, 185, 243)"
4991,2020-05-01,Congo,0,0,220,"rgb(158, 185, 243)"
4992,2020-05-02,Congo,1,9,229,"rgb(158, 185, 243)"
4993,2020-05-03,Congo,0,0,229,"rgb(158, 185, 243)"
4994,2020-05-04,Congo,0,0,229,"rgb(158, 185, 243)"
4995,2020-05-05,Congo,0,7,236,"rgb(158, 185, 243)"
4996,2020-05-06,Congo,0,0,236,"rgb(158, 185, 243)"
4997,2020-05-07,Congo,0,28,264,"rgb(158, 185, 243)"
4998,2020-05-08,Congo,0,10,274,"rgb(158, 185, 243)"
4999,2020-05-09,Congo,0,13,287,"rgb(158, 185, 243)"
5000,2020-05-10,Congo,0,0,287,"rgb(158, 185, 243)"
5001,2020-05-11,Congo,0,0,287,"rgb(158, 185, 243)"
5002,2020-05-12,Congo,1,46,333,"rgb(158, 185, 243)"
5003,2020-05-13,Congo,0,0,333,"rgb(158, 185, 243)"
5004,2020-05-14,Congo,0,8,341,"rgb(158, 185, 243)"
5005,2020-05-15,Congo,4,50,391,"rgb(158, 185, 243)"
5006,2020-05-16,Congo,0,0,391,"rgb(158, 185, 243)"
5007,2020-05-17,Congo,0,21,412,"rgb(158, 185, 243)"
5008,2020-05-18,Congo,0,0,412,"rgb(158, 185, 243)"
5009,2020-05-19,Congo,0,0,412,"rgb(158, 185, 243)"
5010,2020-05-20,Congo,0,8,420,"rgb(158, 185, 243)"
5011,2020-05-21,Congo,0,0,420,"rgb(158, 185, 243)"
5012,2020-05-22,Congo,1,49,469,"rgb(158, 185, 243)"
5013,2020-05-23,Congo,0,0,469,"rgb(158, 185, 243)"
5014,2020-05-24,Congo,0,18,487,"rgb(158, 185, 243)"
5015,2020-05-25,Congo,0,0,487,"rgb(158, 185, 243)"
5016,2020-05-26,Congo,1,44,531,"rgb(158, 185, 243)"
5017,2020-05-27,Congo,2,38,569,"rgb(158, 185, 243)"
5018,2020-05-28,Congo,0,2,571,"rgb(158, 185, 243)"
5019,2020-05-29,Congo,0,0,571,"rgb(158, 185, 243)"
5020,2020-05-30,Congo,0,16,587,"rgb(158, 185, 243)"
5021,2020-05-31,Congo,0,0,587,"rgb(158, 185, 243)"
5022,2020-06-01,Congo,1,24,611,"rgb(158, 185, 243)"
5023,2020-06-02,Congo,0,0,611,"rgb(158, 185, 243)"
5024,2020-06-03,Congo,0,0,611,"rgb(158, 185, 243)"
5025,2020-06-04,Congo,0,7,618,"rgb(158, 185, 243)"
5026,2020-06-05,Congo,0,17,635,"rgb(158, 185, 243)"
5027,2020-06-06,Congo,0,4,639,"rgb(158, 185, 243)"
5028,2020-06-07,Congo,2,44,683,"rgb(158, 185, 243)"
5029,2020-06-08,Congo,0,0,683,"rgb(158, 185, 243)"
5030,2020-06-09,Congo,0,0,683,"rgb(158, 185, 243)"
5031,2020-06-10,Congo,2,45,728,"rgb(158, 185, 243)"
5032,2020-06-11,Congo,1,17,745,"rgb(158, 185, 243)"
5033,2020-06-12,Congo,0,0,745,"rgb(158, 185, 243)"
5034,2020-06-13,Congo,0,0,745,"rgb(158, 185, 243)"
5035,2020-06-14,Congo,0,34,779,"rgb(158, 185, 243)"
5036,2020-06-15,Congo,0,0,779,"rgb(158, 185, 243)"
5037,2020-06-16,Congo,2,104,883,"rgb(158, 185, 243)"
5038,2020-06-17,Congo,0,0,883,"rgb(158, 185, 243)"
5039,2020-06-18,Congo,0,0,883,"rgb(158, 185, 243)"
5040,2020-06-19,Congo,0,0,883,"rgb(158, 185, 243)"
5041,2020-06-20,Congo,0,0,883,"rgb(158, 185, 243)"
5042,2020-06-21,Congo,1,130,1013,"rgb(158, 185, 243)"
5043,2020-06-22,Congo,0,0,1013,"rgb(158, 185, 243)"
5044,2020-06-23,Congo,9,74,1087,"rgb(158, 185, 243)"
5045,2020-06-24,Congo,0,0,1087,"rgb(158, 185, 243)"
5046,2020-06-25,Congo,0,0,1087,"rgb(158, 185, 243)"
5047,2020-06-26,Congo,1,117,1204,"rgb(158, 185, 243)"
5048,2020-06-27,Congo,0,0,1204,"rgb(158, 185, 243)"
5049,2020-06-28,Congo,2,41,1245,"rgb(158, 185, 243)"
5050,2020-06-29,Congo,0,0,1245,"rgb(158, 185, 243)"
5051,2020-06-30,Congo,0,0,1245,"rgb(158, 185, 243)"
5052,2020-07-01,Congo,0,0,1245,"rgb(158, 185, 243)"
5053,2020-07-02,Congo,1,137,1382,"rgb(158, 185, 243)"
5054,2020-07-03,Congo,0,0,1382,"rgb(158, 185, 243)"
5055,2020-07-04,Congo,3,175,1557,"rgb(158, 185, 243)"
5056,2020-07-05,Congo,0,0,1557,"rgb(158, 185, 243)"
5057,2020-07-06,Congo,0,0,1557,"rgb(158, 185, 243)"
5058,2020-07-07,Congo,0,0,1557,"rgb(158, 185, 243)"
5059,2020-07-08,Congo,0,0,1557,"rgb(158, 185, 243)"
5060,2020-07-09,Congo,3,264,1821,"rgb(158, 185, 243)"
5061,2020-07-10,Congo,0,0,1821,"rgb(158, 185, 243)"
5062,2020-07-11,Congo,0,207,2028,"rgb(158, 185, 243)"
5063,2020-07-12,Congo,0,0,2028,"rgb(158, 185, 243)"
5064,2020-07-13,Congo,0,75,2103,"rgb(158, 185, 243)"
5065,2019-12-31,Switzerland,0,0,0,"rgb(254, 136, 177)"
5066,2020-01-01,Switzerland,0,0,0,"rgb(254, 136, 177)"
5067,2020-01-02,Switzerland,0,0,0,"rgb(254, 136, 177)"
5068,2020-01-03,Switzerland,0,0,0,"rgb(254, 136, 177)"
5069,2020-01-04,Switzerland,0,0,0,"rgb(254, 136, 177)"
5070,2020-01-05,Switzerland,0,0,0,"rgb(254, 136, 177)"
5071,2020-01-06,Switzerland,0,0,0,"rgb(254, 136, 177)"
5072,2020-01-07,Switzerland,0,0,0,"rgb(254, 136, 177)"
5073,2020-01-08,Switzerland,0,0,0,"rgb(254, 136, 177)"
5074,2020-01-09,Switzerland,0,0,0,"rgb(254, 136, 177)"
5075,2020-01-10,Switzerland,0,0,0,"rgb(254, 136, 177)"
5076,2020-01-11,Switzerland,0,0,0,"rgb(254, 136, 177)"
5077,2020-01-12,Switzerland,0,0,0,"rgb(254, 136, 177)"
5078,2020-01-13,Switzerland,0,0,0,"rgb(254, 136, 177)"
5079,2020-01-14,Switzerland,0,0,0,"rgb(254, 136, 177)"
5080,2020-01-15,Switzerland,0,0,0,"rgb(254, 136, 177)"
5081,2020-01-16,Switzerland,0,0,0,"rgb(254, 136, 177)"
5082,2020-01-17,Switzerland,0,0,0,"rgb(254, 136, 177)"
5083,2020-01-18,Switzerland,0,0,0,"rgb(254, 136, 177)"
5084,2020-01-19,Switzerland,0,0,0,"rgb(254, 136, 177)"
5085,2020-01-20,Switzerland,0,0,0,"rgb(254, 136, 177)"
5086,2020-01-21,Switzerland,0,0,0,"rgb(254, 136, 177)"
5087,2020-01-22,Switzerland,0,0,0,"rgb(254, 136, 177)"
5088,2020-01-23,Switzerland,0,0,0,"rgb(254, 136, 177)"
5089,2020-01-24,Switzerland,0,0,0,"rgb(254, 136, 177)"
5090,2020-01-25,Switzerland,0,0,0,"rgb(254, 136, 177)"
5091,2020-01-26,Switzerland,0,0,0,"rgb(254, 136, 177)"
5092,2020-01-27,Switzerland,0,0,0,"rgb(254, 136, 177)"
5093,2020-01-28,Switzerland,0,0,0,"rgb(254, 136, 177)"
5094,2020-01-29,Switzerland,0,0,0,"rgb(254, 136, 177)"
5095,2020-01-30,Switzerland,0,0,0,"rgb(254, 136, 177)"
5096,2020-01-31,Switzerland,0,0,0,"rgb(254, 136, 177)"
5097,2020-02-01,Switzerland,0,0,0,"rgb(254, 136, 177)"
5098,2020-02-02,Switzerland,0,0,0,"rgb(254, 136, 177)"
5099,2020-02-03,Switzerland,0,0,0,"rgb(254, 136, 177)"
5100,2020-02-04,Switzerland,0,0,0,"rgb(254, 136, 177)"
5101,2020-02-05,Switzerland,0,0,0,"rgb(254, 136, 177)"
5102,2020-02-06,Switzerland,0,0,0,"rgb(254, 136, 177)"
5103,2020-02-07,Switzerland,0,0,0,"rgb(254, 136, 177)"
5104,2020-02-08,Switzerland,0,0,0,"rgb(254, 136, 177)"
5105,2020-02-09,Switzerland,0,0,0,"rgb(254, 136, 177)"
5106,2020-02-10,Switzerland,0,0,0,"rgb(254, 136, 177)"
5107,2020-02-11,Switzerland,0,0,0,"rgb(254, 136, 177)"
5108,2020-02-12,Switzerland,0,0,0,"rgb(254, 136, 177)"
5109,2020-02-13,Switzerland,0,0,0,"rgb(254, 136, 177)"
5110,2020-02-14,Switzerland,0,0,0,"rgb(254, 136, 177)"
5111,2020-02-15,Switzerland,0,0,0,"rgb(254, 136, 177)"
5112,2020-02-16,Switzerland,0,0,0,"rgb(254, 136, 177)"
5113,2020-02-17,Switzerland,0,0,0,"rgb(254, 136, 177)"
5114,2020-02-18,Switzerland,0,0,0,"rgb(254, 136, 177)"
5115,2020-02-19,Switzerland,0,0,0,"rgb(254, 136, 177)"
5116,2020-02-20,Switzerland,0,0,0,"rgb(254, 136, 177)"
5117,2020-02-21,Switzerland,0,0,0,"rgb(254, 136, 177)"
5118,2020-02-22,Switzerland,0,0,0,"rgb(254, 136, 177)"
5119,2020-02-23,Switzerland,0,0,0,"rgb(254, 136, 177)"
5120,2020-02-24,Switzerland,0,0,0,"rgb(254, 136, 177)"
5121,2020-02-25,Switzerland,0,0,0,"rgb(254, 136, 177)"
5122,2020-02-26,Switzerland,0,1,1,"rgb(254, 136, 177)"
5123,2020-02-27,Switzerland,0,0,1,"rgb(254, 136, 177)"
5124,2020-02-28,Switzerland,0,7,8,"rgb(254, 136, 177)"
5125,2020-02-29,Switzerland,0,4,12,"rgb(254, 136, 177)"
5126,2020-03-01,Switzerland,0,6,18,"rgb(254, 136, 177)"
5127,2020-03-02,Switzerland,0,6,24,"rgb(254, 136, 177)"
5128,2020-03-03,Switzerland,0,6,30,"rgb(254, 136, 177)"
5129,2020-03-04,Switzerland,0,7,37,"rgb(254, 136, 177)"
5130,2020-03-05,Switzerland,0,20,57,"rgb(254, 136, 177)"
5131,2020-03-06,Switzerland,1,30,87,"rgb(254, 136, 177)"
5132,2020-03-07,Switzerland,0,122,209,"rgb(254, 136, 177)"
5133,2020-03-08,Switzerland,0,55,264,"rgb(254, 136, 177)"
5134,2020-03-09,Switzerland,1,68,332,"rgb(254, 136, 177)"
5135,2020-03-10,Switzerland,0,42,374,"rgb(254, 136, 177)"
5136,2020-03-11,Switzerland,1,116,490,"rgb(254, 136, 177)"
5137,2020-03-12,Switzerland,1,152,642,"rgb(254, 136, 177)"
5138,2020-03-13,Switzerland,0,212,854,"rgb(254, 136, 177)"
5139,2020-03-14,Switzerland,3,267,1121,"rgb(254, 136, 177)"
5140,2020-03-15,Switzerland,4,238,1359,"rgb(254, 136, 177)"
5141,2020-03-16,Switzerland,2,841,2200,"rgb(254, 136, 177)"
5142,2020-03-17,Switzerland,1,0,2200,"rgb(254, 136, 177)"
5143,2020-03-18,Switzerland,5,450,2650,"rgb(254, 136, 177)"
5144,2020-03-19,Switzerland,2,360,3010,"rgb(254, 136, 177)"
5145,2020-03-20,Switzerland,12,878,3888,"rgb(254, 136, 177)"
5146,2020-03-21,Switzerland,10,952,4840,"rgb(254, 136, 177)"
5147,2020-03-22,Switzerland,13,1237,6077,"rgb(254, 136, 177)"
5148,2020-03-23,Switzerland,4,894,6971,"rgb(254, 136, 177)"
5149,2020-03-24,Switzerland,6,1044,8015,"rgb(254, 136, 177)"
5150,2020-03-25,Switzerland,20,774,8789,"rgb(254, 136, 177)"
5151,2020-03-26,Switzerland,17,925,9714,"rgb(254, 136, 177)"
5152,2020-03-27,Switzerland,58,1000,10714,"rgb(254, 136, 177)"
5153,2020-03-28,Switzerland,36,1390,12104,"rgb(254, 136, 177)"
5154,2020-03-29,Switzerland,38,1048,13152,"rgb(254, 136, 177)"
5155,2020-03-30,Switzerland,22,1122,14274,"rgb(254, 136, 177)"
5156,2020-03-31,Switzerland,38,1138,15412,"rgb(254, 136, 177)"
5157,2020-04-01,Switzerland,78,696,16108,"rgb(254, 136, 177)"
5158,2020-04-02,Switzerland,5,962,17070,"rgb(254, 136, 177)"
5159,2020-04-03,Switzerland,54,1124,18194,"rgb(254, 136, 177)"
5160,2020-04-04,Switzerland,52,1033,19227,"rgb(254, 136, 177)"
5161,2020-04-05,Switzerland,56,974,20201,"rgb(254, 136, 177)"
5162,2020-04-06,Switzerland,19,821,21022,"rgb(254, 136, 177)"
5163,2020-04-07,Switzerland,25,552,21574,"rgb(254, 136, 177)"
5164,2020-04-08,Switzerland,57,590,22164,"rgb(254, 136, 177)"
5165,2020-04-09,Switzerland,64,546,22710,"rgb(254, 136, 177)"
5166,2020-04-10,Switzerland,51,785,23495,"rgb(254, 136, 177)"
5167,2020-04-11,Switzerland,49,733,24228,"rgb(254, 136, 177)"
5168,2020-04-12,Switzerland,26,592,24820,"rgb(254, 136, 177)"
5169,2020-04-13,Switzerland,27,400,25220,"rgb(254, 136, 177)"
5170,2020-04-14,Switzerland,0,279,25499,"rgb(254, 136, 177)"
5171,2020-04-15,Switzerland,42,254,25753,"rgb(254, 136, 177)"
5172,2020-04-16,Switzerland,73,583,26336,"rgb(254, 136, 177)"
5173,2020-04-17,Switzerland,43,315,26651,"rgb(254, 136, 177)"
5174,2020-04-18,Switzerland,42,346,26997,"rgb(254, 136, 177)"
5175,2020-04-19,Switzerland,52,325,27322,"rgb(254, 136, 177)"
5176,2020-04-20,Switzerland,24,336,27658,"rgb(254, 136, 177)"
5177,2020-04-21,Switzerland,7,168,27826,"rgb(254, 136, 177)"
5178,2020-04-22,Switzerland,45,155,27981,"rgb(254, 136, 177)"
5179,2020-04-23,Switzerland,30,205,28186,"rgb(254, 136, 177)"
5180,2020-04-24,Switzerland,51,228,28414,"rgb(254, 136, 177)"
5181,2020-04-25,Switzerland,41,181,28595,"rgb(254, 136, 177)"
5182,2020-04-26,Switzerland,20,216,28811,"rgb(254, 136, 177)"
5183,2020-04-27,Switzerland,8,167,28978,"rgb(254, 136, 177)"
5184,2020-04-28,Switzerland,16,103,29081,"rgb(254, 136, 177)"
5185,2020-04-29,Switzerland,27,100,29181,"rgb(254, 136, 177)"
5186,2020-04-30,Switzerland,28,143,29324,"rgb(254, 136, 177)"
5187,2020-05-01,Switzerland,15,179,29503,"rgb(254, 136, 177)"
5188,2020-05-02,Switzerland,12,119,29622,"rgb(254, 136, 177)"
5189,2020-05-03,Switzerland,32,112,29734,"rgb(254, 136, 177)"
5190,2020-05-04,Switzerland,6,88,29822,"rgb(254, 136, 177)"
5191,2020-05-05,Switzerland,4,76,29898,"rgb(254, 136, 177)"
5192,2020-05-06,Switzerland,6,28,29926,"rgb(254, 136, 177)"
5193,2020-05-07,Switzerland,22,51,29977,"rgb(254, 136, 177)"
5194,2020-05-08,Switzerland,13,66,30043,"rgb(254, 136, 177)"
5195,2020-05-09,Switzerland,8,81,30124,"rgb(254, 136, 177)"
5196,2020-05-10,Switzerland,6,44,30168,"rgb(254, 136, 177)"
5197,2020-05-11,Switzerland,6,54,30222,"rgb(254, 136, 177)"
5198,2020-05-12,Switzerland,5,39,30261,"rgb(254, 136, 177)"
5199,2020-05-13,Switzerland,18,36,30297,"rgb(254, 136, 177)"
5200,2020-05-14,Switzerland,3,33,30330,"rgb(254, 136, 177)"
5201,2020-05-15,Switzerland,25,50,30380,"rgb(254, 136, 177)"
5202,2020-05-16,Switzerland,6,51,30431,"rgb(254, 136, 177)"
5203,2020-05-17,Switzerland,7,58,30489,"rgb(254, 136, 177)"
5204,2020-05-18,Switzerland,1,15,30504,"rgb(254, 136, 177)"
5205,2020-05-19,Switzerland,0,10,30514,"rgb(254, 136, 177)"
5206,2020-05-20,Switzerland,11,21,30535,"rgb(254, 136, 177)"
5207,2020-05-21,Switzerland,16,40,30575,"rgb(254, 136, 177)"
5208,2020-05-22,Switzerland,8,36,30611,"rgb(254, 136, 177)"
5209,2020-05-23,Switzerland,0,13,30624,"rgb(254, 136, 177)"
5210,2020-05-24,Switzerland,4,18,30642,"rgb(254, 136, 177)"
5211,2020-05-25,Switzerland,0,11,30653,"rgb(254, 136, 177)"
5212,2020-05-26,Switzerland,0,10,30663,"rgb(254, 136, 177)"
5213,2020-05-27,Switzerland,6,15,30678,"rgb(254, 136, 177)"
5214,2020-05-28,Switzerland,0,0,30678,"rgb(254, 136, 177)"
5215,2020-05-29,Switzerland,7,35,30713,"rgb(254, 136, 177)"
5216,2020-05-30,Switzerland,2,32,30745,"rgb(254, 136, 177)"
5217,2020-05-31,Switzerland,0,17,30762,"rgb(254, 136, 177)"
5218,2020-06-01,Switzerland,0,17,30779,"rgb(254, 136, 177)"
5219,2020-06-02,Switzerland,0,9,30788,"rgb(254, 136, 177)"
5220,2020-06-03,Switzerland,0,3,30791,"rgb(254, 136, 177)"
5221,2020-06-04,Switzerland,3,19,30810,"rgb(254, 136, 177)"
5222,2020-06-05,Switzerland,0,20,30830,"rgb(254, 136, 177)"
5223,2020-06-06,Switzerland,0,23,30853,"rgb(254, 136, 177)"
5224,2020-06-07,Switzerland,1,20,30873,"rgb(254, 136, 177)"
5225,2020-06-08,Switzerland,0,9,30882,"rgb(254, 136, 177)"
5226,2020-06-09,Switzerland,0,7,30889,"rgb(254, 136, 177)"
5227,2020-06-10,Switzerland,2,16,30905,"rgb(254, 136, 177)"
5228,2020-06-11,Switzerland,12,23,30928,"rgb(254, 136, 177)"
5229,2020-06-12,Switzerland,0,33,30961,"rgb(254, 136, 177)"
5230,2020-06-13,Switzerland,2,19,30980,"rgb(254, 136, 177)"
5231,2020-06-14,Switzerland,0,31,31011,"rgb(254, 136, 177)"
5232,2020-06-15,Switzerland,0,23,31034,"rgb(254, 136, 177)"
5233,2020-06-16,Switzerland,0,14,31048,"rgb(254, 136, 177)"
5234,2020-06-17,Switzerland,1,15,31063,"rgb(254, 136, 177)"
5235,2020-06-18,Switzerland,0,37,31100,"rgb(254, 136, 177)"
5236,2020-06-19,Switzerland,0,17,31117,"rgb(254, 136, 177)"
5237,2020-06-20,Switzerland,0,92,31209,"rgb(254, 136, 177)"
5238,2020-06-21,Switzerland,0,0,31209,"rgb(254, 136, 177)"
5239,2020-06-22,Switzerland,2,0,31209,"rgb(254, 136, 177)"
5240,2020-06-23,Switzerland,0,18,31227,"rgb(254, 136, 177)"
5241,2020-06-24,Switzerland,0,22,31249,"rgb(254, 136, 177)"
5242,2020-06-25,Switzerland,2,44,31293,"rgb(254, 136, 177)"
5243,2020-06-26,Switzerland,0,52,31345,"rgb(254, 136, 177)"
5244,2020-06-27,Switzerland,0,58,31403,"rgb(254, 136, 177)"
5245,2020-06-28,Switzerland,0,69,31472,"rgb(254, 136, 177)"
5246,2020-06-29,Switzerland,0,62,31534,"rgb(254, 136, 177)"
5247,2020-06-30,Switzerland,0,35,31569,"rgb(254, 136, 177)"
5248,2020-07-01,Switzerland,2,62,31631,"rgb(254, 136, 177)"
5249,2020-07-02,Switzerland,1,220,31851,"rgb(254, 136, 177)"
5250,2020-07-03,Switzerland,1,33,31884,"rgb(254, 136, 177)"
5251,2020-07-04,Switzerland,0,133,32017,"rgb(254, 136, 177)"
5252,2020-07-05,Switzerland,0,97,32114,"rgb(254, 136, 177)"
5253,2020-07-06,Switzerland,0,70,32184,"rgb(254, 136, 177)"
5254,2020-07-07,Switzerland,0,46,32230,"rgb(254, 136, 177)"
5255,2020-07-08,Switzerland,0,54,32284,"rgb(254, 136, 177)"
5256,2020-07-09,Switzerland,0,129,32413,"rgb(254, 136, 177)"
5257,2020-07-10,Switzerland,0,88,32501,"rgb(254, 136, 177)"
5258,2020-07-11,Switzerland,0,104,32605,"rgb(254, 136, 177)"
5259,2020-07-12,Switzerland,0,108,32713,"rgb(254, 136, 177)"
5260,2020-07-13,Switzerland,0,85,32798,"rgb(254, 136, 177)"
5261,2020-03-12,Côte d'Ivoire,0,1,1,"rgb(201, 219, 116)"
5262,2020-03-15,Côte d'Ivoire,0,3,4,"rgb(201, 219, 116)"
5263,2020-03-16,Côte d'Ivoire,0,0,4,"rgb(201, 219, 116)"
5264,2020-03-17,Côte d'Ivoire,0,1,5,"rgb(201, 219, 116)"
5265,2020-03-18,Côte d'Ivoire,0,0,5,"rgb(201, 219, 116)"
5266,2020-03-19,Côte d'Ivoire,0,1,6,"rgb(201, 219, 116)"
5267,2020-03-20,Côte d'Ivoire,0,3,9,"rgb(201, 219, 116)"
5268,2020-03-21,Côte d'Ivoire,0,5,14,"rgb(201, 219, 116)"
5269,2020-03-22,Côte d'Ivoire,0,3,17,"rgb(201, 219, 116)"
5270,2020-03-23,Côte d'Ivoire,0,8,25,"rgb(201, 219, 116)"
5271,2020-03-24,Côte d'Ivoire,0,0,25,"rgb(201, 219, 116)"
5272,2020-03-25,Côte d'Ivoire,0,48,73,"rgb(201, 219, 116)"
5273,2020-03-26,Côte d'Ivoire,0,7,80,"rgb(201, 219, 116)"
5274,2020-03-27,Côte d'Ivoire,0,16,96,"rgb(201, 219, 116)"
5275,2020-03-28,Côte d'Ivoire,0,5,101,"rgb(201, 219, 116)"
5276,2020-03-29,Côte d'Ivoire,0,39,140,"rgb(201, 219, 116)"
5277,2020-03-30,Côte d'Ivoire,1,25,165,"rgb(201, 219, 116)"
5278,2020-03-31,Côte d'Ivoire,0,3,168,"rgb(201, 219, 116)"
5279,2020-04-01,Côte d'Ivoire,0,0,168,"rgb(201, 219, 116)"
5280,2020-04-02,Côte d'Ivoire,0,22,190,"rgb(201, 219, 116)"
5281,2020-04-03,Côte d'Ivoire,0,4,194,"rgb(201, 219, 116)"
5282,2020-04-04,Côte d'Ivoire,0,24,218,"rgb(201, 219, 116)"
5283,2020-04-05,Côte d'Ivoire,1,27,245,"rgb(201, 219, 116)"
5284,2020-04-06,Côte d'Ivoire,1,16,261,"rgb(201, 219, 116)"
5285,2020-04-07,Côte d'Ivoire,0,62,323,"rgb(201, 219, 116)"
5286,2020-04-08,Côte d'Ivoire,0,26,349,"rgb(201, 219, 116)"
5287,2020-04-09,Côte d'Ivoire,0,35,384,"rgb(201, 219, 116)"
5288,2020-04-10,Côte d'Ivoire,0,60,444,"rgb(201, 219, 116)"
5289,2020-04-11,Côte d'Ivoire,0,36,480,"rgb(201, 219, 116)"
5290,2020-04-12,Côte d'Ivoire,1,53,533,"rgb(201, 219, 116)"
5291,2020-04-13,Côte d'Ivoire,1,41,574,"rgb(201, 219, 116)"
5292,2020-04-14,Côte d'Ivoire,1,52,626,"rgb(201, 219, 116)"
5293,2020-04-15,Côte d'Ivoire,0,0,626,"rgb(201, 219, 116)"
5294,2020-04-16,Côte d'Ivoire,0,28,654,"rgb(201, 219, 116)"
5295,2020-04-17,Côte d'Ivoire,0,34,688,"rgb(201, 219, 116)"
5296,2020-04-18,Côte d'Ivoire,0,54,742,"rgb(201, 219, 116)"
5297,2020-04-19,Côte d'Ivoire,2,59,801,"rgb(201, 219, 116)"
5298,2020-04-20,Côte d'Ivoire,1,46,847,"rgb(201, 219, 116)"
5299,2020-04-21,Côte d'Ivoire,1,32,879,"rgb(201, 219, 116)"
5300,2020-04-22,Côte d'Ivoire,3,37,916,"rgb(201, 219, 116)"
5301,2020-04-23,Côte d'Ivoire,1,36,952,"rgb(201, 219, 116)"
5302,2020-04-24,Côte d'Ivoire,0,52,1004,"rgb(201, 219, 116)"
5303,2020-04-25,Côte d'Ivoire,0,73,1077,"rgb(201, 219, 116)"
5304,2020-04-26,Côte d'Ivoire,0,34,1111,"rgb(201, 219, 116)"
5305,2020-04-27,Côte d'Ivoire,0,39,1150,"rgb(201, 219, 116)"
5306,2020-04-28,Côte d'Ivoire,0,14,1164,"rgb(201, 219, 116)"
5307,2020-04-29,Côte d'Ivoire,0,19,1183,"rgb(201, 219, 116)"
5308,2020-04-30,Côte d'Ivoire,0,55,1238,"rgb(201, 219, 116)"
5309,2020-05-01,Côte d'Ivoire,0,37,1275,"rgb(201, 219, 116)"
5310,2020-05-02,Côte d'Ivoire,1,58,1333,"rgb(201, 219, 116)"
5311,2020-05-03,Côte d'Ivoire,0,29,1362,"rgb(201, 219, 116)"
5312,2020-05-04,Côte d'Ivoire,2,36,1398,"rgb(201, 219, 116)"
5313,2020-05-05,Côte d'Ivoire,0,34,1432,"rgb(201, 219, 116)"
5314,2020-05-06,Côte d'Ivoire,1,32,1464,"rgb(201, 219, 116)"
5315,2020-05-07,Côte d'Ivoire,0,52,1516,"rgb(201, 219, 116)"
5316,2020-05-08,Côte d'Ivoire,2,55,1571,"rgb(201, 219, 116)"
5317,2020-05-09,Côte d'Ivoire,0,31,1602,"rgb(201, 219, 116)"
5318,2020-05-10,Côte d'Ivoire,1,65,1667,"rgb(201, 219, 116)"
5319,2020-05-11,Côte d'Ivoire,0,33,1700,"rgb(201, 219, 116)"
5320,2020-05-12,Côte d'Ivoire,0,30,1730,"rgb(201, 219, 116)"
5321,2020-05-13,Côte d'Ivoire,0,127,1857,"rgb(201, 219, 116)"
5322,2020-05-14,Côte d'Ivoire,3,55,1912,"rgb(201, 219, 116)"
5323,2020-05-15,Côte d'Ivoire,0,59,1971,"rgb(201, 219, 116)"
5324,2020-05-16,Côte d'Ivoire,0,46,2017,"rgb(201, 219, 116)"
5325,2020-05-17,Côte d'Ivoire,1,44,2061,"rgb(201, 219, 116)"
5326,2020-05-18,Côte d'Ivoire,2,48,2109,"rgb(201, 219, 116)"
5327,2020-05-19,Côte d'Ivoire,1,10,2119,"rgb(201, 219, 116)"
5328,2020-05-20,Côte d'Ivoire,0,34,2153,"rgb(201, 219, 116)"
5329,2020-05-21,Côte d'Ivoire,1,78,2231,"rgb(201, 219, 116)"
5330,2020-05-22,Côte d'Ivoire,0,0,2231,"rgb(201, 219, 116)"
5331,2020-05-23,Côte d'Ivoire,0,70,2301,"rgb(201, 219, 116)"
5332,2020-05-24,Côte d'Ivoire,1,65,2366,"rgb(201, 219, 116)"
5333,2020-05-25,Côte d'Ivoire,0,10,2376,"rgb(201, 219, 116)"
5334,2020-05-26,Côte d'Ivoire,0,47,2423,"rgb(201, 219, 116)"
5335,2020-05-27,Côte d'Ivoire,0,54,2477,"rgb(201, 219, 116)"
5336,2020-05-28,Côte d'Ivoire,1,79,2556,"rgb(201, 219, 116)"
5337,2020-05-29,Côte d'Ivoire,1,85,2641,"rgb(201, 219, 116)"
5338,2020-05-30,Côte d'Ivoire,0,109,2750,"rgb(201, 219, 116)"
5339,2020-05-31,Côte d'Ivoire,1,49,2799,"rgb(201, 219, 116)"
5340,2020-06-01,Côte d'Ivoire,0,34,2833,"rgb(201, 219, 116)"
5341,2020-06-02,Côte d'Ivoire,0,118,2951,"rgb(201, 219, 116)"
5342,2020-06-03,Côte d'Ivoire,0,73,3024,"rgb(201, 219, 116)"
5343,2020-06-04,Côte d'Ivoire,0,0,3024,"rgb(201, 219, 116)"
5344,2020-06-05,Côte d'Ivoire,2,238,3262,"rgb(201, 219, 116)"
5345,2020-06-06,Côte d'Ivoire,1,169,3431,"rgb(201, 219, 116)"
5346,2020-06-07,Côte d'Ivoire,0,126,3557,"rgb(201, 219, 116)"
5347,2020-06-08,Côte d'Ivoire,0,182,3739,"rgb(201, 219, 116)"
5348,2020-06-09,Côte d'Ivoire,2,142,3881,"rgb(201, 219, 116)"
5349,2020-06-10,Côte d'Ivoire,0,114,3995,"rgb(201, 219, 116)"
5350,2020-06-11,Côte d'Ivoire,3,186,4181,"rgb(201, 219, 116)"
5351,2020-06-12,Côte d'Ivoire,0,223,4404,"rgb(201, 219, 116)"
5352,2020-06-13,Côte d'Ivoire,4,280,4684,"rgb(201, 219, 116)"
5353,2020-06-14,Côte d'Ivoire,0,164,4848,"rgb(201, 219, 116)"
5354,2020-06-15,Côte d'Ivoire,0,236,5084,"rgb(201, 219, 116)"
5355,2020-06-16,Côte d'Ivoire,1,355,5439,"rgb(201, 219, 116)"
5356,2020-06-17,Côte d'Ivoire,0,240,5679,"rgb(201, 219, 116)"
5357,2020-06-18,Côte d'Ivoire,2,384,6063,"rgb(201, 219, 116)"
5358,2020-06-19,Côte d'Ivoire,0,0,6063,"rgb(201, 219, 116)"
5359,2020-06-20,Côte d'Ivoire,1,381,6444,"rgb(201, 219, 116)"
5360,2020-06-21,Côte d'Ivoire,0,430,6874,"rgb(201, 219, 116)"
5361,2020-06-22,Côte d'Ivoire,2,618,7492,"rgb(201, 219, 116)"
5362,2020-06-23,Côte d'Ivoire,3,0,7492,"rgb(201, 219, 116)"
5363,2020-06-24,Côte d'Ivoire,4,412,7904,"rgb(201, 219, 116)"
5364,2020-06-25,Côte d'Ivoire,0,0,7904,"rgb(201, 219, 116)"
5365,2020-06-26,Côte d'Ivoire,0,260,8164,"rgb(201, 219, 116)"
5366,2020-06-27,Côte d'Ivoire,2,170,8334,"rgb(201, 219, 116)"
5367,2020-06-28,Côte d'Ivoire,4,405,8739,"rgb(201, 219, 116)"
5368,2020-06-29,Côte d'Ivoire,2,205,8944,"rgb(201, 219, 116)"
5369,2020-06-30,Côte d'Ivoire,0,270,9214,"rgb(201, 219, 116)"
5370,2020-07-01,Côte d'Ivoire,2,285,9499,"rgb(201, 219, 116)"
5371,2020-07-02,Côte d'Ivoire,0,203,9702,"rgb(201, 219, 116)"
5372,2020-07-03,Côte d'Ivoire,0,290,9992,"rgb(201, 219, 116)"
5373,2020-07-04,Côte d'Ivoire,2,252,10244,"rgb(201, 219, 116)"
5374,2020-07-05,Côte d'Ivoire,2,218,10462,"rgb(201, 219, 116)"
5375,2020-07-06,Côte d'Ivoire,2,310,10772,"rgb(201, 219, 116)"
5376,2020-07-07,Côte d'Ivoire,1,194,10966,"rgb(201, 219, 116)"
5377,2020-07-08,Côte d'Ivoire,0,0,10966,"rgb(201, 219, 116)"
5378,2020-07-09,Côte d'Ivoire,3,538,11504,"rgb(201, 219, 116)"
5379,2020-07-10,Côte d'Ivoire,1,246,11750,"rgb(201, 219, 116)"
5380,2020-07-11,Côte d'Ivoire,2,302,12052,"rgb(201, 219, 116)"
5381,2020-07-12,Côte d'Ivoire,1,391,12443,"rgb(201, 219, 116)"
5382,2020-07-13,Côte d'Ivoire,2,323,12766,"rgb(201, 219, 116)"
5383,2020-03-04,Chile,0,1,1,"rgb(139, 224, 164)"
5384,2020-03-05,Chile,0,2,3,"rgb(139, 224, 164)"
5385,2020-03-06,Chile,0,1,4,"rgb(139, 224, 164)"
5386,2020-03-07,Chile,0,1,5,"rgb(139, 224, 164)"
5387,2020-03-09,Chile,0,5,10,"rgb(139, 224, 164)"
5388,2020-03-10,Chile,0,3,13,"rgb(139, 224, 164)"
5389,2020-03-11,Chile,0,4,17,"rgb(139, 224, 164)"
5390,2020-03-12,Chile,0,6,23,"rgb(139, 224, 164)"
5391,2020-03-13,Chile,0,10,33,"rgb(139, 224, 164)"
5392,2020-03-14,Chile,0,10,43,"rgb(139, 224, 164)"
5393,2020-03-15,Chile,0,18,61,"rgb(139, 224, 164)"
5394,2020-03-16,Chile,0,14,75,"rgb(139, 224, 164)"
5395,2020-03-17,Chile,0,81,156,"rgb(139, 224, 164)"
5396,2020-03-18,Chile,0,45,201,"rgb(139, 224, 164)"
5397,2020-03-19,Chile,0,37,238,"rgb(139, 224, 164)"
5398,2020-03-20,Chile,0,104,342,"rgb(139, 224, 164)"
5399,2020-03-21,Chile,0,92,434,"rgb(139, 224, 164)"
5400,2020-03-22,Chile,0,103,537,"rgb(139, 224, 164)"
5401,2020-03-23,Chile,1,95,632,"rgb(139, 224, 164)"
5402,2020-03-24,Chile,1,114,746,"rgb(139, 224, 164)"
5403,2020-03-25,Chile,0,176,922,"rgb(139, 224, 164)"
5404,2020-03-26,Chile,1,220,1142,"rgb(139, 224, 164)"
5405,2020-03-27,Chile,1,164,1306,"rgb(139, 224, 164)"
5406,2020-03-28,Chile,1,304,1610,"rgb(139, 224, 164)"
5407,2020-03-29,Chile,1,299,1909,"rgb(139, 224, 164)"
5408,2020-03-30,Chile,1,230,2139,"rgb(139, 224, 164)"
5409,2020-03-31,Chile,1,310,2449,"rgb(139, 224, 164)"
5410,2020-04-01,Chile,4,289,2738,"rgb(139, 224, 164)"
5411,2020-04-02,Chile,4,293,3031,"rgb(139, 224, 164)"
5412,2020-04-03,Chile,2,373,3404,"rgb(139, 224, 164)"
5413,2020-04-04,Chile,4,333,3737,"rgb(139, 224, 164)"
5414,2020-04-05,Chile,5,424,4161,"rgb(139, 224, 164)"
5415,2020-04-06,Chile,7,310,4471,"rgb(139, 224, 164)"
5416,2020-04-07,Chile,3,344,4815,"rgb(139, 224, 164)"
5417,2020-04-08,Chile,6,301,5116,"rgb(139, 224, 164)"
5418,2020-04-09,Chile,5,430,5546,"rgb(139, 224, 164)"
5419,2020-04-10,Chile,9,426,5972,"rgb(139, 224, 164)"
5420,2020-04-11,Chile,8,529,6501,"rgb(139, 224, 164)"
5421,2020-04-12,Chile,8,426,6927,"rgb(139, 224, 164)"
5422,2020-04-13,Chile,7,286,7213,"rgb(139, 224, 164)"
5423,2020-04-14,Chile,2,312,7525,"rgb(139, 224, 164)"
5424,2020-04-15,Chile,10,392,7917,"rgb(139, 224, 164)"
5425,2020-04-16,Chile,2,356,8273,"rgb(139, 224, 164)"
5426,2020-04-17,Chile,11,534,8807,"rgb(139, 224, 164)"
5427,2020-04-18,Chile,11,445,9252,"rgb(139, 224, 164)"
5428,2020-04-19,Chile,10,478,9730,"rgb(139, 224, 164)"
5429,2020-04-20,Chile,7,358,10088,"rgb(139, 224, 164)"
5430,2020-04-21,Chile,6,419,10507,"rgb(139, 224, 164)"
5431,2020-04-22,Chile,8,325,10832,"rgb(139, 224, 164)"
5432,2020-04-23,Chile,13,464,11296,"rgb(139, 224, 164)"
5433,2020-04-24,Chile,8,516,11812,"rgb(139, 224, 164)"
5434,2020-04-25,Chile,6,494,12306,"rgb(139, 224, 164)"
5435,2020-04-26,Chile,7,552,12858,"rgb(139, 224, 164)"
5436,2020-04-27,Chile,8,473,13331,"rgb(139, 224, 164)"
5437,2020-04-28,Chile,9,482,13813,"rgb(139, 224, 164)"
5438,2020-04-29,Chile,9,552,14365,"rgb(139, 224, 164)"
5439,2020-04-30,Chile,9,520,14885,"rgb(139, 224, 164)"
5440,2020-05-01,Chile,11,1138,16023,"rgb(139, 224, 164)"
5441,2020-05-02,Chile,7,985,17008,"rgb(139, 224, 164)"
5442,2020-05-03,Chile,13,1427,18435,"rgb(139, 224, 164)"
5443,2020-05-04,Chile,13,1228,19663,"rgb(139, 224, 164)"
5444,2020-05-05,Chile,10,980,20643,"rgb(139, 224, 164)"
5445,2020-05-06,Chile,5,1373,22016,"rgb(139, 224, 164)"
5446,2020-05-07,Chile,6,1032,23048,"rgb(139, 224, 164)"
5447,2020-05-08,Chile,4,1533,24581,"rgb(139, 224, 164)"
5448,2020-05-09,Chile,9,1391,25972,"rgb(139, 224, 164)"
5449,2020-05-10,Chile,10,1247,27219,"rgb(139, 224, 164)"
5450,2020-05-11,Chile,8,1647,28866,"rgb(139, 224, 164)"
5451,2020-05-12,Chile,11,1197,30063,"rgb(139, 224, 164)"
5452,2020-05-13,Chile,12,1658,31721,"rgb(139, 224, 164)"
5453,2020-05-14,Chile,11,2660,34381,"rgb(139, 224, 164)"
5454,2020-05-15,Chile,12,2659,37040,"rgb(139, 224, 164)"
5455,2020-05-16,Chile,36,2502,39542,"rgb(139, 224, 164)"
5456,2020-05-17,Chile,27,1886,41428,"rgb(139, 224, 164)"
5457,2020-05-18,Chile,29,2353,43781,"rgb(139, 224, 164)"
5458,2020-05-19,Chile,28,2278,46059,"rgb(139, 224, 164)"
5459,2020-05-20,Chile,31,3520,49579,"rgb(139, 224, 164)"
5460,2020-05-21,Chile,35,4038,53617,"rgb(139, 224, 164)"
5461,2020-05-22,Chile,45,3964,57581,"rgb(139, 224, 164)"
5462,2020-05-23,Chile,41,4276,61857,"rgb(139, 224, 164)"
5463,2020-05-24,Chile,43,3536,65393,"rgb(139, 224, 164)"
5464,2020-05-25,Chile,45,3709,69102,"rgb(139, 224, 164)"
5465,2020-05-26,Chile,43,4895,73997,"rgb(139, 224, 164)"
5466,2020-05-27,Chile,45,3964,77961,"rgb(139, 224, 164)"
5467,2020-05-28,Chile,35,4328,82289,"rgb(139, 224, 164)"
5468,2020-05-29,Chile,49,4654,86943,"rgb(139, 224, 164)"
5469,2020-05-30,Chile,54,3695,90638,"rgb(139, 224, 164)"
5470,2020-05-31,Chile,53,4220,94858,"rgb(139, 224, 164)"
5471,2020-06-01,Chile,57,4830,99688,"rgb(139, 224, 164)"
5472,2020-06-02,Chile,59,5471,105159,"rgb(139, 224, 164)"
5473,2020-06-03,Chile,75,3527,108686,"rgb(139, 224, 164)"
5474,2020-06-04,Chile,87,4942,113628,"rgb(139, 224, 164)"
5475,2020-06-05,Chile,81,4664,118292,"rgb(139, 224, 164)"
5476,2020-06-06,Chile,92,4207,122499,"rgb(139, 224, 164)"
5477,2020-06-07,Chile,93,5246,127745,"rgb(139, 224, 164)"
5478,2020-06-08,Chile,649,6405,134150,"rgb(139, 224, 164)"
5479,2020-06-09,Chile,74,4696,138846,"rgb(139, 224, 164)"
5480,2020-06-10,Chile,19,3913,142759,"rgb(139, 224, 164)"
5481,2020-06-11,Chile,192,5737,148496,"rgb(139, 224, 164)"
5482,2020-06-12,Chile,173,5596,154092,"rgb(139, 224, 164)"
5483,2020-06-13,Chile,222,6754,160846,"rgb(139, 224, 164)"
5484,2020-06-14,Chile,231,6509,167355,"rgb(139, 224, 164)"
5485,2020-06-15,Chile,222,6938,174293,"rgb(139, 224, 164)"
5486,2020-06-16,Chile,39,5143,179436,"rgb(139, 224, 164)"
5487,2020-06-17,Chile,21,5013,184449,"rgb(139, 224, 164)"
5488,2020-06-18,Chile,232,36179,220628,"rgb(139, 224, 164)"
5489,2020-06-19,Chile,226,4475,225103,"rgb(139, 224, 164)"
5490,2020-06-20,Chile,252,6290,231393,"rgb(139, 224, 164)"
5491,2020-06-21,Chile,202,5355,236748,"rgb(139, 224, 164)"
5492,2020-06-22,Chile,184,5607,242355,"rgb(139, 224, 164)"
5493,2020-06-23,Chile,23,4608,246963,"rgb(139, 224, 164)"
5494,2020-06-24,Chile,3,3804,250767,"rgb(139, 224, 164)"
5495,2020-06-25,Chile,226,3649,254416,"rgb(139, 224, 164)"
5496,2020-06-26,Chile,172,4648,259064,"rgb(139, 224, 164)"
5497,2020-06-27,Chile,165,4296,263360,"rgb(139, 224, 164)"
5498,2020-06-28,Chile,279,4406,267766,"rgb(139, 224, 164)"
5499,2020-06-29,Chile,162,4216,271982,"rgb(139, 224, 164)"
5500,2020-06-30,Chile,66,4017,275999,"rgb(139, 224, 164)"
5501,2020-07-01,Chile,113,3394,279393,"rgb(139, 224, 164)"
5502,2020-07-02,Chile,65,2650,282043,"rgb(139, 224, 164)"
5503,2020-07-03,Chile,167,2498,284541,"rgb(139, 224, 164)"
5504,2020-07-04,Chile,131,3548,288089,"rgb(139, 224, 164)"
5505,2020-07-05,Chile,141,3758,291847,"rgb(139, 224, 164)"
5506,2020-07-06,Chile,116,3685,295532,"rgb(139, 224, 164)"
5507,2020-07-07,Chile,76,3025,298557,"rgb(139, 224, 164)"
5508,2020-07-08,Chile,50,2462,301019,"rgb(139, 224, 164)"
5509,2020-07-09,Chile,139,2064,303083,"rgb(139, 224, 164)"
5510,2020-07-10,Chile,109,3133,306216,"rgb(139, 224, 164)"
5511,2020-07-11,Chile,99,3058,309274,"rgb(139, 224, 164)"
5512,2020-07-12,Chile,100,2755,312029,"rgb(139, 224, 164)"
5513,2020-07-13,Chile,98,3012,315041,"rgb(139, 224, 164)"
5514,2020-03-07,Cameroon,0,1,1,"rgb(180, 151, 231)"
5515,2020-03-09,Cameroon,0,1,2,"rgb(180, 151, 231)"
5516,2020-03-15,Cameroon,0,1,3,"rgb(180, 151, 231)"
5517,2020-03-16,Cameroon,0,1,4,"rgb(180, 151, 231)"
5518,2020-03-17,Cameroon,0,0,4,"rgb(180, 151, 231)"
5519,2020-03-18,Cameroon,0,6,10,"rgb(180, 151, 231)"
5520,2020-03-19,Cameroon,0,0,10,"rgb(180, 151, 231)"
5521,2020-03-20,Cameroon,0,4,14,"rgb(180, 151, 231)"
5522,2020-03-21,Cameroon,0,13,27,"rgb(180, 151, 231)"
5523,2020-03-22,Cameroon,0,0,27,"rgb(180, 151, 231)"
5524,2020-03-23,Cameroon,0,0,27,"rgb(180, 151, 231)"
5525,2020-03-24,Cameroon,0,29,56,"rgb(180, 151, 231)"
5526,2020-03-25,Cameroon,1,16,72,"rgb(180, 151, 231)"
5527,2020-03-26,Cameroon,0,0,72,"rgb(180, 151, 231)"
5528,2020-03-27,Cameroon,0,16,88,"rgb(180, 151, 231)"
5529,2020-03-28,Cameroon,0,0,88,"rgb(180, 151, 231)"
5530,2020-03-29,Cameroon,1,11,99,"rgb(180, 151, 231)"
5531,2020-03-30,Cameroon,0,0,99,"rgb(180, 151, 231)"
5532,2020-03-31,Cameroon,0,43,142,"rgb(180, 151, 231)"
5533,2020-04-01,Cameroon,4,51,193,"rgb(180, 151, 231)"
5534,2020-04-02,Cameroon,0,40,233,"rgb(180, 151, 231)"
5535,2020-04-03,Cameroon,1,38,271,"rgb(180, 151, 231)"
5536,2020-04-04,Cameroon,1,238,509,"rgb(180, 151, 231)"
5537,2020-04-05,Cameroon,1,46,555,"rgb(180, 151, 231)"
5538,2020-04-06,Cameroon,0,95,650,"rgb(180, 151, 231)"
5539,2020-04-07,Cameroon,0,8,658,"rgb(180, 151, 231)"
5540,2020-04-08,Cameroon,0,27,685,"rgb(180, 151, 231)"
5541,2020-04-09,Cameroon,1,45,730,"rgb(180, 151, 231)"
5542,2020-04-10,Cameroon,0,0,730,"rgb(180, 151, 231)"
5543,2020-04-11,Cameroon,0,73,803,"rgb(180, 151, 231)"
5544,2020-04-12,Cameroon,1,17,820,"rgb(180, 151, 231)"
5545,2020-04-13,Cameroon,1,0,820,"rgb(180, 151, 231)"
5546,2020-04-14,Cameroon,0,0,820,"rgb(180, 151, 231)"
5547,2020-04-15,Cameroon,5,35,855,"rgb(180, 151, 231)"
5548,2020-04-16,Cameroon,0,0,855,"rgb(180, 151, 231)"
5549,2020-04-17,Cameroon,4,0,855,"rgb(180, 151, 231)"
5550,2020-04-18,Cameroon,0,161,1016,"rgb(180, 151, 231)"
5551,2020-04-19,Cameroon,0,0,1016,"rgb(180, 151, 231)"
5552,2020-04-20,Cameroon,21,0,1016,"rgb(180, 151, 231)"
5553,2020-04-21,Cameroon,0,1,1017,"rgb(180, 151, 231)"
5554,2020-04-22,Cameroon,0,146,1163,"rgb(180, 151, 231)"
5555,2020-04-23,Cameroon,1,0,1163,"rgb(180, 151, 231)"
5556,2020-04-24,Cameroon,6,238,1401,"rgb(180, 151, 231)"
5557,2020-04-25,Cameroon,0,2,1403,"rgb(180, 151, 231)"
5558,2020-04-26,Cameroon,4,115,1518,"rgb(180, 151, 231)"
5559,2020-04-27,Cameroon,3,103,1621,"rgb(180, 151, 231)"
5560,2020-04-28,Cameroon,2,0,1621,"rgb(180, 151, 231)"
5561,2020-04-29,Cameroon,1,185,1806,"rgb(180, 151, 231)"
5562,2020-04-30,Cameroon,2,26,1832,"rgb(180, 151, 231)"
5563,2020-05-01,Cameroon,0,0,1832,"rgb(180, 151, 231)"
5564,2020-05-02,Cameroon,0,237,2069,"rgb(180, 151, 231)"
5565,2020-05-03,Cameroon,3,8,2077,"rgb(180, 151, 231)"
5566,2020-05-04,Cameroon,0,0,2077,"rgb(180, 151, 231)"
5567,2020-05-05,Cameroon,0,27,2104,"rgb(180, 151, 231)"
5568,2020-05-06,Cameroon,0,0,2104,"rgb(180, 151, 231)"
5569,2020-05-07,Cameroon,44,161,2265,"rgb(180, 151, 231)"
5570,2020-05-08,Cameroon,0,0,2265,"rgb(180, 151, 231)"
5571,2020-05-09,Cameroon,0,0,2265,"rgb(180, 151, 231)"
5572,2020-05-10,Cameroon,0,9,2274,"rgb(180, 151, 231)"
5573,2020-05-11,Cameroon,6,305,2579,"rgb(180, 151, 231)"
5574,2020-05-12,Cameroon,11,110,2689,"rgb(180, 151, 231)"
5575,2020-05-13,Cameroon,0,0,2689,"rgb(180, 151, 231)"
5576,2020-05-14,Cameroon,11,111,2800,"rgb(180, 151, 231)"
5577,2020-05-15,Cameroon,3,154,2954,"rgb(180, 151, 231)"
5578,2020-05-16,Cameroon,1,151,3105,"rgb(180, 151, 231)"
5579,2020-05-17,Cameroon,0,187,3292,"rgb(180, 151, 231)"
5580,2020-05-18,Cameroon,0,0,3292,"rgb(180, 151, 231)"
5581,2020-05-19,Cameroon,0,0,3292,"rgb(180, 151, 231)"
5582,2020-05-20,Cameroon,0,237,3529,"rgb(180, 151, 231)"
5583,2020-05-21,Cameroon,6,204,3733,"rgb(180, 151, 231)"
5584,2020-05-22,Cameroon,10,555,4288,"rgb(180, 151, 231)"
5585,2020-05-23,Cameroon,3,112,4400,"rgb(180, 151, 231)"
5586,2020-05-24,Cameroon,0,197,4597,"rgb(180, 151, 231)"
5587,2020-05-25,Cameroon,6,293,4890,"rgb(180, 151, 231)"
5588,2020-05-26,Cameroon,6,154,5044,"rgb(180, 151, 231)"
5589,2020-05-27,Cameroon,4,312,5356,"rgb(180, 151, 231)"
5590,2020-05-28,Cameroon,2,0,5356,"rgb(180, 151, 231)"
5591,2020-05-29,Cameroon,0,0,5356,"rgb(180, 151, 231)"
5592,2020-05-30,Cameroon,0,80,5436,"rgb(180, 151, 231)"
5593,2020-05-31,Cameroon,14,468,5904,"rgb(180, 151, 231)"
5594,2020-06-01,Cameroon,0,0,5904,"rgb(180, 151, 231)"
5595,2020-06-02,Cameroon,8,493,6397,"rgb(180, 151, 231)"
5596,2020-06-03,Cameroon,1,188,6585,"rgb(180, 151, 231)"
5597,2020-06-04,Cameroon,0,167,6752,"rgb(180, 151, 231)"
5598,2020-06-05,Cameroon,3,37,6789,"rgb(180, 151, 231)"
5599,2020-06-06,Cameroon,0,810,7599,"rgb(180, 151, 231)"
5600,2020-06-07,Cameroon,0,0,7599,"rgb(180, 151, 231)"
5601,2020-06-08,Cameroon,0,309,7908,"rgb(180, 151, 231)"
5602,2020-06-09,Cameroon,5,404,8312,"rgb(180, 151, 231)"
5603,2020-06-10,Cameroon,0,369,8681,"rgb(180, 151, 231)"
5604,2020-06-11,Cameroon,6,248,8929,"rgb(180, 151, 231)"
5605,2020-06-12,Cameroon,0,0,8929,"rgb(180, 151, 231)"
5606,2020-06-13,Cameroon,59,267,9196,"rgb(180, 151, 231)"
5607,2020-06-14,Cameroon,2,376,9572,"rgb(180, 151, 231)"
5608,2020-06-15,Cameroon,1,292,9864,"rgb(180, 151, 231)"
5609,2020-06-16,Cameroon,0,0,9864,"rgb(180, 151, 231)"
5610,2020-06-17,Cameroon,0,0,9864,"rgb(180, 151, 231)"
5611,2020-06-18,Cameroon,0,0,9864,"rgb(180, 151, 231)"
5612,2020-06-19,Cameroon,6,774,10638,"rgb(180, 151, 231)"
5613,2020-06-20,Cameroon,18,643,11281,"rgb(180, 151, 231)"
5614,2020-06-21,Cameroon,0,0,11281,"rgb(180, 151, 231)"
5615,2020-06-22,Cameroon,1,329,11610,"rgb(180, 151, 231)"
5616,2020-06-23,Cameroon,2,282,11892,"rgb(180, 151, 231)"
5617,2020-06-24,Cameroon,5,149,12041,"rgb(180, 151, 231)"
5618,2020-06-25,Cameroon,5,229,12270,"rgb(180, 151, 231)"
5619,2020-06-26,Cameroon,0,322,12592,"rgb(180, 151, 231)"
5620,2020-06-27,Cameroon,0,0,12592,"rgb(180, 151, 231)"
5621,2020-06-28,Cameroon,0,0,12592,"rgb(180, 151, 231)"
5622,2020-06-29,Cameroon,0,0,12592,"rgb(180, 151, 231)"
5623,2020-06-30,Cameroon,0,0,12592,"rgb(180, 151, 231)"
5624,2020-07-01,Cameroon,0,0,12592,"rgb(180, 151, 231)"
5625,2020-07-02,Cameroon,0,0,12592,"rgb(180, 151, 231)"
5626,2020-07-03,Cameroon,0,0,12592,"rgb(180, 151, 231)"
5627,2020-07-04,Cameroon,0,0,12592,"rgb(180, 151, 231)"
5628,2020-07-05,Cameroon,0,0,12592,"rgb(180, 151, 231)"
5629,2020-07-06,Cameroon,15,1119,13711,"rgb(180, 151, 231)"
5630,2020-07-07,Cameroon,2,326,14037,"rgb(180, 151, 231)"
5631,2020-07-08,Cameroon,29,879,14916,"rgb(180, 151, 231)"
5632,2020-07-09,Cameroon,0,0,14916,"rgb(180, 151, 231)"
5633,2020-07-10,Cameroon,0,0,14916,"rgb(180, 151, 231)"
5634,2020-07-11,Cameroon,0,0,14916,"rgb(180, 151, 231)"
5635,2020-07-12,Cameroon,0,0,14916,"rgb(180, 151, 231)"
5636,2020-07-13,Cameroon,0,257,15173,"rgb(180, 151, 231)"
5637,2019-12-31,China,0,27,27,"rgb(179, 179, 179)"
5638,2020-01-01,China,0,0,27,"rgb(179, 179, 179)"
5639,2020-01-02,China,0,0,27,"rgb(179, 179, 179)"
5640,2020-01-03,China,0,17,44,"rgb(179, 179, 179)"
5641,2020-01-04,China,0,0,44,"rgb(179, 179, 179)"
5642,2020-01-05,China,0,15,59,"rgb(179, 179, 179)"
5643,2020-01-06,China,0,0,59,"rgb(179, 179, 179)"
5644,2020-01-07,China,0,0,59,"rgb(179, 179, 179)"
5645,2020-01-08,China,0,0,59,"rgb(179, 179, 179)"
5646,2020-01-09,China,0,0,59,"rgb(179, 179, 179)"
5647,2020-01-10,China,0,0,59,"rgb(179, 179, 179)"
5648,2020-01-11,China,1,0,59,"rgb(179, 179, 179)"
5649,2020-01-12,China,0,0,59,"rgb(179, 179, 179)"
5650,2020-01-13,China,0,0,59,"rgb(179, 179, 179)"
5651,2020-01-14,China,0,0,59,"rgb(179, 179, 179)"
5652,2020-01-15,China,1,0,59,"rgb(179, 179, 179)"
5653,2020-01-16,China,0,0,59,"rgb(179, 179, 179)"
5654,2020-01-17,China,0,4,63,"rgb(179, 179, 179)"
5655,2020-01-18,China,0,17,80,"rgb(179, 179, 179)"
5656,2020-01-19,China,1,136,216,"rgb(179, 179, 179)"
5657,2020-01-20,China,0,19,235,"rgb(179, 179, 179)"
5658,2020-01-21,China,3,151,386,"rgb(179, 179, 179)"
5659,2020-01-22,China,11,140,526,"rgb(179, 179, 179)"
5660,2020-01-23,China,0,97,623,"rgb(179, 179, 179)"
5661,2020-01-24,China,9,259,882,"rgb(179, 179, 179)"
5662,2020-01-25,China,15,441,1323,"rgb(179, 179, 179)"
5663,2020-01-26,China,15,665,1988,"rgb(179, 179, 179)"
5664,2020-01-27,China,25,787,2775,"rgb(179, 179, 179)"
5665,2020-01-28,China,25,1753,4528,"rgb(179, 179, 179)"
5666,2020-01-29,China,26,1466,5994,"rgb(179, 179, 179)"
5667,2020-01-30,China,38,1740,7734,"rgb(179, 179, 179)"
5668,2020-01-31,China,43,1980,9714,"rgb(179, 179, 179)"
5669,2020-02-01,China,46,2095,11809,"rgb(179, 179, 179)"
5670,2020-02-02,China,45,2590,14399,"rgb(179, 179, 179)"
5671,2020-02-03,China,57,2812,17211,"rgb(179, 179, 179)"
5672,2020-02-04,China,65,3237,20448,"rgb(179, 179, 179)"
5673,2020-02-05,China,66,3872,24320,"rgb(179, 179, 179)"
5674,2020-02-06,China,72,3727,28047,"rgb(179, 179, 179)"
5675,2020-02-07,China,73,3160,31207,"rgb(179, 179, 179)"
5676,2020-02-08,China,86,3418,34625,"rgb(179, 179, 179)"
5677,2020-02-09,China,89,2607,37232,"rgb(179, 179, 179)"
5678,2020-02-10,China,97,2974,40206,"rgb(179, 179, 179)"
5679,2020-02-11,China,108,2490,42696,"rgb(179, 179, 179)"
5680,2020-02-12,China,97,2028,44724,"rgb(179, 179, 179)"
5681,2020-02-13,China,254,15141,59865,"rgb(179, 179, 179)"
5682,2020-02-14,China,13,4156,64021,"rgb(179, 179, 179)"
5683,2020-02-15,China,143,2538,66559,"rgb(179, 179, 179)"
5684,2020-02-16,China,142,2007,68566,"rgb(179, 179, 179)"
5685,2020-02-17,China,105,2052,70618,"rgb(179, 179, 179)"
5686,2020-02-18,China,98,1890,72508,"rgb(179, 179, 179)"
5687,2020-02-19,China,139,1750,74258,"rgb(179, 179, 179)"
5688,2020-02-20,China,112,394,74652,"rgb(179, 179, 179)"
5689,2020-02-21,China,118,891,75543,"rgb(179, 179, 179)"
5690,2020-02-22,China,109,826,76369,"rgb(179, 179, 179)"
5691,2020-02-23,China,98,647,77016,"rgb(179, 179, 179)"
5692,2020-02-24,China,150,218,77234,"rgb(179, 179, 179)"
5693,2020-02-25,China,70,515,77749,"rgb(179, 179, 179)"
5694,2020-02-26,China,52,410,78159,"rgb(179, 179, 179)"
5695,2020-02-27,China,29,439,78598,"rgb(179, 179, 179)"
5696,2020-02-28,China,44,329,78927,"rgb(179, 179, 179)"
5697,2020-02-29,China,47,428,79355,"rgb(179, 179, 179)"
5698,2020-03-01,China,35,574,79929,"rgb(179, 179, 179)"
5699,2020-03-02,China,42,205,80134,"rgb(179, 179, 179)"
5700,2020-03-03,China,32,127,80261,"rgb(179, 179, 179)"
5701,2020-03-04,China,37,119,80380,"rgb(179, 179, 179)"
5702,2020-03-05,China,31,117,80497,"rgb(179, 179, 179)"
5703,2020-03-06,China,30,170,80667,"rgb(179, 179, 179)"
5704,2020-03-07,China,28,101,80768,"rgb(179, 179, 179)"
5705,2020-03-08,China,27,46,80814,"rgb(179, 179, 179)"
5706,2020-03-09,China,23,45,80859,"rgb(179, 179, 179)"
5707,2020-03-10,China,17,20,80879,"rgb(179, 179, 179)"
5708,2020-03-11,China,22,29,80908,"rgb(179, 179, 179)"
5709,2020-03-12,China,11,24,80932,"rgb(179, 179, 179)"
5710,2020-03-13,China,7,22,80954,"rgb(179, 179, 179)"
5711,2020-03-14,China,15,19,80973,"rgb(179, 179, 179)"
5712,2020-03-15,China,9,22,80995,"rgb(179, 179, 179)"
5713,2020-03-16,China,13,25,81020,"rgb(179, 179, 179)"
5714,2020-03-17,China,9,43,81063,"rgb(179, 179, 179)"
5715,2020-03-18,China,16,23,81086,"rgb(179, 179, 179)"
5716,2020-03-19,China,8,44,81130,"rgb(179, 179, 179)"
5717,2020-03-20,China,4,99,81229,"rgb(179, 179, 179)"
5718,2020-03-21,China,6,52,81281,"rgb(179, 179, 179)"
5719,2020-03-22,China,6,65,81346,"rgb(179, 179, 179)"
5720,2020-03-23,China,9,138,81484,"rgb(179, 179, 179)"
5721,2020-03-24,China,7,69,81553,"rgb(179, 179, 179)"
5722,2020-03-25,China,4,78,81631,"rgb(179, 179, 179)"
5723,2020-03-26,China,6,102,81733,"rgb(179, 179, 179)"
5724,2020-03-27,China,5,94,81827,"rgb(179, 179, 179)"
5725,2020-03-28,China,3,119,81946,"rgb(179, 179, 179)"
5726,2020-03-29,China,5,113,82059,"rgb(179, 179, 179)"
5727,2020-03-30,China,2,98,82157,"rgb(179, 179, 179)"
5728,2020-03-31,China,3,84,82241,"rgb(179, 179, 179)"
5729,2020-04-01,China,1,54,82295,"rgb(179, 179, 179)"
5730,2020-04-02,China,6,100,82395,"rgb(179, 179, 179)"
5731,2020-04-03,China,10,70,82465,"rgb(179, 179, 179)"
5732,2020-04-04,China,4,62,82527,"rgb(179, 179, 179)"
5733,2020-04-05,China,3,48,82575,"rgb(179, 179, 179)"
5734,2020-04-06,China,2,67,82642,"rgb(179, 179, 179)"
5735,2020-04-07,China,0,56,82698,"rgb(179, 179, 179)"
5736,2020-04-08,China,2,86,82784,"rgb(179, 179, 179)"
5737,2020-04-09,China,2,86,82870,"rgb(179, 179, 179)"
5738,2020-04-10,China,1,55,82925,"rgb(179, 179, 179)"
5739,2020-04-11,China,3,79,83004,"rgb(179, 179, 179)"
5740,2020-04-12,China,0,93,83097,"rgb(179, 179, 179)"
5741,2020-04-13,China,2,112,83209,"rgb(179, 179, 179)"
5742,2020-04-14,China,0,94,83303,"rgb(179, 179, 179)"
5743,2020-04-15,China,1,49,83352,"rgb(179, 179, 179)"
5744,2020-04-16,China,0,50,83402,"rgb(179, 179, 179)"
5745,2020-04-17,China,1290,352,83754,"rgb(179, 179, 179)"
5746,2020-04-18,China,0,31,83785,"rgb(179, 179, 179)"
5747,2020-04-19,China,0,18,83803,"rgb(179, 179, 179)"
5748,2020-04-20,China,0,14,83817,"rgb(179, 179, 179)"
5749,2020-04-21,China,0,32,83849,"rgb(179, 179, 179)"
5750,2020-04-22,China,0,15,83864,"rgb(179, 179, 179)"
5751,2020-04-23,China,0,12,83876,"rgb(179, 179, 179)"
5752,2020-04-24,China,0,8,83884,"rgb(179, 179, 179)"
5753,2020-04-25,China,0,15,83899,"rgb(179, 179, 179)"
5754,2020-04-26,China,0,10,83909,"rgb(179, 179, 179)"
5755,2020-04-27,China,1,3,83912,"rgb(179, 179, 179)"
5756,2020-04-28,China,0,26,83938,"rgb(179, 179, 179)"
5757,2020-04-29,China,0,2,83940,"rgb(179, 179, 179)"
5758,2020-04-30,China,0,4,83944,"rgb(179, 179, 179)"
5759,2020-05-01,China,0,12,83956,"rgb(179, 179, 179)"
5760,2020-05-02,China,0,3,83959,"rgb(179, 179, 179)"
5761,2020-05-03,China,0,2,83961,"rgb(179, 179, 179)"
5762,2020-05-04,China,0,3,83964,"rgb(179, 179, 179)"
5763,2020-05-05,China,0,2,83966,"rgb(179, 179, 179)"
5764,2020-05-06,China,0,2,83968,"rgb(179, 179, 179)"
5765,2020-05-07,China,0,2,83970,"rgb(179, 179, 179)"
5766,2020-05-08,China,0,6,83976,"rgb(179, 179, 179)"
5767,2020-05-09,China,0,0,83976,"rgb(179, 179, 179)"
5768,2020-05-10,China,0,15,83991,"rgb(179, 179, 179)"
5769,2020-05-11,China,0,19,84010,"rgb(179, 179, 179)"
5770,2020-05-12,China,0,1,84011,"rgb(179, 179, 179)"
5771,2020-05-13,China,0,7,84018,"rgb(179, 179, 179)"
5772,2020-05-14,China,0,6,84024,"rgb(179, 179, 179)"
5773,2020-05-15,China,0,5,84029,"rgb(179, 179, 179)"
5774,2020-05-16,China,0,9,84038,"rgb(179, 179, 179)"
5775,2020-05-17,China,1,6,84044,"rgb(179, 179, 179)"
5776,2020-05-18,China,0,10,84054,"rgb(179, 179, 179)"
5777,2020-05-19,China,0,9,84063,"rgb(179, 179, 179)"
5778,2020-05-20,China,0,2,84065,"rgb(179, 179, 179)"
5779,2020-05-21,China,0,2,84067,"rgb(179, 179, 179)"
5780,2020-05-22,China,0,12,84079,"rgb(179, 179, 179)"
5781,2020-05-23,China,0,2,84081,"rgb(179, 179, 179)"
5782,2020-05-24,China,0,3,84084,"rgb(179, 179, 179)"
5783,2020-05-25,China,0,11,84095,"rgb(179, 179, 179)"
5784,2020-05-26,China,0,7,84102,"rgb(179, 179, 179)"
5785,2020-05-27,China,0,1,84103,"rgb(179, 179, 179)"
5786,2020-05-28,China,0,3,84106,"rgb(179, 179, 179)"
5787,2020-05-29,China,0,0,84106,"rgb(179, 179, 179)"
5788,2020-05-30,China,0,17,84123,"rgb(179, 179, 179)"
5789,2020-05-31,China,0,5,84128,"rgb(179, 179, 179)"
5790,2020-06-01,China,0,19,84147,"rgb(179, 179, 179)"
5791,2020-06-02,China,0,7,84154,"rgb(179, 179, 179)"
5792,2020-06-03,China,0,5,84159,"rgb(179, 179, 179)"
5793,2020-06-04,China,0,1,84160,"rgb(179, 179, 179)"
5794,2020-06-05,China,0,11,84171,"rgb(179, 179, 179)"
5795,2020-06-06,China,0,6,84177,"rgb(179, 179, 179)"
5796,2020-06-07,China,0,9,84186,"rgb(179, 179, 179)"
5797,2020-06-08,China,0,5,84191,"rgb(179, 179, 179)"
5798,2020-06-09,China,0,3,84194,"rgb(179, 179, 179)"
5799,2020-06-10,China,0,4,84198,"rgb(179, 179, 179)"
5800,2020-06-11,China,0,11,84209,"rgb(179, 179, 179)"
5801,2020-06-12,China,0,7,84216,"rgb(179, 179, 179)"
5802,2020-06-13,China,0,12,84228,"rgb(179, 179, 179)"
5803,2020-06-14,China,0,60,84288,"rgb(179, 179, 179)"
5804,2020-06-15,China,0,47,84335,"rgb(179, 179, 179)"
5805,2020-06-16,China,0,43,84378,"rgb(179, 179, 179)"
5806,2020-06-17,China,0,44,84422,"rgb(179, 179, 179)"
5807,2020-06-18,China,0,36,84458,"rgb(179, 179, 179)"
5808,2020-06-19,China,0,36,84494,"rgb(179, 179, 179)"
5809,2020-06-20,China,0,30,84524,"rgb(179, 179, 179)"
5810,2020-06-21,China,1,29,84553,"rgb(179, 179, 179)"
5811,2020-06-22,China,0,19,84572,"rgb(179, 179, 179)"
5812,2020-06-23,China,0,52,84624,"rgb(179, 179, 179)"
5813,2020-06-24,China,1,29,84653,"rgb(179, 179, 179)"
5814,2020-06-25,China,0,20,84673,"rgb(179, 179, 179)"
5815,2020-06-26,China,1,28,84701,"rgb(179, 179, 179)"
5816,2020-06-27,China,0,24,84725,"rgb(179, 179, 179)"
5817,2020-06-28,China,0,18,84743,"rgb(179, 179, 179)"
5818,2020-06-29,China,0,14,84757,"rgb(179, 179, 179)"
5819,2020-06-30,China,0,23,84780,"rgb(179, 179, 179)"
5820,2020-07-01,China,0,5,84785,"rgb(179, 179, 179)"
5821,2020-07-02,China,0,31,84816,"rgb(179, 179, 179)"
5822,2020-07-03,China,0,14,84830,"rgb(179, 179, 179)"
5823,2020-07-04,China,0,9,84839,"rgb(179, 179, 179)"
5824,2020-07-05,China,0,18,84857,"rgb(179, 179, 179)"
5825,2020-07-06,China,0,14,84871,"rgb(179, 179, 179)"
5826,2020-07-07,China,0,25,84896,"rgb(179, 179, 179)"
5827,2020-07-08,China,0,21,84917,"rgb(179, 179, 179)"
5828,2020-07-09,China,0,33,84950,"rgb(179, 179, 179)"
5829,2020-07-10,China,0,46,84996,"rgb(179, 179, 179)"
5830,2020-07-11,China,0,40,85036,"rgb(179, 179, 179)"
5831,2020-07-12,China,0,35,85071,"rgb(179, 179, 179)"
5832,2020-07-13,China,0,46,85117,"rgb(179, 179, 179)"
5833,2020-03-07,Colombia,0,1,1,"rgb(229, 134, 6)"
5834,2020-03-10,Colombia,0,2,3,"rgb(229, 134, 6)"
5835,2020-03-12,Colombia,0,6,9,"rgb(229, 134, 6)"
5836,2020-03-14,Colombia,0,7,16,"rgb(229, 134, 6)"
5837,2020-03-15,Colombia,0,18,34,"rgb(229, 134, 6)"
5838,2020-03-16,Colombia,0,11,45,"rgb(229, 134, 6)"
5839,2020-03-17,Colombia,0,12,57,"rgb(229, 134, 6)"
5840,2020-03-18,Colombia,0,8,65,"rgb(229, 134, 6)"
5841,2020-03-19,Colombia,0,37,102,"rgb(229, 134, 6)"
5842,2020-03-20,Colombia,0,26,128,"rgb(229, 134, 6)"
5843,2020-03-21,Colombia,0,30,158,"rgb(229, 134, 6)"
5844,2020-03-22,Colombia,1,52,210,"rgb(229, 134, 6)"
5845,2020-03-23,Colombia,1,25,235,"rgb(229, 134, 6)"
5846,2020-03-24,Colombia,1,71,306,"rgb(229, 134, 6)"
5847,2020-03-25,Colombia,0,72,378,"rgb(229, 134, 6)"
5848,2020-03-26,Colombia,1,92,470,"rgb(229, 134, 6)"
5849,2020-03-27,Colombia,2,21,491,"rgb(229, 134, 6)"
5850,2020-03-28,Colombia,0,48,539,"rgb(229, 134, 6)"
5851,2020-03-29,Colombia,0,69,608,"rgb(229, 134, 6)"
5852,2020-03-30,Colombia,4,94,702,"rgb(229, 134, 6)"
5853,2020-03-31,Colombia,4,96,798,"rgb(229, 134, 6)"
5854,2020-04-01,Colombia,2,108,906,"rgb(229, 134, 6)"
5855,2020-04-02,Colombia,1,159,1065,"rgb(229, 134, 6)"
5856,2020-04-03,Colombia,2,96,1161,"rgb(229, 134, 6)"
5857,2020-04-04,Colombia,6,106,1267,"rgb(229, 134, 6)"
5858,2020-04-05,Colombia,7,139,1406,"rgb(229, 134, 6)"
5859,2020-04-06,Colombia,3,79,1485,"rgb(229, 134, 6)"
5860,2020-04-07,Colombia,11,94,1579,"rgb(229, 134, 6)"
5861,2020-04-08,Colombia,4,201,1780,"rgb(229, 134, 6)"
5862,2020-04-09,Colombia,5,274,2054,"rgb(229, 134, 6)"
5863,2020-04-10,Colombia,14,169,2223,"rgb(229, 134, 6)"
5864,2020-04-11,Colombia,11,250,2473,"rgb(229, 134, 6)"
5865,2020-04-12,Colombia,20,236,2709,"rgb(229, 134, 6)"
5866,2020-04-13,Colombia,9,67,2776,"rgb(229, 134, 6)"
5867,2020-04-14,Colombia,3,76,2852,"rgb(229, 134, 6)"
5868,2020-04-15,Colombia,15,127,2979,"rgb(229, 134, 6)"
5869,2020-04-16,Colombia,4,126,3105,"rgb(229, 134, 6)"
5870,2020-04-17,Colombia,13,128,3233,"rgb(229, 134, 6)"
5871,2020-04-18,Colombia,9,206,3439,"rgb(229, 134, 6)"
5872,2020-04-19,Colombia,13,182,3621,"rgb(229, 134, 6)"
5873,2020-04-20,Colombia,13,171,3792,"rgb(229, 134, 6)"
5874,2020-04-21,Colombia,10,185,3977,"rgb(229, 134, 6)"
5875,2020-04-22,Colombia,7,172,4149,"rgb(229, 134, 6)"
5876,2020-04-23,Colombia,10,207,4356,"rgb(229, 134, 6)"
5877,2020-04-24,Colombia,9,205,4561,"rgb(229, 134, 6)"
5878,2020-04-25,Colombia,10,320,4881,"rgb(229, 134, 6)"
5879,2020-04-26,Colombia,8,261,5142,"rgb(229, 134, 6)"
5880,2020-04-27,Colombia,10,237,5379,"rgb(229, 134, 6)"
5881,2020-04-28,Colombia,10,218,5597,"rgb(229, 134, 6)"
5882,2020-04-29,Colombia,16,352,5949,"rgb(229, 134, 6)"
5883,2020-04-30,Colombia,9,262,6211,"rgb(229, 134, 6)"
5884,2020-05-01,Colombia,15,296,6507,"rgb(229, 134, 6)"
5885,2020-05-02,Colombia,21,499,7006,"rgb(229, 134, 6)"
5886,2020-05-03,Colombia,10,279,7285,"rgb(229, 134, 6)"
5887,2020-05-04,Colombia,16,383,7668,"rgb(229, 134, 6)"
5888,2020-05-05,Colombia,18,305,7973,"rgb(229, 134, 6)"
5889,2020-05-06,Colombia,20,640,8613,"rgb(229, 134, 6)"
5890,2020-05-07,Colombia,19,346,8959,"rgb(229, 134, 6)"
5891,2020-05-08,Colombia,10,497,9456,"rgb(229, 134, 6)"
5892,2020-05-09,Colombia,21,595,10051,"rgb(229, 134, 6)"
5893,2020-05-10,Colombia,17,444,10495,"rgb(229, 134, 6)"
5894,2020-05-11,Colombia,18,568,11063,"rgb(229, 134, 6)"
5895,2020-05-12,Colombia,16,550,11613,"rgb(229, 134, 6)"
5896,2020-05-13,Colombia,14,659,12272,"rgb(229, 134, 6)"
5897,2020-05-14,Colombia,16,658,12930,"rgb(229, 134, 6)"
5898,2020-05-15,Colombia,16,680,13610,"rgb(229, 134, 6)"
5899,2020-05-16,Colombia,21,606,14216,"rgb(229, 134, 6)"
5900,2020-05-17,Colombia,16,723,14939,"rgb(229, 134, 6)"
5901,2020-05-18,Colombia,12,635,15574,"rgb(229, 134, 6)"
5902,2020-05-19,Colombia,18,721,16295,"rgb(229, 134, 6)"
5903,2020-05-20,Colombia,21,640,16935,"rgb(229, 134, 6)"
5904,2020-05-21,Colombia,17,752,17687,"rgb(229, 134, 6)"
5905,2020-05-22,Colombia,22,643,18330,"rgb(229, 134, 6)"
5906,2020-05-23,Colombia,30,801,19131,"rgb(229, 134, 6)"
5907,2020-05-24,Colombia,23,1046,20177,"rgb(229, 134, 6)"
5908,2020-05-25,Colombia,22,998,21175,"rgb(229, 134, 6)"
5909,2020-05-26,Colombia,23,806,21981,"rgb(229, 134, 6)"
5910,2020-05-27,Colombia,26,1022,23003,"rgb(229, 134, 6)"
5911,2020-05-28,Colombia,27,1101,24104,"rgb(229, 134, 6)"
5912,2020-05-29,Colombia,19,1262,25366,"rgb(229, 134, 6)"
5913,2020-05-30,Colombia,31,1322,26688,"rgb(229, 134, 6)"
5914,2020-05-31,Colombia,37,1548,28236,"rgb(229, 134, 6)"
5915,2020-06-01,Colombia,49,1147,29383,"rgb(229, 134, 6)"
5916,2020-06-02,Colombia,30,1110,30493,"rgb(229, 134, 6)"
5917,2020-06-03,Colombia,40,1340,31833,"rgb(229, 134, 6)"
5918,2020-06-04,Colombia,36,1521,33354,"rgb(229, 134, 6)"
5919,2020-06-05,Colombia,42,1766,35120,"rgb(229, 134, 6)"
5920,2020-06-06,Colombia,58,1515,36635,"rgb(229, 134, 6)"
5921,2020-06-07,Colombia,60,1392,38027,"rgb(229, 134, 6)"
5922,2020-06-08,Colombia,54,1209,39236,"rgb(229, 134, 6)"
5923,2020-06-09,Colombia,49,1483,40719,"rgb(229, 134, 6)"
5924,2020-06-10,Colombia,64,1359,42078,"rgb(229, 134, 6)"
5925,2020-06-11,Colombia,61,1604,43682,"rgb(229, 134, 6)"
5926,2020-06-12,Colombia,0,0,43682,"rgb(229, 134, 6)"
5927,2020-06-13,Colombia,112,3176,46858,"rgb(229, 134, 6)"
5928,2020-06-14,Colombia,47,1888,48746,"rgb(229, 134, 6)"
5929,2020-06-15,Colombia,75,2193,50939,"rgb(229, 134, 6)"
5930,2020-06-16,Colombia,59,2124,53063,"rgb(229, 134, 6)"
5931,2020-06-17,Colombia,75,1868,54931,"rgb(229, 134, 6)"
5932,2020-06-18,Colombia,63,2115,57046,"rgb(229, 134, 6)"
5933,2020-06-19,Colombia,86,3171,60217,"rgb(229, 134, 6)"
5934,2020-06-20,Colombia,95,3059,63276,"rgb(229, 134, 6)"
5935,2020-06-21,Colombia,81,2357,65633,"rgb(229, 134, 6)"
5936,2020-06-22,Colombia,111,3019,68652,"rgb(229, 134, 6)"
5937,2020-06-23,Colombia,73,2531,71183,"rgb(229, 134, 6)"
5938,2020-06-24,Colombia,94,2389,73572,"rgb(229, 134, 6)"
5939,2020-06-25,Colombia,87,3541,77113,"rgb(229, 134, 6)"
5940,2020-06-26,Colombia,163,3486,80599,"rgb(229, 134, 6)"
5941,2020-06-27,Colombia,157,3843,84442,"rgb(229, 134, 6)"
5942,2020-06-28,Colombia,128,4149,88591,"rgb(229, 134, 6)"
5943,2020-06-29,Colombia,167,3178,91769,"rgb(229, 134, 6)"
5944,2020-06-30,Colombia,117,3274,95043,"rgb(229, 134, 6)"
5945,2020-07-01,Colombia,111,2803,97846,"rgb(229, 134, 6)"
5946,2020-07-02,Colombia,136,4163,102009,"rgb(229, 134, 6)"
5947,2020-07-03,Colombia,171,4101,106110,"rgb(229, 134, 6)"
5948,2020-07-04,Colombia,136,3395,109505,"rgb(229, 134, 6)"
5949,2020-07-05,Colombia,165,3884,113389,"rgb(229, 134, 6)"
5950,2020-07-06,Colombia,122,3721,117110,"rgb(229, 134, 6)"
5951,2020-07-07,Colombia,146,3171,120281,"rgb(229, 134, 6)"
5952,2020-07-08,Colombia,149,4213,124494,"rgb(229, 134, 6)"
5953,2020-07-09,Colombia,168,4144,128638,"rgb(229, 134, 6)"
5954,2020-07-10,Colombia,187,5335,133973,"rgb(229, 134, 6)"
5955,2020-07-11,Colombia,211,6803,140776,"rgb(229, 134, 6)"
5956,2020-07-12,Colombia,194,4586,145362,"rgb(229, 134, 6)"
5957,2020-07-13,Colombia,188,5083,150445,"rgb(229, 134, 6)"
5958,2020-03-07,Costa Rica,0,1,1,"rgb(93, 105, 177)"
5959,2020-03-09,Costa Rica,0,4,5,"rgb(93, 105, 177)"
5960,2020-03-10,Costa Rica,0,4,9,"rgb(93, 105, 177)"
5961,2020-03-11,Costa Rica,0,4,13,"rgb(93, 105, 177)"
5962,2020-03-12,Costa Rica,0,9,22,"rgb(93, 105, 177)"
5963,2020-03-13,Costa Rica,0,1,23,"rgb(93, 105, 177)"
5964,2020-03-14,Costa Rica,0,3,26,"rgb(93, 105, 177)"
5965,2020-03-15,Costa Rica,0,1,27,"rgb(93, 105, 177)"
5966,2020-03-16,Costa Rica,0,8,35,"rgb(93, 105, 177)"
5967,2020-03-17,Costa Rica,0,6,41,"rgb(93, 105, 177)"
5968,2020-03-18,Costa Rica,0,9,50,"rgb(93, 105, 177)"
5969,2020-03-19,Costa Rica,1,19,69,"rgb(93, 105, 177)"
5970,2020-03-20,Costa Rica,0,18,87,"rgb(93, 105, 177)"
5971,2020-03-21,Costa Rica,1,26,113,"rgb(93, 105, 177)"
5972,2020-03-22,Costa Rica,0,4,117,"rgb(93, 105, 177)"
5973,2020-03-23,Costa Rica,0,17,134,"rgb(93, 105, 177)"
5974,2020-03-24,Costa Rica,0,24,158,"rgb(93, 105, 177)"
5975,2020-03-25,Costa Rica,0,19,177,"rgb(93, 105, 177)"
5976,2020-03-26,Costa Rica,0,24,201,"rgb(93, 105, 177)"
5977,2020-03-27,Costa Rica,0,30,231,"rgb(93, 105, 177)"
5978,2020-03-28,Costa Rica,0,32,263,"rgb(93, 105, 177)"
5979,2020-03-29,Costa Rica,0,32,295,"rgb(93, 105, 177)"
5980,2020-03-30,Costa Rica,0,19,314,"rgb(93, 105, 177)"
5981,2020-03-31,Costa Rica,0,16,330,"rgb(93, 105, 177)"
5982,2020-04-01,Costa Rica,0,17,347,"rgb(93, 105, 177)"
5983,2020-04-02,Costa Rica,0,28,375,"rgb(93, 105, 177)"
5984,2020-04-03,Costa Rica,0,21,396,"rgb(93, 105, 177)"
5985,2020-04-04,Costa Rica,0,20,416,"rgb(93, 105, 177)"
5986,2020-04-05,Costa Rica,0,19,435,"rgb(93, 105, 177)"
5987,2020-04-06,Costa Rica,0,19,454,"rgb(93, 105, 177)"
5988,2020-04-07,Costa Rica,0,13,467,"rgb(93, 105, 177)"
5989,2020-04-08,Costa Rica,0,16,483,"rgb(93, 105, 177)"
5990,2020-04-09,Costa Rica,0,19,502,"rgb(93, 105, 177)"
5991,2020-04-10,Costa Rica,1,37,539,"rgb(93, 105, 177)"
5992,2020-04-11,Costa Rica,0,19,558,"rgb(93, 105, 177)"
5993,2020-04-12,Costa Rica,0,19,577,"rgb(93, 105, 177)"
5994,2020-04-13,Costa Rica,0,18,595,"rgb(93, 105, 177)"
5995,2020-04-14,Costa Rica,0,17,612,"rgb(93, 105, 177)"
5996,2020-04-15,Costa Rica,0,6,618,"rgb(93, 105, 177)"
5997,2020-04-16,Costa Rica,1,8,626,"rgb(93, 105, 177)"
5998,2020-04-17,Costa Rica,0,16,642,"rgb(93, 105, 177)"
5999,2020-04-18,Costa Rica,0,7,649,"rgb(93, 105, 177)"
6000,2020-04-19,Costa Rica,0,6,655,"rgb(93, 105, 177)"
6001,2020-04-20,Costa Rica,0,5,660,"rgb(93, 105, 177)"
6002,2020-04-21,Costa Rica,2,2,662,"rgb(93, 105, 177)"
6003,2020-04-22,Costa Rica,0,7,669,"rgb(93, 105, 177)"
6004,2020-04-23,Costa Rica,0,12,681,"rgb(93, 105, 177)"
6005,2020-04-24,Costa Rica,0,6,687,"rgb(93, 105, 177)"
6006,2020-04-25,Costa Rica,0,0,687,"rgb(93, 105, 177)"
6007,2020-04-26,Costa Rica,0,6,693,"rgb(93, 105, 177)"
6008,2020-04-27,Costa Rica,0,2,695,"rgb(93, 105, 177)"
6009,2020-04-28,Costa Rica,0,2,697,"rgb(93, 105, 177)"
6010,2020-04-29,Costa Rica,0,8,705,"rgb(93, 105, 177)"
6011,2020-04-30,Costa Rica,0,8,713,"rgb(93, 105, 177)"
6012,2020-05-01,Costa Rica,0,6,719,"rgb(93, 105, 177)"
6013,2020-05-02,Costa Rica,0,6,725,"rgb(93, 105, 177)"
6014,2020-05-03,Costa Rica,0,8,733,"rgb(93, 105, 177)"
6015,2020-05-04,Costa Rica,0,6,739,"rgb(93, 105, 177)"
6016,2020-05-05,Costa Rica,0,3,742,"rgb(93, 105, 177)"
6017,2020-05-06,Costa Rica,0,13,755,"rgb(93, 105, 177)"
6018,2020-05-07,Costa Rica,0,6,761,"rgb(93, 105, 177)"
6019,2020-05-08,Costa Rica,0,4,765,"rgb(93, 105, 177)"
6020,2020-05-09,Costa Rica,0,8,773,"rgb(93, 105, 177)"
6021,2020-05-10,Costa Rica,0,7,780,"rgb(93, 105, 177)"
6022,2020-05-11,Costa Rica,0,12,792,"rgb(93, 105, 177)"
6023,2020-05-12,Costa Rica,1,9,801,"rgb(93, 105, 177)"
6024,2020-05-13,Costa Rica,0,3,804,"rgb(93, 105, 177)"
6025,2020-05-14,Costa Rica,0,11,815,"rgb(93, 105, 177)"
6026,2020-05-15,Costa Rica,1,15,830,"rgb(93, 105, 177)"
6027,2020-05-16,Costa Rica,0,13,843,"rgb(93, 105, 177)"
6028,2020-05-17,Costa Rica,2,10,853,"rgb(93, 105, 177)"
6029,2020-05-18,Costa Rica,0,10,863,"rgb(93, 105, 177)"
6030,2020-05-19,Costa Rica,0,3,866,"rgb(93, 105, 177)"
6031,2020-05-20,Costa Rica,0,16,882,"rgb(93, 105, 177)"
6032,2020-05-21,Costa Rica,0,15,897,"rgb(93, 105, 177)"
6033,2020-05-22,Costa Rica,0,6,903,"rgb(93, 105, 177)"
6034,2020-05-23,Costa Rica,0,8,911,"rgb(93, 105, 177)"
6035,2020-05-24,Costa Rica,0,7,918,"rgb(93, 105, 177)"
6036,2020-05-25,Costa Rica,0,12,930,"rgb(93, 105, 177)"
6037,2020-05-26,Costa Rica,0,21,951,"rgb(93, 105, 177)"
6038,2020-05-27,Costa Rica,0,5,956,"rgb(93, 105, 177)"
6039,2020-05-28,Costa Rica,0,28,984,"rgb(93, 105, 177)"
6040,2020-05-29,Costa Rica,0,16,1000,"rgb(93, 105, 177)"
6041,2020-05-30,Costa Rica,0,22,1022,"rgb(93, 105, 177)"
6042,2020-05-31,Costa Rica,0,25,1047,"rgb(93, 105, 177)"
6043,2020-06-01,Costa Rica,0,9,1056,"rgb(93, 105, 177)"
6044,2020-06-02,Costa Rica,0,28,1084,"rgb(93, 105, 177)"
6045,2020-06-03,Costa Rica,0,21,1105,"rgb(93, 105, 177)"
6046,2020-06-04,Costa Rica,0,52,1157,"rgb(93, 105, 177)"
6047,2020-06-05,Costa Rica,0,37,1194,"rgb(93, 105, 177)"
6048,2020-06-06,Costa Rica,0,34,1228,"rgb(93, 105, 177)"
6049,2020-06-07,Costa Rica,0,35,1263,"rgb(93, 105, 177)"
6050,2020-06-08,Costa Rica,0,55,1318,"rgb(93, 105, 177)"
6051,2020-06-09,Costa Rica,0,24,1342,"rgb(93, 105, 177)"
6052,2020-06-10,Costa Rica,1,33,1375,"rgb(93, 105, 177)"
6053,2020-06-11,Costa Rica,1,86,1461,"rgb(93, 105, 177)"
6054,2020-06-12,Costa Rica,0,77,1538,"rgb(93, 105, 177)"
6055,2020-06-13,Costa Rica,0,74,1612,"rgb(93, 105, 177)"
6056,2020-06-14,Costa Rica,0,50,1662,"rgb(93, 105, 177)"
6057,2020-06-15,Costa Rica,0,53,1715,"rgb(93, 105, 177)"
6058,2020-06-16,Costa Rica,0,29,1744,"rgb(93, 105, 177)"
6059,2020-06-17,Costa Rica,0,25,1769,"rgb(93, 105, 177)"
6060,2020-06-18,Costa Rica,0,102,1871,"rgb(93, 105, 177)"
6061,2020-06-19,Costa Rica,0,0,1871,"rgb(93, 105, 177)"
6062,2020-06-20,Costa Rica,0,187,2058,"rgb(93, 105, 177)"
6063,2020-06-21,Costa Rica,0,69,2127,"rgb(93, 105, 177)"
6064,2020-06-22,Costa Rica,0,86,2213,"rgb(93, 105, 177)"
6065,2020-06-23,Costa Rica,0,64,2277,"rgb(93, 105, 177)"
6066,2020-06-24,Costa Rica,0,91,2368,"rgb(93, 105, 177)"
6067,2020-06-25,Costa Rica,0,147,2515,"rgb(93, 105, 177)"
6068,2020-06-26,Costa Rica,0,169,2684,"rgb(93, 105, 177)"
6069,2020-06-27,Costa Rica,0,152,2836,"rgb(93, 105, 177)"
6070,2020-06-28,Costa Rica,0,143,2979,"rgb(93, 105, 177)"
6071,2020-06-29,Costa Rica,3,151,3130,"rgb(93, 105, 177)"
6072,2020-06-30,Costa Rica,0,139,3269,"rgb(93, 105, 177)"
6073,2020-07-01,Costa Rica,1,190,3459,"rgb(93, 105, 177)"
6074,2020-07-02,Costa Rica,1,294,3753,"rgb(93, 105, 177)"
6075,2020-07-03,Costa Rica,0,270,4023,"rgb(93, 105, 177)"
6076,2020-07-04,Costa Rica,1,288,4311,"rgb(93, 105, 177)"
6077,2020-07-05,Costa Rica,0,310,4621,"rgb(93, 105, 177)"
6078,2020-07-06,Costa Rica,1,375,4996,"rgb(93, 105, 177)"
6079,2020-07-07,Costa Rica,4,245,5241,"rgb(93, 105, 177)"
6080,2020-07-08,Costa Rica,0,245,5486,"rgb(93, 105, 177)"
6081,2020-07-09,Costa Rica,1,350,5836,"rgb(93, 105, 177)"
6082,2020-07-10,Costa Rica,1,649,6485,"rgb(93, 105, 177)"
6083,2020-07-11,Costa Rica,1,360,6845,"rgb(93, 105, 177)"
6084,2020-07-12,Costa Rica,2,386,7231,"rgb(93, 105, 177)"
6085,2020-07-13,Costa Rica,2,365,7596,"rgb(93, 105, 177)"
6086,2020-03-12,Cuba,0,3,3,"rgb(82, 188, 163)"
6087,2020-03-14,Cuba,0,1,4,"rgb(82, 188, 163)"
6088,2020-03-15,Cuba,0,0,4,"rgb(82, 188, 163)"
6089,2020-03-18,Cuba,0,3,7,"rgb(82, 188, 163)"
6090,2020-03-19,Cuba,1,4,11,"rgb(82, 188, 163)"
6091,2020-03-20,Cuba,0,5,16,"rgb(82, 188, 163)"
6092,2020-03-21,Cuba,0,5,21,"rgb(82, 188, 163)"
6093,2020-03-22,Cuba,0,4,25,"rgb(82, 188, 163)"
6094,2020-03-23,Cuba,0,10,35,"rgb(82, 188, 163)"
6095,2020-03-24,Cuba,0,5,40,"rgb(82, 188, 163)"
6096,2020-03-25,Cuba,0,8,48,"rgb(82, 188, 163)"
6097,2020-03-26,Cuba,0,9,57,"rgb(82, 188, 163)"
6098,2020-03-27,Cuba,1,10,67,"rgb(82, 188, 163)"
6099,2020-03-28,Cuba,0,13,80,"rgb(82, 188, 163)"
6100,2020-03-29,Cuba,1,39,119,"rgb(82, 188, 163)"
6101,2020-03-30,Cuba,0,20,139,"rgb(82, 188, 163)"
6102,2020-03-31,Cuba,1,31,170,"rgb(82, 188, 163)"
6103,2020-04-01,Cuba,2,16,186,"rgb(82, 188, 163)"
6104,2020-04-02,Cuba,0,26,212,"rgb(82, 188, 163)"
6105,2020-04-03,Cuba,0,21,233,"rgb(82, 188, 163)"
6106,2020-04-04,Cuba,0,36,269,"rgb(82, 188, 163)"
6107,2020-04-05,Cuba,0,19,288,"rgb(82, 188, 163)"
6108,2020-04-06,Cuba,2,32,320,"rgb(82, 188, 163)"
6109,2020-04-07,Cuba,1,30,350,"rgb(82, 188, 163)"
6110,2020-04-08,Cuba,2,46,396,"rgb(82, 188, 163)"
6111,2020-04-09,Cuba,1,61,457,"rgb(82, 188, 163)"
6112,2020-04-10,Cuba,3,58,515,"rgb(82, 188, 163)"
6113,2020-04-11,Cuba,0,49,564,"rgb(82, 188, 163)"
6114,2020-04-12,Cuba,1,56,620,"rgb(82, 188, 163)"
6115,2020-04-13,Cuba,2,49,669,"rgb(82, 188, 163)"
6116,2020-04-14,Cuba,3,57,726,"rgb(82, 188, 163)"
6117,2020-04-15,Cuba,0,40,766,"rgb(82, 188, 163)"
6118,2020-04-16,Cuba,3,48,814,"rgb(82, 188, 163)"
6119,2020-04-17,Cuba,3,48,862,"rgb(82, 188, 163)"
6120,2020-04-18,Cuba,4,61,923,"rgb(82, 188, 163)"
6121,2020-04-19,Cuba,1,63,986,"rgb(82, 188, 163)"
6122,2020-04-20,Cuba,2,49,1035,"rgb(82, 188, 163)"
6123,2020-04-21,Cuba,2,52,1087,"rgb(82, 188, 163)"
6124,2020-04-22,Cuba,2,50,1137,"rgb(82, 188, 163)"
6125,2020-04-23,Cuba,2,52,1189,"rgb(82, 188, 163)"
6126,2020-04-24,Cuba,3,46,1235,"rgb(82, 188, 163)"
6127,2020-04-25,Cuba,6,50,1285,"rgb(82, 188, 163)"
6128,2020-04-26,Cuba,2,52,1337,"rgb(82, 188, 163)"
6129,2020-04-27,Cuba,3,32,1369,"rgb(82, 188, 163)"
6130,2020-04-28,Cuba,2,20,1389,"rgb(82, 188, 163)"
6131,2020-04-29,Cuba,2,48,1437,"rgb(82, 188, 163)"
6132,2020-04-30,Cuba,0,30,1467,"rgb(82, 188, 163)"
6133,2020-05-01,Cuba,3,34,1501,"rgb(82, 188, 163)"
6134,2020-05-02,Cuba,3,36,1537,"rgb(82, 188, 163)"
6135,2020-05-03,Cuba,2,74,1611,"rgb(82, 188, 163)"
6136,2020-05-04,Cuba,1,38,1649,"rgb(82, 188, 163)"
6137,2020-05-05,Cuba,2,19,1668,"rgb(82, 188, 163)"
6138,2020-05-06,Cuba,0,17,1685,"rgb(82, 188, 163)"
6139,2020-05-07,Cuba,0,18,1703,"rgb(82, 188, 163)"
6140,2020-05-08,Cuba,4,26,1729,"rgb(82, 188, 163)"
6141,2020-05-09,Cuba,1,12,1741,"rgb(82, 188, 163)"
6142,2020-05-10,Cuba,0,13,1754,"rgb(82, 188, 163)"
6143,2020-05-11,Cuba,3,12,1766,"rgb(82, 188, 163)"
6144,2020-05-12,Cuba,0,17,1783,"rgb(82, 188, 163)"
6145,2020-05-13,Cuba,1,21,1804,"rgb(82, 188, 163)"
6146,2020-05-14,Cuba,1,6,1810,"rgb(82, 188, 163)"
6147,2020-05-15,Cuba,0,20,1830,"rgb(82, 188, 163)"
6148,2020-05-16,Cuba,0,10,1840,"rgb(82, 188, 163)"
6149,2020-05-17,Cuba,0,22,1862,"rgb(82, 188, 163)"
6150,2020-05-18,Cuba,0,10,1872,"rgb(82, 188, 163)"
6151,2020-05-19,Cuba,0,9,1881,"rgb(82, 188, 163)"
6152,2020-05-20,Cuba,0,6,1887,"rgb(82, 188, 163)"
6153,2020-05-21,Cuba,0,13,1900,"rgb(82, 188, 163)"
6154,2020-05-22,Cuba,1,8,1908,"rgb(82, 188, 163)"
6155,2020-05-23,Cuba,1,8,1916,"rgb(82, 188, 163)"
6156,2020-05-24,Cuba,0,15,1931,"rgb(82, 188, 163)"
6157,2020-05-25,Cuba,1,10,1941,"rgb(82, 188, 163)"
6158,2020-05-26,Cuba,0,6,1947,"rgb(82, 188, 163)"
6159,2020-05-27,Cuba,0,16,1963,"rgb(82, 188, 163)"
6160,2020-05-28,Cuba,0,11,1974,"rgb(82, 188, 163)"
6161,2020-05-29,Cuba,0,9,1983,"rgb(82, 188, 163)"
6162,2020-05-30,Cuba,0,22,2005,"rgb(82, 188, 163)"
6163,2020-05-31,Cuba,1,20,2025,"rgb(82, 188, 163)"
6164,2020-06-01,Cuba,0,20,2045,"rgb(82, 188, 163)"
6165,2020-06-02,Cuba,0,38,2083,"rgb(82, 188, 163)"
6166,2020-06-03,Cuba,0,9,2092,"rgb(82, 188, 163)"
6167,2020-06-04,Cuba,0,15,2107,"rgb(82, 188, 163)"
6168,2020-06-05,Cuba,0,12,2119,"rgb(82, 188, 163)"
6169,2020-06-06,Cuba,0,14,2133,"rgb(82, 188, 163)"
6170,2020-06-07,Cuba,0,40,2173,"rgb(82, 188, 163)"
6171,2020-06-08,Cuba,0,18,2191,"rgb(82, 188, 163)"
6172,2020-06-09,Cuba,0,9,2200,"rgb(82, 188, 163)"
6173,2020-06-10,Cuba,0,5,2205,"rgb(82, 188, 163)"
6174,2020-06-11,Cuba,0,6,2211,"rgb(82, 188, 163)"
6175,2020-06-12,Cuba,1,8,2219,"rgb(82, 188, 163)"
6176,2020-06-13,Cuba,0,14,2233,"rgb(82, 188, 163)"
6177,2020-06-14,Cuba,0,5,2238,"rgb(82, 188, 163)"
6178,2020-06-15,Cuba,0,10,2248,"rgb(82, 188, 163)"
6179,2020-06-16,Cuba,0,14,2262,"rgb(82, 188, 163)"
6180,2020-06-17,Cuba,0,11,2273,"rgb(82, 188, 163)"
6181,2020-06-18,Cuba,0,7,2280,"rgb(82, 188, 163)"
6182,2020-06-19,Cuba,1,15,2295,"rgb(82, 188, 163)"
6183,2020-06-20,Cuba,0,10,2305,"rgb(82, 188, 163)"
6184,2020-06-21,Cuba,0,4,2309,"rgb(82, 188, 163)"
6185,2020-06-22,Cuba,0,3,2312,"rgb(82, 188, 163)"
6186,2020-06-23,Cuba,0,3,2315,"rgb(82, 188, 163)"
6187,2020-06-24,Cuba,0,3,2318,"rgb(82, 188, 163)"
6188,2020-06-25,Cuba,0,1,2319,"rgb(82, 188, 163)"
6189,2020-06-26,Cuba,0,2,2321,"rgb(82, 188, 163)"
6190,2020-06-27,Cuba,0,4,2325,"rgb(82, 188, 163)"
6191,2020-06-28,Cuba,1,5,2330,"rgb(82, 188, 163)"
6192,2020-06-29,Cuba,0,2,2332,"rgb(82, 188, 163)"
6193,2020-06-30,Cuba,0,8,2340,"rgb(82, 188, 163)"
6194,2020-07-01,Cuba,0,1,2341,"rgb(82, 188, 163)"
6195,2020-07-02,Cuba,0,7,2348,"rgb(82, 188, 163)"
6196,2020-07-03,Cuba,0,5,2353,"rgb(82, 188, 163)"
6197,2020-07-04,Cuba,0,8,2361,"rgb(82, 188, 163)"
6198,2020-07-05,Cuba,0,8,2369,"rgb(82, 188, 163)"
6199,2020-07-06,Cuba,0,3,2372,"rgb(82, 188, 163)"
6200,2020-07-07,Cuba,0,8,2380,"rgb(82, 188, 163)"
6201,2020-07-08,Cuba,0,15,2395,"rgb(82, 188, 163)"
6202,2020-07-09,Cuba,0,4,2399,"rgb(82, 188, 163)"
6203,2020-07-10,Cuba,0,4,2403,"rgb(82, 188, 163)"
6204,2020-07-11,Cuba,0,10,2413,"rgb(82, 188, 163)"
6205,2020-07-12,Cuba,1,7,2420,"rgb(82, 188, 163)"
6206,2020-07-13,Cuba,0,6,2426,"rgb(82, 188, 163)"
6207,2020-03-21,Cabo Verde,0,2,2,"rgb(153, 201, 69)"
6208,2020-03-22,Cabo Verde,0,1,3,"rgb(153, 201, 69)"
6209,2020-03-23,Cabo Verde,0,0,3,"rgb(153, 201, 69)"
6210,2020-03-24,Cabo Verde,0,0,3,"rgb(153, 201, 69)"
6211,2020-03-25,Cabo Verde,1,0,3,"rgb(153, 201, 69)"
6212,2020-03-26,Cabo Verde,0,1,4,"rgb(153, 201, 69)"
6213,2020-03-27,Cabo Verde,0,1,5,"rgb(153, 201, 69)"
6214,2020-03-28,Cabo Verde,0,0,5,"rgb(153, 201, 69)"
6215,2020-03-29,Cabo Verde,0,0,5,"rgb(153, 201, 69)"
6216,2020-03-30,Cabo Verde,0,0,5,"rgb(153, 201, 69)"
6217,2020-03-31,Cabo Verde,0,0,5,"rgb(153, 201, 69)"
6218,2020-04-01,Cabo Verde,0,1,6,"rgb(153, 201, 69)"
6219,2020-04-02,Cabo Verde,0,0,6,"rgb(153, 201, 69)"
6220,2020-04-03,Cabo Verde,0,0,6,"rgb(153, 201, 69)"
6221,2020-04-04,Cabo Verde,0,0,6,"rgb(153, 201, 69)"
6222,2020-04-05,Cabo Verde,0,1,7,"rgb(153, 201, 69)"
6223,2020-04-06,Cabo Verde,0,0,7,"rgb(153, 201, 69)"
6224,2020-04-07,Cabo Verde,0,0,7,"rgb(153, 201, 69)"
6225,2020-04-08,Cabo Verde,0,0,7,"rgb(153, 201, 69)"
6226,2020-04-09,Cabo Verde,0,0,7,"rgb(153, 201, 69)"
6227,2020-04-10,Cabo Verde,0,0,7,"rgb(153, 201, 69)"
6228,2020-04-11,Cabo Verde,0,0,7,"rgb(153, 201, 69)"
6229,2020-04-12,Cabo Verde,0,1,8,"rgb(153, 201, 69)"
6230,2020-04-13,Cabo Verde,0,2,10,"rgb(153, 201, 69)"
6231,2020-04-14,Cabo Verde,0,0,10,"rgb(153, 201, 69)"
6232,2020-04-15,Cabo Verde,0,1,11,"rgb(153, 201, 69)"
6233,2020-04-16,Cabo Verde,0,44,55,"rgb(153, 201, 69)"
6234,2020-04-17,Cabo Verde,0,0,55,"rgb(153, 201, 69)"
6235,2020-04-18,Cabo Verde,0,1,56,"rgb(153, 201, 69)"
6236,2020-04-19,Cabo Verde,0,2,58,"rgb(153, 201, 69)"
6237,2020-04-20,Cabo Verde,0,3,61,"rgb(153, 201, 69)"
6238,2020-04-21,Cabo Verde,0,6,67,"rgb(153, 201, 69)"
6239,2020-04-22,Cabo Verde,0,0,67,"rgb(153, 201, 69)"
6240,2020-04-23,Cabo Verde,0,6,73,"rgb(153, 201, 69)"
6241,2020-04-24,Cabo Verde,0,9,82,"rgb(153, 201, 69)"
6242,2020-04-25,Cabo Verde,0,6,88,"rgb(153, 201, 69)"
6243,2020-04-26,Cabo Verde,0,2,90,"rgb(153, 201, 69)"
6244,2020-04-27,Cabo Verde,0,16,106,"rgb(153, 201, 69)"
6245,2020-04-28,Cabo Verde,0,3,109,"rgb(153, 201, 69)"
6246,2020-04-29,Cabo Verde,0,4,113,"rgb(153, 201, 69)"
6247,2020-04-30,Cabo Verde,0,0,113,"rgb(153, 201, 69)"
6248,2020-05-01,Cabo Verde,0,8,121,"rgb(153, 201, 69)"
6249,2020-05-02,Cabo Verde,1,2,123,"rgb(153, 201, 69)"
6250,2020-05-03,Cabo Verde,0,29,152,"rgb(153, 201, 69)"
6251,2020-05-04,Cabo Verde,0,13,165,"rgb(153, 201, 69)"
6252,2020-05-05,Cabo Verde,0,10,175,"rgb(153, 201, 69)"
6253,2020-05-06,Cabo Verde,0,11,186,"rgb(153, 201, 69)"
6254,2020-05-07,Cabo Verde,0,5,191,"rgb(153, 201, 69)"
6255,2020-05-08,Cabo Verde,0,27,218,"rgb(153, 201, 69)"
6256,2020-05-09,Cabo Verde,0,12,230,"rgb(153, 201, 69)"
6257,2020-05-10,Cabo Verde,0,6,236,"rgb(153, 201, 69)"
6258,2020-05-11,Cabo Verde,0,10,246,"rgb(153, 201, 69)"
6259,2020-05-12,Cabo Verde,0,14,260,"rgb(153, 201, 69)"
6260,2020-05-13,Cabo Verde,0,10,270,"rgb(153, 201, 69)"
6261,2020-05-14,Cabo Verde,0,19,289,"rgb(153, 201, 69)"
6262,2020-05-15,Cabo Verde,0,26,315,"rgb(153, 201, 69)"
6263,2020-05-16,Cabo Verde,0,11,326,"rgb(153, 201, 69)"
6264,2020-05-17,Cabo Verde,1,2,328,"rgb(153, 201, 69)"
6265,2020-05-18,Cabo Verde,0,0,328,"rgb(153, 201, 69)"
6266,2020-05-19,Cabo Verde,0,0,328,"rgb(153, 201, 69)"
6267,2020-05-20,Cabo Verde,0,7,335,"rgb(153, 201, 69)"
6268,2020-05-21,Cabo Verde,0,14,349,"rgb(153, 201, 69)"
6269,2020-05-22,Cabo Verde,0,7,356,"rgb(153, 201, 69)"
6270,2020-05-23,Cabo Verde,0,6,362,"rgb(153, 201, 69)"
6271,2020-05-24,Cabo Verde,0,9,371,"rgb(153, 201, 69)"
6272,2020-05-25,Cabo Verde,0,9,380,"rgb(153, 201, 69)"
6273,2020-05-26,Cabo Verde,0,10,390,"rgb(153, 201, 69)"
6274,2020-05-27,Cabo Verde,1,0,390,"rgb(153, 201, 69)"
6275,2020-05-28,Cabo Verde,0,0,390,"rgb(153, 201, 69)"
6276,2020-05-29,Cabo Verde,0,0,390,"rgb(153, 201, 69)"
6277,2020-05-30,Cabo Verde,0,15,405,"rgb(153, 201, 69)"
6278,2020-05-31,Cabo Verde,0,16,421,"rgb(153, 201, 69)"
6279,2020-06-01,Cabo Verde,0,14,435,"rgb(153, 201, 69)"
6280,2020-06-02,Cabo Verde,0,23,458,"rgb(153, 201, 69)"
6281,2020-06-03,Cabo Verde,1,8,466,"rgb(153, 201, 69)"
6282,2020-06-04,Cabo Verde,0,11,477,"rgb(153, 201, 69)"
6283,2020-06-05,Cabo Verde,0,25,502,"rgb(153, 201, 69)"
6284,2020-06-06,Cabo Verde,0,34,536,"rgb(153, 201, 69)"
6285,2020-06-07,Cabo Verde,0,6,542,"rgb(153, 201, 69)"
6286,2020-06-08,Cabo Verde,0,12,554,"rgb(153, 201, 69)"
6287,2020-06-09,Cabo Verde,0,13,567,"rgb(153, 201, 69)"
6288,2020-06-10,Cabo Verde,0,18,585,"rgb(153, 201, 69)"
6289,2020-06-11,Cabo Verde,0,30,615,"rgb(153, 201, 69)"
6290,2020-06-12,Cabo Verde,1,42,657,"rgb(153, 201, 69)"
6291,2020-06-13,Cabo Verde,0,40,697,"rgb(153, 201, 69)"
6292,2020-06-14,Cabo Verde,0,29,726,"rgb(153, 201, 69)"
6293,2020-06-15,Cabo Verde,0,24,750,"rgb(153, 201, 69)"
6294,2020-06-16,Cabo Verde,1,10,760,"rgb(153, 201, 69)"
6295,2020-06-17,Cabo Verde,0,21,781,"rgb(153, 201, 69)"
6296,2020-06-18,Cabo Verde,0,11,792,"rgb(153, 201, 69)"
6297,2020-06-19,Cabo Verde,0,31,823,"rgb(153, 201, 69)"
6298,2020-06-20,Cabo Verde,1,25,848,"rgb(153, 201, 69)"
6299,2020-06-21,Cabo Verde,0,15,863,"rgb(153, 201, 69)"
6300,2020-06-22,Cabo Verde,0,27,890,"rgb(153, 201, 69)"
6301,2020-06-23,Cabo Verde,0,54,944,"rgb(153, 201, 69)"
6302,2020-06-24,Cabo Verde,0,38,982,"rgb(153, 201, 69)"
6303,2020-06-25,Cabo Verde,0,17,999,"rgb(153, 201, 69)"
6304,2020-06-26,Cabo Verde,0,4,1003,"rgb(153, 201, 69)"
6305,2020-06-27,Cabo Verde,2,24,1027,"rgb(153, 201, 69)"
6306,2020-06-28,Cabo Verde,2,64,1091,"rgb(153, 201, 69)"
6307,2020-06-29,Cabo Verde,0,64,1155,"rgb(153, 201, 69)"
6308,2020-06-30,Cabo Verde,0,10,1165,"rgb(153, 201, 69)"
6309,2020-07-01,Cabo Verde,3,62,1227,"rgb(153, 201, 69)"
6310,2020-07-02,Cabo Verde,0,40,1267,"rgb(153, 201, 69)"
6311,2020-07-03,Cabo Verde,0,34,1301,"rgb(153, 201, 69)"
6312,2020-07-04,Cabo Verde,0,81,1382,"rgb(153, 201, 69)"
6313,2020-07-05,Cabo Verde,1,38,1420,"rgb(153, 201, 69)"
6314,2020-07-06,Cabo Verde,1,31,1451,"rgb(153, 201, 69)"
6315,2020-07-07,Cabo Verde,0,12,1463,"rgb(153, 201, 69)"
6316,2020-07-08,Cabo Verde,1,36,1499,"rgb(153, 201, 69)"
6317,2020-07-09,Cabo Verde,0,43,1542,"rgb(153, 201, 69)"
6318,2020-07-10,Cabo Verde,1,11,1553,"rgb(153, 201, 69)"
6319,2020-07-11,Cabo Verde,0,0,1553,"rgb(153, 201, 69)"
6320,2020-07-12,Cabo Verde,0,38,1591,"rgb(153, 201, 69)"
6321,2020-07-13,Cabo Verde,0,107,1698,"rgb(153, 201, 69)"
6322,2020-03-13,Curaçao,0,1,1,"rgb(204, 97, 176)"
6323,2020-03-20,Curaçao,0,2,3,"rgb(204, 97, 176)"
6324,2020-03-24,Curaçao,0,3,6,"rgb(204, 97, 176)"
6325,2020-03-26,Curaçao,1,0,6,"rgb(204, 97, 176)"
6326,2020-03-27,Curaçao,0,1,7,"rgb(204, 97, 176)"
6327,2020-03-28,Curaçao,0,1,8,"rgb(204, 97, 176)"
6328,2020-03-29,Curaçao,0,0,8,"rgb(204, 97, 176)"
6329,2020-03-30,Curaçao,0,1,9,"rgb(204, 97, 176)"
6330,2020-04-01,Curaçao,0,2,11,"rgb(204, 97, 176)"
6331,2020-04-02,Curaçao,0,0,11,"rgb(204, 97, 176)"
6332,2020-04-03,Curaçao,0,0,11,"rgb(204, 97, 176)"
6333,2020-04-04,Curaçao,0,0,11,"rgb(204, 97, 176)"
6334,2020-04-05,Curaçao,0,0,11,"rgb(204, 97, 176)"
6335,2020-04-06,Curaçao,0,0,11,"rgb(204, 97, 176)"
6336,2020-04-07,Curaçao,0,2,13,"rgb(204, 97, 176)"
6337,2020-04-08,Curaçao,0,0,13,"rgb(204, 97, 176)"
6338,2020-04-09,Curaçao,0,1,14,"rgb(204, 97, 176)"
6339,2020-04-10,Curaçao,0,0,14,"rgb(204, 97, 176)"
6340,2020-04-11,Curaçao,0,0,14,"rgb(204, 97, 176)"
6341,2020-04-12,Curaçao,0,0,14,"rgb(204, 97, 176)"
6342,2020-04-13,Curaçao,0,0,14,"rgb(204, 97, 176)"
6343,2020-04-14,Curaçao,0,0,14,"rgb(204, 97, 176)"
6344,2020-04-15,Curaçao,0,0,14,"rgb(204, 97, 176)"
6345,2020-04-16,Curaçao,0,0,14,"rgb(204, 97, 176)"
6346,2020-04-17,Curaçao,0,0,14,"rgb(204, 97, 176)"
6347,2020-04-18,Curaçao,0,0,14,"rgb(204, 97, 176)"
6348,2020-04-19,Curaçao,0,0,14,"rgb(204, 97, 176)"
6349,2020-04-20,Curaçao,0,0,14,"rgb(204, 97, 176)"
6350,2020-04-21,Curaçao,0,0,14,"rgb(204, 97, 176)"
6351,2020-04-22,Curaçao,0,0,14,"rgb(204, 97, 176)"
6352,2020-04-23,Curaçao,0,0,14,"rgb(204, 97, 176)"
6353,2020-04-24,Curaçao,0,0,14,"rgb(204, 97, 176)"
6354,2020-04-25,Curaçao,0,2,16,"rgb(204, 97, 176)"
6355,2020-04-26,Curaçao,0,0,16,"rgb(204, 97, 176)"
6356,2020-04-27,Curaçao,0,0,16,"rgb(204, 97, 176)"
6357,2020-04-28,Curaçao,0,0,16,"rgb(204, 97, 176)"
6358,2020-04-29,Curaçao,0,0,16,"rgb(204, 97, 176)"
6359,2020-04-30,Curaçao,0,0,16,"rgb(204, 97, 176)"
6360,2020-05-01,Curaçao,0,0,16,"rgb(204, 97, 176)"
6361,2020-05-02,Curaçao,0,0,16,"rgb(204, 97, 176)"
6362,2020-05-03,Curaçao,0,0,16,"rgb(204, 97, 176)"
6363,2020-05-04,Curaçao,0,0,16,"rgb(204, 97, 176)"
6364,2020-05-05,Curaçao,0,0,16,"rgb(204, 97, 176)"
6365,2020-05-06,Curaçao,0,0,16,"rgb(204, 97, 176)"
6366,2020-05-07,Curaçao,0,0,16,"rgb(204, 97, 176)"
6367,2020-05-08,Curaçao,0,0,16,"rgb(204, 97, 176)"
6368,2020-05-09,Curaçao,0,0,16,"rgb(204, 97, 176)"
6369,2020-05-10,Curaçao,0,0,16,"rgb(204, 97, 176)"
6370,2020-05-11,Curaçao,0,0,16,"rgb(204, 97, 176)"
6371,2020-05-12,Curaçao,0,0,16,"rgb(204, 97, 176)"
6372,2020-05-13,Curaçao,0,0,16,"rgb(204, 97, 176)"
6373,2020-05-14,Curaçao,0,0,16,"rgb(204, 97, 176)"
6374,2020-05-15,Curaçao,0,0,16,"rgb(204, 97, 176)"
6375,2020-05-16,Curaçao,0,0,16,"rgb(204, 97, 176)"
6376,2020-05-17,Curaçao,0,0,16,"rgb(204, 97, 176)"
6377,2020-05-18,Curaçao,0,0,16,"rgb(204, 97, 176)"
6378,2020-05-19,Curaçao,0,0,16,"rgb(204, 97, 176)"
6379,2020-05-20,Curaçao,0,0,16,"rgb(204, 97, 176)"
6380,2020-05-21,Curaçao,0,0,16,"rgb(204, 97, 176)"
6381,2020-05-22,Curaçao,0,0,16,"rgb(204, 97, 176)"
6382,2020-05-23,Curaçao,0,0,16,"rgb(204, 97, 176)"
6383,2020-05-24,Curaçao,0,0,16,"rgb(204, 97, 176)"
6384,2020-05-25,Curaçao,0,1,17,"rgb(204, 97, 176)"
6385,2020-05-26,Curaçao,0,1,18,"rgb(204, 97, 176)"
6386,2020-05-27,Curaçao,0,0,18,"rgb(204, 97, 176)"
6387,2020-05-28,Curaçao,0,0,18,"rgb(204, 97, 176)"
6388,2020-05-29,Curaçao,0,1,19,"rgb(204, 97, 176)"
6389,2020-05-30,Curaçao,0,0,19,"rgb(204, 97, 176)"
6390,2020-05-31,Curaçao,0,0,19,"rgb(204, 97, 176)"
6391,2020-06-01,Curaçao,0,0,19,"rgb(204, 97, 176)"
6392,2020-06-02,Curaçao,0,1,20,"rgb(204, 97, 176)"
6393,2020-06-03,Curaçao,0,0,20,"rgb(204, 97, 176)"
6394,2020-06-04,Curaçao,0,0,20,"rgb(204, 97, 176)"
6395,2020-06-05,Curaçao,0,1,21,"rgb(204, 97, 176)"
6396,2020-06-06,Curaçao,0,0,21,"rgb(204, 97, 176)"
6397,2020-06-07,Curaçao,0,0,21,"rgb(204, 97, 176)"
6398,2020-06-08,Curaçao,0,0,21,"rgb(204, 97, 176)"
6399,2020-06-09,Curaçao,0,0,21,"rgb(204, 97, 176)"
6400,2020-06-10,Curaçao,0,0,21,"rgb(204, 97, 176)"
6401,2020-06-11,Curaçao,0,0,21,"rgb(204, 97, 176)"
6402,2020-06-12,Curaçao,0,1,22,"rgb(204, 97, 176)"
6403,2020-06-13,Curaçao,0,0,22,"rgb(204, 97, 176)"
6404,2020-06-14,Curaçao,0,0,22,"rgb(204, 97, 176)"
6405,2020-06-15,Curaçao,0,0,22,"rgb(204, 97, 176)"
6406,2020-06-16,Curaçao,0,0,22,"rgb(204, 97, 176)"
6407,2020-06-17,Curaçao,0,0,22,"rgb(204, 97, 176)"
6408,2020-06-18,Curaçao,0,1,23,"rgb(204, 97, 176)"
6409,2020-06-19,Curaçao,0,0,23,"rgb(204, 97, 176)"
6410,2020-06-20,Curaçao,0,0,23,"rgb(204, 97, 176)"
6411,2020-06-21,Curaçao,0,0,23,"rgb(204, 97, 176)"
6412,2020-06-22,Curaçao,0,0,23,"rgb(204, 97, 176)"
6413,2020-06-23,Curaçao,0,0,23,"rgb(204, 97, 176)"
6414,2020-06-24,Curaçao,0,1,24,"rgb(204, 97, 176)"
6415,2020-06-25,Curaçao,0,0,24,"rgb(204, 97, 176)"
6416,2020-06-26,Curaçao,0,0,24,"rgb(204, 97, 176)"
6417,2020-06-27,Curaçao,0,0,24,"rgb(204, 97, 176)"
6418,2020-06-28,Curaçao,0,0,24,"rgb(204, 97, 176)"
6419,2020-06-29,Curaçao,0,0,24,"rgb(204, 97, 176)"
6420,2020-06-30,Curaçao,0,0,24,"rgb(204, 97, 176)"
6421,2020-07-01,Curaçao,0,1,25,"rgb(204, 97, 176)"
6422,2020-07-02,Curaçao,0,0,25,"rgb(204, 97, 176)"
6423,2020-07-03,Curaçao,0,0,25,"rgb(204, 97, 176)"
6424,2020-07-04,Curaçao,0,0,25,"rgb(204, 97, 176)"
6425,2020-07-05,Curaçao,0,0,25,"rgb(204, 97, 176)"
6426,2020-07-06,Curaçao,0,0,25,"rgb(204, 97, 176)"
6427,2020-07-07,Curaçao,0,0,25,"rgb(204, 97, 176)"
6428,2020-07-08,Curaçao,0,0,25,"rgb(204, 97, 176)"
6429,2020-07-09,Curaçao,0,0,25,"rgb(204, 97, 176)"
6430,2020-07-10,Curaçao,0,0,25,"rgb(204, 97, 176)"
6431,2020-07-11,Curaçao,0,0,25,"rgb(204, 97, 176)"
6432,2020-07-12,Curaçao,0,0,25,"rgb(204, 97, 176)"
6433,2020-07-13,Curaçao,0,0,25,"rgb(204, 97, 176)"
6434,2020-03-10,Cyprus,0,2,2,"rgb(36, 121, 108)"
6435,2020-03-12,Cyprus,0,4,6,"rgb(36, 121, 108)"
6436,2020-03-14,Cyprus,0,8,14,"rgb(36, 121, 108)"
6437,2020-03-15,Cyprus,0,7,21,"rgb(36, 121, 108)"
6438,2020-03-16,Cyprus,0,9,30,"rgb(36, 121, 108)"
6439,2020-03-17,Cyprus,0,10,40,"rgb(36, 121, 108)"
6440,2020-03-18,Cyprus,0,0,40,"rgb(36, 121, 108)"
6441,2020-03-19,Cyprus,0,18,58,"rgb(36, 121, 108)"
6442,2020-03-20,Cyprus,0,0,58,"rgb(36, 121, 108)"
6443,2020-03-21,Cyprus,0,9,67,"rgb(36, 121, 108)"
6444,2020-03-22,Cyprus,0,17,84,"rgb(36, 121, 108)"
6445,2020-03-23,Cyprus,0,11,95,"rgb(36, 121, 108)"
6446,2020-03-24,Cyprus,0,21,116,"rgb(36, 121, 108)"
6447,2020-03-25,Cyprus,3,8,124,"rgb(36, 121, 108)"
6448,2020-03-26,Cyprus,0,8,132,"rgb(36, 121, 108)"
6449,2020-03-27,Cyprus,0,14,146,"rgb(36, 121, 108)"
6450,2020-03-28,Cyprus,2,16,162,"rgb(36, 121, 108)"
6451,2020-03-29,Cyprus,0,17,179,"rgb(36, 121, 108)"
6452,2020-03-30,Cyprus,1,35,214,"rgb(36, 121, 108)"
6453,2020-03-31,Cyprus,1,16,230,"rgb(36, 121, 108)"
6454,2020-04-01,Cyprus,1,32,262,"rgb(36, 121, 108)"
6455,2020-04-02,Cyprus,1,58,320,"rgb(36, 121, 108)"
6456,2020-04-03,Cyprus,0,36,356,"rgb(36, 121, 108)"
6457,2020-04-04,Cyprus,0,40,396,"rgb(36, 121, 108)"
6458,2020-04-05,Cyprus,0,30,426,"rgb(36, 121, 108)"
6459,2020-04-06,Cyprus,0,20,446,"rgb(36, 121, 108)"
6460,2020-04-07,Cyprus,0,19,465,"rgb(36, 121, 108)"
6461,2020-04-08,Cyprus,0,29,494,"rgb(36, 121, 108)"
6462,2020-04-09,Cyprus,0,32,526,"rgb(36, 121, 108)"
6463,2020-04-10,Cyprus,1,38,564,"rgb(36, 121, 108)"
6464,2020-04-11,Cyprus,0,31,595,"rgb(36, 121, 108)"
6465,2020-04-12,Cyprus,0,21,616,"rgb(36, 121, 108)"
6466,2020-04-13,Cyprus,1,17,633,"rgb(36, 121, 108)"
6467,2020-04-14,Cyprus,1,29,662,"rgb(36, 121, 108)"
6468,2020-04-15,Cyprus,0,33,695,"rgb(36, 121, 108)"
6469,2020-04-16,Cyprus,0,20,715,"rgb(36, 121, 108)"
6470,2020-04-17,Cyprus,0,20,735,"rgb(36, 121, 108)"
6471,2020-04-18,Cyprus,0,0,735,"rgb(36, 121, 108)"
6472,2020-04-19,Cyprus,0,26,761,"rgb(36, 121, 108)"
6473,2020-04-20,Cyprus,0,6,767,"rgb(36, 121, 108)"
6474,2020-04-21,Cyprus,0,5,772,"rgb(36, 121, 108)"
6475,2020-04-22,Cyprus,0,12,784,"rgb(36, 121, 108)"
6476,2020-04-23,Cyprus,2,6,790,"rgb(36, 121, 108)"
6477,2020-04-24,Cyprus,0,5,795,"rgb(36, 121, 108)"
6478,2020-04-25,Cyprus,0,9,804,"rgb(36, 121, 108)"
6479,2020-04-26,Cyprus,0,6,810,"rgb(36, 121, 108)"
6480,2020-04-27,Cyprus,0,7,817,"rgb(36, 121, 108)"
6481,2020-04-28,Cyprus,1,5,822,"rgb(36, 121, 108)"
6482,2020-04-29,Cyprus,0,15,837,"rgb(36, 121, 108)"
6483,2020-04-30,Cyprus,0,6,843,"rgb(36, 121, 108)"
6484,2020-05-01,Cyprus,0,7,850,"rgb(36, 121, 108)"
6485,2020-05-02,Cyprus,0,7,857,"rgb(36, 121, 108)"
6486,2020-05-03,Cyprus,0,7,864,"rgb(36, 121, 108)"
6487,2020-05-04,Cyprus,0,8,872,"rgb(36, 121, 108)"
6488,2020-05-05,Cyprus,0,2,874,"rgb(36, 121, 108)"
6489,2020-05-06,Cyprus,0,4,878,"rgb(36, 121, 108)"
6490,2020-05-07,Cyprus,0,5,883,"rgb(36, 121, 108)"
6491,2020-05-08,Cyprus,0,6,889,"rgb(36, 121, 108)"
6492,2020-05-09,Cyprus,0,2,891,"rgb(36, 121, 108)"
6493,2020-05-10,Cyprus,0,1,892,"rgb(36, 121, 108)"
6494,2020-05-11,Cyprus,1,6,898,"rgb(36, 121, 108)"
6495,2020-05-12,Cyprus,0,3,901,"rgb(36, 121, 108)"
6496,2020-05-13,Cyprus,0,2,903,"rgb(36, 121, 108)"
6497,2020-05-14,Cyprus,1,2,905,"rgb(36, 121, 108)"
6498,2020-05-15,Cyprus,0,2,907,"rgb(36, 121, 108)"
6499,2020-05-16,Cyprus,0,3,910,"rgb(36, 121, 108)"
6500,2020-05-17,Cyprus,0,4,914,"rgb(36, 121, 108)"
6501,2020-05-18,Cyprus,0,2,916,"rgb(36, 121, 108)"
6502,2020-05-19,Cyprus,0,1,917,"rgb(36, 121, 108)"
6503,2020-05-20,Cyprus,0,1,918,"rgb(36, 121, 108)"
6504,2020-05-21,Cyprus,0,4,922,"rgb(36, 121, 108)"
6505,2020-05-22,Cyprus,0,1,923,"rgb(36, 121, 108)"
6506,2020-05-23,Cyprus,0,4,927,"rgb(36, 121, 108)"
6507,2020-05-24,Cyprus,0,0,927,"rgb(36, 121, 108)"
6508,2020-05-25,Cyprus,0,8,935,"rgb(36, 121, 108)"
6509,2020-05-26,Cyprus,0,2,937,"rgb(36, 121, 108)"
6510,2020-05-27,Cyprus,0,2,939,"rgb(36, 121, 108)"
6511,2020-05-28,Cyprus,0,0,939,"rgb(36, 121, 108)"
6512,2020-05-29,Cyprus,0,2,941,"rgb(36, 121, 108)"
6513,2020-05-30,Cyprus,0,0,941,"rgb(36, 121, 108)"
6514,2020-05-31,Cyprus,0,2,943,"rgb(36, 121, 108)"
6515,2020-06-01,Cyprus,0,1,944,"rgb(36, 121, 108)"
6516,2020-06-02,Cyprus,0,5,949,"rgb(36, 121, 108)"
6517,2020-06-03,Cyprus,0,3,952,"rgb(36, 121, 108)"
6518,2020-06-04,Cyprus,0,6,958,"rgb(36, 121, 108)"
6519,2020-06-05,Cyprus,0,0,958,"rgb(36, 121, 108)"
6520,2020-06-06,Cyprus,0,2,960,"rgb(36, 121, 108)"
6521,2020-06-07,Cyprus,1,0,960,"rgb(36, 121, 108)"
6522,2020-06-08,Cyprus,0,4,964,"rgb(36, 121, 108)"
6523,2020-06-09,Cyprus,0,6,970,"rgb(36, 121, 108)"
6524,2020-06-10,Cyprus,0,2,972,"rgb(36, 121, 108)"
6525,2020-06-11,Cyprus,0,2,974,"rgb(36, 121, 108)"
6526,2020-06-12,Cyprus,0,1,975,"rgb(36, 121, 108)"
6527,2020-06-13,Cyprus,0,5,980,"rgb(36, 121, 108)"
6528,2020-06-14,Cyprus,0,0,980,"rgb(36, 121, 108)"
6529,2020-06-15,Cyprus,0,3,983,"rgb(36, 121, 108)"
6530,2020-06-16,Cyprus,0,2,985,"rgb(36, 121, 108)"
6531,2020-06-17,Cyprus,0,0,985,"rgb(36, 121, 108)"
6532,2020-06-18,Cyprus,0,0,985,"rgb(36, 121, 108)"
6533,2020-06-19,Cyprus,1,0,985,"rgb(36, 121, 108)"
6534,2020-06-20,Cyprus,0,0,985,"rgb(36, 121, 108)"
6535,2020-06-21,Cyprus,0,0,985,"rgb(36, 121, 108)"
6536,2020-06-22,Cyprus,0,1,986,"rgb(36, 121, 108)"
6537,2020-06-23,Cyprus,0,2,988,"rgb(36, 121, 108)"
6538,2020-06-24,Cyprus,0,2,990,"rgb(36, 121, 108)"
6539,2020-06-25,Cyprus,0,1,991,"rgb(36, 121, 108)"
6540,2020-06-26,Cyprus,0,1,992,"rgb(36, 121, 108)"
6541,2020-06-27,Cyprus,0,0,992,"rgb(36, 121, 108)"
6542,2020-06-28,Cyprus,0,2,994,"rgb(36, 121, 108)"
6543,2020-06-29,Cyprus,0,0,994,"rgb(36, 121, 108)"
6544,2020-06-30,Cyprus,0,2,996,"rgb(36, 121, 108)"
6545,2020-07-01,Cyprus,0,2,998,"rgb(36, 121, 108)"
6546,2020-07-02,Cyprus,0,1,999,"rgb(36, 121, 108)"
6547,2020-07-03,Cyprus,0,0,999,"rgb(36, 121, 108)"
6548,2020-07-04,Cyprus,0,0,999,"rgb(36, 121, 108)"
6549,2020-07-05,Cyprus,0,3,1002,"rgb(36, 121, 108)"
6550,2020-07-06,Cyprus,0,1,1003,"rgb(36, 121, 108)"
6551,2020-07-07,Cyprus,0,1,1004,"rgb(36, 121, 108)"
6552,2020-07-08,Cyprus,0,1,1005,"rgb(36, 121, 108)"
6553,2020-07-09,Cyprus,0,3,1008,"rgb(36, 121, 108)"
6554,2020-07-10,Cyprus,0,2,1010,"rgb(36, 121, 108)"
6555,2020-07-11,Cyprus,0,3,1013,"rgb(36, 121, 108)"
6556,2020-07-12,Cyprus,0,1,1014,"rgb(36, 121, 108)"
6557,2020-07-13,Cyprus,0,7,1021,"rgb(36, 121, 108)"
6558,2019-12-31,Czech Republic,0,0,0,"rgb(218, 165, 27)"
6559,2020-01-01,Czech Republic,0,0,0,"rgb(218, 165, 27)"
6560,2020-01-02,Czech Republic,0,0,0,"rgb(218, 165, 27)"
6561,2020-01-03,Czech Republic,0,0,0,"rgb(218, 165, 27)"
6562,2020-01-04,Czech Republic,0,0,0,"rgb(218, 165, 27)"
6563,2020-01-05,Czech Republic,0,0,0,"rgb(218, 165, 27)"
6564,2020-01-06,Czech Republic,0,0,0,"rgb(218, 165, 27)"
6565,2020-01-07,Czech Republic,0,0,0,"rgb(218, 165, 27)"
6566,2020-01-08,Czech Republic,0,0,0,"rgb(218, 165, 27)"
6567,2020-01-09,Czech Republic,0,0,0,"rgb(218, 165, 27)"
6568,2020-01-10,Czech Republic,0,0,0,"rgb(218, 165, 27)"
6569,2020-01-11,Czech Republic,0,0,0,"rgb(218, 165, 27)"
6570,2020-01-12,Czech Republic,0,0,0,"rgb(218, 165, 27)"
6571,2020-01-13,Czech Republic,0,0,0,"rgb(218, 165, 27)"
6572,2020-01-14,Czech Republic,0,0,0,"rgb(218, 165, 27)"
6573,2020-01-15,Czech Republic,0,0,0,"rgb(218, 165, 27)"
6574,2020-01-16,Czech Republic,0,0,0,"rgb(218, 165, 27)"
6575,2020-01-17,Czech Republic,0,0,0,"rgb(218, 165, 27)"
6576,2020-01-18,Czech Republic,0,0,0,"rgb(218, 165, 27)"
6577,2020-01-19,Czech Republic,0,0,0,"rgb(218, 165, 27)"
6578,2020-01-20,Czech Republic,0,0,0,"rgb(218, 165, 27)"
6579,2020-01-21,Czech Republic,0,0,0,"rgb(218, 165, 27)"
6580,2020-01-22,Czech Republic,0,0,0,"rgb(218, 165, 27)"
6581,2020-01-23,Czech Republic,0,0,0,"rgb(218, 165, 27)"
6582,2020-01-24,Czech Republic,0,0,0,"rgb(218, 165, 27)"
6583,2020-01-25,Czech Republic,0,0,0,"rgb(218, 165, 27)"
6584,2020-01-26,Czech Republic,0,0,0,"rgb(218, 165, 27)"
6585,2020-01-27,Czech Republic,0,0,0,"rgb(218, 165, 27)"
6586,2020-01-28,Czech Republic,0,0,0,"rgb(218, 165, 27)"
6587,2020-01-29,Czech Republic,0,0,0,"rgb(218, 165, 27)"
6588,2020-01-30,Czech Republic,0,0,0,"rgb(218, 165, 27)"
6589,2020-01-31,Czech Republic,0,0,0,"rgb(218, 165, 27)"
6590,2020-02-01,Czech Republic,0,0,0,"rgb(218, 165, 27)"
6591,2020-02-02,Czech Republic,0,0,0,"rgb(218, 165, 27)"
6592,2020-02-03,Czech Republic,0,0,0,"rgb(218, 165, 27)"
6593,2020-02-04,Czech Republic,0,0,0,"rgb(218, 165, 27)"
6594,2020-02-05,Czech Republic,0,0,0,"rgb(218, 165, 27)"
6595,2020-02-06,Czech Republic,0,0,0,"rgb(218, 165, 27)"
6596,2020-02-07,Czech Republic,0,0,0,"rgb(218, 165, 27)"
6597,2020-02-08,Czech Republic,0,0,0,"rgb(218, 165, 27)"
6598,2020-02-09,Czech Republic,0,0,0,"rgb(218, 165, 27)"
6599,2020-02-10,Czech Republic,0,0,0,"rgb(218, 165, 27)"
6600,2020-02-11,Czech Republic,0,0,0,"rgb(218, 165, 27)"
6601,2020-02-12,Czech Republic,0,0,0,"rgb(218, 165, 27)"
6602,2020-02-13,Czech Republic,0,0,0,"rgb(218, 165, 27)"
6603,2020-02-14,Czech Republic,0,0,0,"rgb(218, 165, 27)"
6604,2020-02-15,Czech Republic,0,0,0,"rgb(218, 165, 27)"
6605,2020-02-16,Czech Republic,0,0,0,"rgb(218, 165, 27)"
6606,2020-02-17,Czech Republic,0,0,0,"rgb(218, 165, 27)"
6607,2020-02-18,Czech Republic,0,0,0,"rgb(218, 165, 27)"
6608,2020-02-19,Czech Republic,0,0,0,"rgb(218, 165, 27)"
6609,2020-02-20,Czech Republic,0,0,0,"rgb(218, 165, 27)"
6610,2020-02-21,Czech Republic,0,0,0,"rgb(218, 165, 27)"
6611,2020-02-22,Czech Republic,0,0,0,"rgb(218, 165, 27)"
6612,2020-02-23,Czech Republic,0,0,0,"rgb(218, 165, 27)"
6613,2020-02-24,Czech Republic,0,0,0,"rgb(218, 165, 27)"
6614,2020-02-25,Czech Republic,0,0,0,"rgb(218, 165, 27)"
6615,2020-02-26,Czech Republic,0,0,0,"rgb(218, 165, 27)"
6616,2020-02-27,Czech Republic,0,0,0,"rgb(218, 165, 27)"
6617,2020-02-28,Czech Republic,0,0,0,"rgb(218, 165, 27)"
6618,2020-02-29,Czech Republic,0,0,0,"rgb(218, 165, 27)"
6619,2020-03-01,Czech Republic,0,0,0,"rgb(218, 165, 27)"
6620,2020-03-02,Czech Republic,0,3,3,"rgb(218, 165, 27)"
6621,2020-03-03,Czech Republic,0,2,5,"rgb(218, 165, 27)"
6622,2020-03-04,Czech Republic,0,0,5,"rgb(218, 165, 27)"
6623,2020-03-05,Czech Republic,0,3,8,"rgb(218, 165, 27)"
6624,2020-03-06,Czech Republic,0,4,12,"rgb(218, 165, 27)"
6625,2020-03-07,Czech Republic,0,7,19,"rgb(218, 165, 27)"
6626,2020-03-08,Czech Republic,0,7,26,"rgb(218, 165, 27)"
6627,2020-03-09,Czech Republic,0,6,32,"rgb(218, 165, 27)"
6628,2020-03-10,Czech Republic,0,8,40,"rgb(218, 165, 27)"
6629,2020-03-11,Czech Republic,0,23,63,"rgb(218, 165, 27)"
6630,2020-03-12,Czech Republic,0,31,94,"rgb(218, 165, 27)"
6631,2020-03-13,Czech Republic,0,22,116,"rgb(218, 165, 27)"
6632,2020-03-14,Czech Republic,0,34,150,"rgb(218, 165, 27)"
6633,2020-03-15,Czech Republic,0,64,214,"rgb(218, 165, 27)"
6634,2020-03-16,Czech Republic,0,84,298,"rgb(218, 165, 27)"
6635,2020-03-17,Czech Republic,0,46,344,"rgb(218, 165, 27)"
6636,2020-03-18,Czech Republic,0,90,434,"rgb(218, 165, 27)"
6637,2020-03-19,Czech Republic,0,88,522,"rgb(218, 165, 27)"
6638,2020-03-20,Czech Republic,0,172,694,"rgb(218, 165, 27)"
6639,2020-03-21,Czech Republic,0,210,904,"rgb(218, 165, 27)"
6640,2020-03-22,Czech Republic,0,91,995,"rgb(218, 165, 27)"
6641,2020-03-23,Czech Republic,1,170,1165,"rgb(218, 165, 27)"
6642,2020-03-24,Czech Republic,0,71,1236,"rgb(218, 165, 27)"
6643,2020-03-25,Czech Republic,2,158,1394,"rgb(218, 165, 27)"
6644,2020-03-26,Czech Republic,3,260,1654,"rgb(218, 165, 27)"
6645,2020-03-27,Czech Republic,3,408,2062,"rgb(218, 165, 27)"
6646,2020-03-28,Czech Republic,0,217,2279,"rgb(218, 165, 27)"
6647,2020-03-29,Czech Republic,2,384,2663,"rgb(218, 165, 27)"
6648,2020-03-30,Czech Republic,5,166,2829,"rgb(218, 165, 27)"
6649,2020-03-31,Czech Republic,8,173,3002,"rgb(218, 165, 27)"
6650,2020-04-01,Czech Republic,7,306,3308,"rgb(218, 165, 27)"
6651,2020-04-02,Czech Republic,8,281,3589,"rgb(218, 165, 27)"
6652,2020-04-03,Czech Republic,5,269,3858,"rgb(218, 165, 27)"
6653,2020-04-04,Czech Republic,9,332,4190,"rgb(218, 165, 27)"
6654,2020-04-05,Czech Republic,6,282,4472,"rgb(218, 165, 27)"
6655,2020-04-06,Czech Republic,8,115,4587,"rgb(218, 165, 27)"
6656,2020-04-07,Czech Republic,11,235,4822,"rgb(218, 165, 27)"
6657,2020-04-08,Czech Republic,10,195,5017,"rgb(218, 165, 27)"
6658,2020-04-09,Czech Republic,11,295,5312,"rgb(218, 165, 27)"
6659,2020-04-10,Czech Republic,13,257,5569,"rgb(218, 165, 27)"
6660,2020-04-11,Czech Republic,7,163,5732,"rgb(218, 165, 27)"
6661,2020-04-12,Czech Republic,10,170,5902,"rgb(218, 165, 27)"
6662,2020-04-13,Czech Republic,9,89,5991,"rgb(218, 165, 27)"
6663,2020-04-14,Czech Republic,5,68,6059,"rgb(218, 165, 27)"
6664,2020-04-15,Czech Republic,18,82,6141,"rgb(218, 165, 27)"
6665,2020-04-16,Czech Republic,5,162,6303,"rgb(218, 165, 27)"
6666,2020-04-17,Czech Republic,3,130,6433,"rgb(218, 165, 27)"
6667,2020-04-18,Czech Republic,4,116,6549,"rgb(218, 165, 27)"
6668,2020-04-19,Czech Republic,8,105,6654,"rgb(218, 165, 27)"
6669,2020-04-20,Czech Republic,7,133,6787,"rgb(218, 165, 27)"
6670,2020-04-21,Czech Republic,8,127,6914,"rgb(218, 165, 27)"
6671,2020-04-22,Czech Republic,5,127,7041,"rgb(218, 165, 27)"
6672,2020-04-23,Czech Republic,9,95,7136,"rgb(218, 165, 27)"
6673,2020-04-24,Czech Republic,3,52,7188,"rgb(218, 165, 27)"
6674,2020-04-25,Czech Republic,2,85,7273,"rgb(218, 165, 27)"
6675,2020-04-26,Czech Republic,3,79,7352,"rgb(218, 165, 27)"
6676,2020-04-27,Czech Republic,3,52,7404,"rgb(218, 165, 27)"
6677,2020-04-28,Czech Republic,2,45,7449,"rgb(218, 165, 27)"
6678,2020-04-29,Czech Republic,4,55,7504,"rgb(218, 165, 27)"
6679,2020-04-30,Czech Republic,0,75,7579,"rgb(218, 165, 27)"
6680,2020-05-01,Czech Republic,9,103,7682,"rgb(218, 165, 27)"
6681,2020-05-02,Czech Republic,4,55,7737,"rgb(218, 165, 27)"
6682,2020-05-03,Czech Republic,5,18,7755,"rgb(218, 165, 27)"
6683,2020-05-04,Czech Republic,3,26,7781,"rgb(218, 165, 27)"
6684,2020-05-05,Czech Republic,4,38,7819,"rgb(218, 165, 27)"
6685,2020-05-06,Czech Republic,5,77,7896,"rgb(218, 165, 27)"
6686,2020-05-07,Czech Republic,5,78,7974,"rgb(218, 165, 27)"
6687,2020-05-08,Czech Republic,8,57,8031,"rgb(218, 165, 27)"
6688,2020-05-09,Czech Republic,3,46,8077,"rgb(218, 165, 27)"
6689,2020-05-10,Czech Republic,3,18,8095,"rgb(218, 165, 27)"
6690,2020-05-11,Czech Republic,4,28,8123,"rgb(218, 165, 27)"
6691,2020-05-12,Czech Republic,2,53,8176,"rgb(218, 165, 27)"
6692,2020-05-13,Czech Republic,1,45,8221,"rgb(218, 165, 27)"
6693,2020-05-14,Czech Republic,7,48,8269,"rgb(218, 165, 27)"
6694,2020-05-15,Czech Republic,3,82,8351,"rgb(218, 165, 27)"
6695,2020-05-16,Czech Republic,2,55,8406,"rgb(218, 165, 27)"
6696,2020-05-17,Czech Republic,1,49,8455,"rgb(218, 165, 27)"
6697,2020-05-18,Czech Republic,1,20,8475,"rgb(218, 165, 27)"
6698,2020-05-19,Czech Republic,0,111,8586,"rgb(218, 165, 27)"
6699,2020-05-20,Czech Republic,5,61,8647,"rgb(218, 165, 27)"
6700,2020-05-21,Czech Republic,2,74,8721,"rgb(218, 165, 27)"
6701,2020-05-22,Czech Republic,2,33,8754,"rgb(218, 165, 27)"
6702,2020-05-23,Czech Republic,6,59,8813,"rgb(218, 165, 27)"
6703,2020-05-24,Czech Republic,2,77,8890,"rgb(218, 165, 27)"
6704,2020-05-25,Czech Republic,1,67,8957,"rgb(218, 165, 27)"
6705,2020-05-26,Czech Republic,2,47,9004,"rgb(218, 165, 27)"
6706,2020-05-27,Czech Republic,0,46,9050,"rgb(218, 165, 27)"
6707,2020-05-28,Czech Republic,0,36,9086,"rgb(218, 165, 27)"
6708,2020-05-29,Czech Republic,2,54,9140,"rgb(218, 165, 27)"
6709,2020-05-30,Czech Republic,0,56,9196,"rgb(218, 165, 27)"
6710,2020-05-31,Czech Republic,0,34,9230,"rgb(218, 165, 27)"
6711,2020-06-01,Czech Republic,1,43,9273,"rgb(218, 165, 27)"
6712,2020-06-02,Czech Republic,1,29,9302,"rgb(218, 165, 27)"
6713,2020-06-03,Czech Republic,2,62,9364,"rgb(218, 165, 27)"
6714,2020-06-04,Czech Republic,1,74,9438,"rgb(218, 165, 27)"
6715,2020-06-05,Czech Republic,2,56,9494,"rgb(218, 165, 27)"
6716,2020-06-06,Czech Republic,1,35,9529,"rgb(218, 165, 27)"
6717,2020-06-07,Czech Republic,0,38,9567,"rgb(218, 165, 27)"
6718,2020-06-08,Czech Republic,0,61,9628,"rgb(218, 165, 27)"
6719,2020-06-09,Czech Republic,1,69,9697,"rgb(218, 165, 27)"
6720,2020-06-10,Czech Republic,0,54,9751,"rgb(218, 165, 27)"
6721,2020-06-11,Czech Republic,0,73,9824,"rgb(218, 165, 27)"
6722,2020-06-12,Czech Republic,1,62,9886,"rgb(218, 165, 27)"
6723,2020-06-13,Czech Republic,0,52,9938,"rgb(218, 165, 27)"
6724,2020-06-14,Czech Republic,0,53,9991,"rgb(218, 165, 27)"
6725,2020-06-15,Czech Republic,0,33,10024,"rgb(218, 165, 27)"
6726,2020-06-16,Czech Republic,1,40,10064,"rgb(218, 165, 27)"
6727,2020-06-17,Czech Republic,1,47,10111,"rgb(218, 165, 27)"
6728,2020-06-18,Czech Republic,2,51,10162,"rgb(218, 165, 27)"
6729,2020-06-19,Czech Republic,1,68,10230,"rgb(218, 165, 27)"
6730,2020-06-20,Czech Republic,1,176,10406,"rgb(218, 165, 27)"
6731,2020-06-21,Czech Republic,1,42,10448,"rgb(218, 165, 27)"
6732,2020-06-22,Czech Republic,0,50,10498,"rgb(218, 165, 27)"
6733,2020-06-23,Czech Republic,0,63,10561,"rgb(218, 165, 27)"
6734,2020-06-24,Czech Republic,3,89,10650,"rgb(218, 165, 27)"
6735,2020-06-25,Czech Republic,4,127,10777,"rgb(218, 165, 27)"
6736,2020-06-26,Czech Republic,2,93,10870,"rgb(218, 165, 27)"
6737,2020-06-27,Czech Republic,0,168,11038,"rgb(218, 165, 27)"
6738,2020-06-28,Czech Republic,2,260,11298,"rgb(218, 165, 27)"
6739,2020-06-29,Czech Republic,1,305,11603,"rgb(218, 165, 27)"
6740,2020-06-30,Czech Republic,0,202,11805,"rgb(218, 165, 27)"
6741,2020-07-01,Czech Republic,1,149,11954,"rgb(218, 165, 27)"
6742,2020-07-02,Czech Republic,0,92,12046,"rgb(218, 165, 27)"
6743,2020-07-03,Czech Republic,2,132,12178,"rgb(218, 165, 27)"
6744,2020-07-04,Czech Republic,1,141,12319,"rgb(218, 165, 27)"
6745,2020-07-05,Czech Republic,-1,121,12440,"rgb(218, 165, 27)"
6746,2020-07-06,Czech Republic,-3,75,12515,"rgb(218, 165, 27)"
6747,2020-07-07,Czech Republic,2,51,12566,"rgb(218, 165, 27)"
6748,2020-07-08,Czech Republic,1,119,12685,"rgb(218, 165, 27)"
6749,2020-07-09,Czech Republic,0,129,12814,"rgb(218, 165, 27)"
6750,2020-07-10,Czech Republic,1,105,12919,"rgb(218, 165, 27)"
6751,2020-07-11,Czech Republic,0,143,13062,"rgb(218, 165, 27)"
6752,2020-07-12,Czech Republic,0,53,13115,"rgb(218, 165, 27)"
6753,2020-07-13,Czech Republic,0,59,13174,"rgb(218, 165, 27)"
6754,2019-12-31,Germany,0,0,0,"rgb(47, 138, 196)"
6755,2020-01-01,Germany,0,0,0,"rgb(47, 138, 196)"
6756,2020-01-02,Germany,0,0,0,"rgb(47, 138, 196)"
6757,2020-01-03,Germany,0,0,0,"rgb(47, 138, 196)"
6758,2020-01-04,Germany,0,0,0,"rgb(47, 138, 196)"
6759,2020-01-05,Germany,0,0,0,"rgb(47, 138, 196)"
6760,2020-01-06,Germany,0,0,0,"rgb(47, 138, 196)"
6761,2020-01-07,Germany,0,0,0,"rgb(47, 138, 196)"
6762,2020-01-08,Germany,0,0,0,"rgb(47, 138, 196)"
6763,2020-01-09,Germany,0,0,0,"rgb(47, 138, 196)"
6764,2020-01-10,Germany,0,0,0,"rgb(47, 138, 196)"
6765,2020-01-11,Germany,0,0,0,"rgb(47, 138, 196)"
6766,2020-01-12,Germany,0,0,0,"rgb(47, 138, 196)"
6767,2020-01-13,Germany,0,0,0,"rgb(47, 138, 196)"
6768,2020-01-14,Germany,0,0,0,"rgb(47, 138, 196)"
6769,2020-01-15,Germany,0,0,0,"rgb(47, 138, 196)"
6770,2020-01-16,Germany,0,0,0,"rgb(47, 138, 196)"
6771,2020-01-17,Germany,0,0,0,"rgb(47, 138, 196)"
6772,2020-01-18,Germany,0,0,0,"rgb(47, 138, 196)"
6773,2020-01-19,Germany,0,0,0,"rgb(47, 138, 196)"
6774,2020-01-20,Germany,0,0,0,"rgb(47, 138, 196)"
6775,2020-01-21,Germany,0,0,0,"rgb(47, 138, 196)"
6776,2020-01-22,Germany,0,0,0,"rgb(47, 138, 196)"
6777,2020-01-23,Germany,0,0,0,"rgb(47, 138, 196)"
6778,2020-01-24,Germany,0,0,0,"rgb(47, 138, 196)"
6779,2020-01-25,Germany,0,0,0,"rgb(47, 138, 196)"
6780,2020-01-26,Germany,0,0,0,"rgb(47, 138, 196)"
6781,2020-01-27,Germany,0,0,0,"rgb(47, 138, 196)"
6782,2020-01-28,Germany,0,1,1,"rgb(47, 138, 196)"
6783,2020-01-29,Germany,0,3,4,"rgb(47, 138, 196)"
6784,2020-01-30,Germany,0,0,4,"rgb(47, 138, 196)"
6785,2020-01-31,Germany,0,1,5,"rgb(47, 138, 196)"
6786,2020-02-01,Germany,0,2,7,"rgb(47, 138, 196)"
6787,2020-02-02,Germany,0,1,8,"rgb(47, 138, 196)"
6788,2020-02-03,Germany,0,1,9,"rgb(47, 138, 196)"
6789,2020-02-04,Germany,0,2,11,"rgb(47, 138, 196)"
6790,2020-02-05,Germany,0,0,11,"rgb(47, 138, 196)"
6791,2020-02-06,Germany,0,0,11,"rgb(47, 138, 196)"
6792,2020-02-07,Germany,0,1,12,"rgb(47, 138, 196)"
6793,2020-02-08,Germany,0,1,13,"rgb(47, 138, 196)"
6794,2020-02-09,Germany,0,0,13,"rgb(47, 138, 196)"
6795,2020-02-10,Germany,0,0,13,"rgb(47, 138, 196)"
6796,2020-02-11,Germany,0,0,13,"rgb(47, 138, 196)"
6797,2020-02-12,Germany,0,2,15,"rgb(47, 138, 196)"
6798,2020-02-13,Germany,0,0,15,"rgb(47, 138, 196)"
6799,2020-02-14,Germany,0,0,15,"rgb(47, 138, 196)"
6800,2020-02-15,Germany,0,0,15,"rgb(47, 138, 196)"
6801,2020-02-16,Germany,0,0,15,"rgb(47, 138, 196)"
6802,2020-02-17,Germany,0,0,15,"rgb(47, 138, 196)"
6803,2020-02-18,Germany,0,0,15,"rgb(47, 138, 196)"
6804,2020-02-19,Germany,0,0,15,"rgb(47, 138, 196)"
6805,2020-02-20,Germany,0,0,15,"rgb(47, 138, 196)"
6806,2020-02-21,Germany,0,0,15,"rgb(47, 138, 196)"
6807,2020-02-22,Germany,0,0,15,"rgb(47, 138, 196)"
6808,2020-02-23,Germany,0,0,15,"rgb(47, 138, 196)"
6809,2020-02-24,Germany,0,0,15,"rgb(47, 138, 196)"
6810,2020-02-25,Germany,0,0,15,"rgb(47, 138, 196)"
6811,2020-02-26,Germany,0,2,17,"rgb(47, 138, 196)"
6812,2020-02-27,Germany,0,4,21,"rgb(47, 138, 196)"
6813,2020-02-28,Germany,0,26,47,"rgb(47, 138, 196)"
6814,2020-02-29,Germany,0,10,57,"rgb(47, 138, 196)"
6815,2020-03-01,Germany,0,54,111,"rgb(47, 138, 196)"
6816,2020-03-02,Germany,0,18,129,"rgb(47, 138, 196)"
6817,2020-03-03,Germany,0,28,157,"rgb(47, 138, 196)"
6818,2020-03-04,Germany,0,39,196,"rgb(47, 138, 196)"
6819,2020-03-05,Germany,0,66,262,"rgb(47, 138, 196)"
6820,2020-03-06,Germany,0,138,400,"rgb(47, 138, 196)"
6821,2020-03-07,Germany,0,284,684,"rgb(47, 138, 196)"
6822,2020-03-08,Germany,0,163,847,"rgb(47, 138, 196)"
6823,2020-03-09,Germany,0,55,902,"rgb(47, 138, 196)"
6824,2020-03-10,Germany,2,237,1139,"rgb(47, 138, 196)"
6825,2020-03-11,Germany,0,157,1296,"rgb(47, 138, 196)"
6826,2020-03-12,Germany,1,271,1567,"rgb(47, 138, 196)"
6827,2020-03-13,Germany,2,802,2369,"rgb(47, 138, 196)"
6828,2020-03-14,Germany,0,693,3062,"rgb(47, 138, 196)"
6829,2020-03-15,Germany,3,733,3795,"rgb(47, 138, 196)"
6830,2020-03-16,Germany,4,1043,4838,"rgb(47, 138, 196)"
6831,2020-03-17,Germany,1,1174,6012,"rgb(47, 138, 196)"
6832,2020-03-18,Germany,0,1144,7156,"rgb(47, 138, 196)"
6833,2020-03-19,Germany,0,1042,8198,"rgb(47, 138, 196)"
6834,2020-03-20,Germany,30,5940,14138,"rgb(47, 138, 196)"
6835,2020-03-21,Germany,2,4049,18187,"rgb(47, 138, 196)"
6836,2020-03-22,Germany,22,3276,21463,"rgb(47, 138, 196)"
6837,2020-03-23,Germany,27,3311,24774,"rgb(47, 138, 196)"
6838,2020-03-24,Germany,32,4438,29212,"rgb(47, 138, 196)"
6839,2020-03-25,Germany,23,2342,31554,"rgb(47, 138, 196)"
6840,2020-03-26,Germany,49,4954,36508,"rgb(47, 138, 196)"
6841,2020-03-27,Germany,55,5780,42288,"rgb(47, 138, 196)"
6842,2020-03-28,Germany,72,6294,48582,"rgb(47, 138, 196)"
6843,2020-03-29,Germany,64,3965,52547,"rgb(47, 138, 196)"
6844,2020-03-30,Germany,66,4751,57298,"rgb(47, 138, 196)"
6845,2020-03-31,Germany,128,4615,61913,"rgb(47, 138, 196)"
6846,2020-04-01,Germany,149,5453,67366,"rgb(47, 138, 196)"
6847,2020-04-02,Germany,140,6156,73522,"rgb(47, 138, 196)"
6848,2020-04-03,Germany,145,6174,79696,"rgb(47, 138, 196)"
6849,2020-04-04,Germany,141,6082,85778,"rgb(47, 138, 196)"
6850,2020-04-05,Germany,184,5936,91714,"rgb(47, 138, 196)"
6851,2020-04-06,Germany,92,3677,95391,"rgb(47, 138, 196)"
6852,2020-04-07,Germany,173,3834,99225,"rgb(47, 138, 196)"
6853,2020-04-08,Germany,254,4003,103228,"rgb(47, 138, 196)"
6854,2020-04-09,Germany,246,4974,108202,"rgb(47, 138, 196)"
6855,2020-04-10,Germany,266,5323,113525,"rgb(47, 138, 196)"
6856,2020-04-11,Germany,171,4133,117658,"rgb(47, 138, 196)"
6857,2020-04-12,Germany,129,2821,120479,"rgb(47, 138, 196)"
6858,2020-04-13,Germany,126,2537,123016,"rgb(47, 138, 196)"
6859,2020-04-14,Germany,170,2082,125098,"rgb(47, 138, 196)"
6860,2020-04-15,Germany,285,2486,127584,"rgb(47, 138, 196)"
6861,2020-04-16,Germany,315,2866,130450,"rgb(47, 138, 196)"
6862,2020-04-17,Germany,299,3380,133830,"rgb(47, 138, 196)"
6863,2020-04-18,Germany,242,3609,137439,"rgb(47, 138, 196)"
6864,2020-04-19,Germany,184,2458,139897,"rgb(47, 138, 196)"
6865,2020-04-20,Germany,110,1775,141672,"rgb(47, 138, 196)"
6866,2020-04-21,Germany,194,1785,143457,"rgb(47, 138, 196)"
6867,2020-04-22,Germany,281,2237,145694,"rgb(47, 138, 196)"
6868,2020-04-23,Germany,215,2352,148046,"rgb(47, 138, 196)"
6869,2020-04-24,Germany,227,2337,150383,"rgb(47, 138, 196)"
6870,2020-04-25,Germany,179,2055,152438,"rgb(47, 138, 196)"
6871,2020-04-26,Germany,140,1737,154175,"rgb(47, 138, 196)"
6872,2020-04-27,Germany,110,1018,155193,"rgb(47, 138, 196)"
6873,2020-04-28,Germany,163,1144,156337,"rgb(47, 138, 196)"
6874,2020-04-29,Germany,202,1304,157641,"rgb(47, 138, 196)"
6875,2020-04-30,Germany,173,1478,159119,"rgb(47, 138, 196)"
6876,2020-05-01,Germany,0,0,159119,"rgb(47, 138, 196)"
6877,2020-05-02,Germany,287,2584,161703,"rgb(47, 138, 196)"
6878,2020-05-03,Germany,74,793,162496,"rgb(47, 138, 196)"
6879,2020-05-04,Germany,43,679,163175,"rgb(47, 138, 196)"
6880,2020-05-05,Germany,139,685,163860,"rgb(47, 138, 196)"
6881,2020-05-06,Germany,165,1037,164897,"rgb(47, 138, 196)"
6882,2020-05-07,Germany,123,1194,166091,"rgb(47, 138, 196)"
6883,2020-05-08,Germany,147,1209,167300,"rgb(47, 138, 196)"
6884,2020-05-09,Germany,103,1251,168551,"rgb(47, 138, 196)"
6885,2020-05-10,Germany,26,667,169218,"rgb(47, 138, 196)"
6886,2020-05-11,Germany,22,357,169575,"rgb(47, 138, 196)"
6887,2020-05-12,Germany,116,933,170508,"rgb(47, 138, 196)"
6888,2020-05-13,Germany,101,798,171306,"rgb(47, 138, 196)"
6889,2020-05-14,Germany,89,933,172239,"rgb(47, 138, 196)"
6890,2020-05-15,Germany,101,913,173152,"rgb(47, 138, 196)"
6891,2020-05-16,Germany,57,620,173772,"rgb(47, 138, 196)"
6892,2020-05-17,Germany,33,583,174355,"rgb(47, 138, 196)"
6893,2020-05-18,Germany,21,342,174697,"rgb(47, 138, 196)"
6894,2020-05-19,Germany,72,513,175210,"rgb(47, 138, 196)"
6895,2020-05-20,Germany,83,797,176007,"rgb(47, 138, 196)"
6896,2020-05-21,Germany,57,745,176752,"rgb(47, 138, 196)"
6897,2020-05-22,Germany,27,460,177212,"rgb(47, 138, 196)"
6898,2020-05-23,Germany,42,638,177850,"rgb(47, 138, 196)"
6899,2020-05-24,Germany,31,431,178281,"rgb(47, 138, 196)"
6900,2020-05-25,Germany,10,289,178570,"rgb(47, 138, 196)"
6901,2020-05-26,Germany,45,432,179002,"rgb(47, 138, 196)"
6902,2020-05-27,Germany,47,362,179364,"rgb(47, 138, 196)"
6903,2020-05-28,Germany,62,353,179717,"rgb(47, 138, 196)"
6904,2020-05-29,Germany,39,741,180458,"rgb(47, 138, 196)"
6905,2020-05-30,Germany,39,738,181196,"rgb(47, 138, 196)"
6906,2020-05-31,Germany,11,286,181482,"rgb(47, 138, 196)"
6907,2020-06-01,Germany,11,333,181815,"rgb(47, 138, 196)"
6908,2020-06-02,Germany,11,213,182028,"rgb(47, 138, 196)"
6909,2020-06-03,Germany,29,342,182370,"rgb(47, 138, 196)"
6910,2020-06-04,Germany,30,394,182764,"rgb(47, 138, 196)"
6911,2020-06-05,Germany,32,507,183271,"rgb(47, 138, 196)"
6912,2020-06-06,Germany,33,407,183678,"rgb(47, 138, 196)"
6913,2020-06-07,Germany,22,301,183979,"rgb(47, 138, 196)"
6914,2020-06-08,Germany,6,214,184193,"rgb(47, 138, 196)"
6915,2020-06-09,Germany,37,350,184543,"rgb(47, 138, 196)"
6916,2020-06-10,Germany,18,318,184861,"rgb(47, 138, 196)"
6917,2020-06-11,Germany,26,555,185416,"rgb(47, 138, 196)"
6918,2020-06-12,Germany,8,258,185674,"rgb(47, 138, 196)"
6919,2020-06-13,Germany,18,348,186022,"rgb(47, 138, 196)"
6920,2020-06-14,Germany,6,247,186269,"rgb(47, 138, 196)"
6921,2020-06-15,Germany,4,192,186461,"rgb(47, 138, 196)"
6922,2020-06-16,Germany,9,378,186839,"rgb(47, 138, 196)"
6923,2020-06-17,Germany,30,345,187184,"rgb(47, 138, 196)"
6924,2020-06-18,Germany,26,580,187764,"rgb(47, 138, 196)"
6925,2020-06-19,Germany,16,770,188534,"rgb(47, 138, 196)"
6926,2020-06-20,Germany,10,601,189135,"rgb(47, 138, 196)"
6927,2020-06-21,Germany,0,687,189822,"rgb(47, 138, 196)"
6928,2020-06-22,Germany,3,537,190359,"rgb(47, 138, 196)"
6929,2020-06-23,Germany,10,503,190862,"rgb(47, 138, 196)"
6930,2020-06-24,Germany,19,587,191449,"rgb(47, 138, 196)"
6931,2020-06-25,Germany,13,630,192079,"rgb(47, 138, 196)"
6932,2020-06-26,Germany,21,477,192556,"rgb(47, 138, 196)"
6933,2020-06-27,Germany,6,687,193243,"rgb(47, 138, 196)"
6934,2020-06-28,Germany,3,256,193499,"rgb(47, 138, 196)"
6935,2020-06-29,Germany,4,262,193761,"rgb(47, 138, 196)"
6936,2020-06-30,Germany,12,498,194259,"rgb(47, 138, 196)"
6937,2020-07-01,Germany,12,466,194725,"rgb(47, 138, 196)"
6938,2020-07-02,Germany,9,503,195228,"rgb(47, 138, 196)"
6939,2020-07-03,Germany,9,446,195674,"rgb(47, 138, 196)"
6940,2020-07-04,Germany,7,422,196096,"rgb(47, 138, 196)"
6941,2020-07-05,Germany,2,239,196335,"rgb(47, 138, 196)"
6942,2020-07-06,Germany,4,219,196554,"rgb(47, 138, 196)"
6943,2020-07-07,Germany,8,390,196944,"rgb(47, 138, 196)"
6944,2020-07-08,Germany,12,397,197341,"rgb(47, 138, 196)"
6945,2020-07-09,Germany,12,442,197783,"rgb(47, 138, 196)"
6946,2020-07-10,Germany,6,395,198178,"rgb(47, 138, 196)"
6947,2020-07-11,Germany,6,378,198556,"rgb(47, 138, 196)"
6948,2020-07-12,Germany,3,248,198804,"rgb(47, 138, 196)"
6949,2020-07-13,Germany,1,159,198963,"rgb(47, 138, 196)"
6950,2020-03-19,Djibouti,0,1,1,"rgb(118, 78, 159)"
6951,2020-03-20,Djibouti,0,0,1,"rgb(118, 78, 159)"
6952,2020-03-21,Djibouti,0,0,1,"rgb(118, 78, 159)"
6953,2020-03-22,Djibouti,0,0,1,"rgb(118, 78, 159)"
6954,2020-03-23,Djibouti,0,0,1,"rgb(118, 78, 159)"
6955,2020-03-24,Djibouti,0,2,3,"rgb(118, 78, 159)"
6956,2020-03-25,Djibouti,0,0,3,"rgb(118, 78, 159)"
6957,2020-03-26,Djibouti,0,9,12,"rgb(118, 78, 159)"
6958,2020-03-27,Djibouti,0,0,12,"rgb(118, 78, 159)"
6959,2020-03-28,Djibouti,0,1,13,"rgb(118, 78, 159)"
6960,2020-03-29,Djibouti,0,2,15,"rgb(118, 78, 159)"
6961,2020-03-30,Djibouti,0,4,19,"rgb(118, 78, 159)"
6962,2020-03-31,Djibouti,0,7,26,"rgb(118, 78, 159)"
6963,2020-04-01,Djibouti,0,5,31,"rgb(118, 78, 159)"
6964,2020-04-02,Djibouti,0,3,34,"rgb(118, 78, 159)"
6965,2020-04-03,Djibouti,0,7,41,"rgb(118, 78, 159)"
6966,2020-04-04,Djibouti,0,0,41,"rgb(118, 78, 159)"
6967,2020-04-05,Djibouti,0,10,51,"rgb(118, 78, 159)"
6968,2020-04-06,Djibouti,0,8,59,"rgb(118, 78, 159)"
6969,2020-04-07,Djibouti,0,31,90,"rgb(118, 78, 159)"
6970,2020-04-08,Djibouti,0,31,121,"rgb(118, 78, 159)"
6971,2020-04-09,Djibouti,0,14,135,"rgb(118, 78, 159)"
6972,2020-04-10,Djibouti,1,5,140,"rgb(118, 78, 159)"
6973,2020-04-11,Djibouti,0,10,150,"rgb(118, 78, 159)"
6974,2020-04-12,Djibouti,1,37,187,"rgb(118, 78, 159)"
6975,2020-04-13,Djibouti,0,27,214,"rgb(118, 78, 159)"
6976,2020-04-14,Djibouti,0,84,298,"rgb(118, 78, 159)"
6977,2020-04-15,Djibouti,0,65,363,"rgb(118, 78, 159)"
6978,2020-04-16,Djibouti,0,72,435,"rgb(118, 78, 159)"
6979,2020-04-17,Djibouti,0,156,591,"rgb(118, 78, 159)"
6980,2020-04-18,Djibouti,0,141,732,"rgb(118, 78, 159)"
6981,2020-04-19,Djibouti,0,0,732,"rgb(118, 78, 159)"
6982,2020-04-20,Djibouti,0,114,846,"rgb(118, 78, 159)"
6983,2020-04-21,Djibouti,0,0,846,"rgb(118, 78, 159)"
6984,2020-04-22,Djibouti,0,99,945,"rgb(118, 78, 159)"
6985,2020-04-23,Djibouti,0,29,974,"rgb(118, 78, 159)"
6986,2020-04-24,Djibouti,0,12,986,"rgb(118, 78, 159)"
6987,2020-04-25,Djibouti,0,13,999,"rgb(118, 78, 159)"
6988,2020-04-26,Djibouti,0,9,1008,"rgb(118, 78, 159)"
6989,2020-04-27,Djibouti,0,15,1023,"rgb(118, 78, 159)"
6990,2020-04-28,Djibouti,0,12,1035,"rgb(118, 78, 159)"
6991,2020-04-29,Djibouti,0,37,1072,"rgb(118, 78, 159)"
6992,2020-04-30,Djibouti,0,5,1077,"rgb(118, 78, 159)"
6993,2020-05-01,Djibouti,0,12,1089,"rgb(118, 78, 159)"
6994,2020-05-02,Djibouti,0,8,1097,"rgb(118, 78, 159)"
6995,2020-05-03,Djibouti,0,15,1112,"rgb(118, 78, 159)"
6996,2020-05-04,Djibouti,0,0,1112,"rgb(118, 78, 159)"
6997,2020-05-05,Djibouti,0,4,1116,"rgb(118, 78, 159)"
6998,2020-05-06,Djibouti,0,4,1120,"rgb(118, 78, 159)"
6999,2020-05-07,Djibouti,1,0,1120,"rgb(118, 78, 159)"
7000,2020-05-08,Djibouti,0,13,1133,"rgb(118, 78, 159)"
7001,2020-05-09,Djibouti,0,2,1135,"rgb(118, 78, 159)"
7002,2020-05-10,Djibouti,0,54,1189,"rgb(118, 78, 159)"
7003,2020-05-11,Djibouti,0,21,1210,"rgb(118, 78, 159)"
7004,2020-05-12,Djibouti,0,17,1227,"rgb(118, 78, 159)"
7005,2020-05-13,Djibouti,0,29,1256,"rgb(118, 78, 159)"
7006,2020-05-14,Djibouti,0,12,1268,"rgb(118, 78, 159)"
7007,2020-05-15,Djibouti,0,16,1284,"rgb(118, 78, 159)"
7008,2020-05-16,Djibouti,1,25,1309,"rgb(118, 78, 159)"
7009,2020-05-17,Djibouti,0,22,1331,"rgb(118, 78, 159)"
7010,2020-05-18,Djibouti,0,70,1401,"rgb(118, 78, 159)"
7011,2020-05-19,Djibouti,3,117,1518,"rgb(118, 78, 159)"
7012,2020-05-20,Djibouti,0,0,1518,"rgb(118, 78, 159)"
7013,2020-05-21,Djibouti,2,310,1828,"rgb(118, 78, 159)"
7014,2020-05-22,Djibouti,1,219,2047,"rgb(118, 78, 159)"
7015,2020-05-23,Djibouti,0,223,2270,"rgb(118, 78, 159)"
7016,2020-05-24,Djibouti,0,0,2270,"rgb(118, 78, 159)"
7017,2020-05-25,Djibouti,0,0,2270,"rgb(118, 78, 159)"
7018,2020-05-26,Djibouti,4,198,2468,"rgb(118, 78, 159)"
7019,2020-05-27,Djibouti,0,0,2468,"rgb(118, 78, 159)"
7020,2020-05-28,Djibouti,4,229,2697,"rgb(118, 78, 159)"
7021,2020-05-29,Djibouti,2,217,2914,"rgb(118, 78, 159)"
7022,2020-05-30,Djibouti,0,0,2914,"rgb(118, 78, 159)"
7023,2020-05-31,Djibouti,2,280,3194,"rgb(118, 78, 159)"
7024,2020-06-01,Djibouti,2,160,3354,"rgb(118, 78, 159)"
7025,2020-06-02,Djibouti,0,215,3569,"rgb(118, 78, 159)"
7026,2020-06-03,Djibouti,1,210,3779,"rgb(118, 78, 159)"
7027,2020-06-04,Djibouti,1,156,3935,"rgb(118, 78, 159)"
7028,2020-06-05,Djibouti,0,119,4054,"rgb(118, 78, 159)"
7029,2020-06-06,Djibouti,0,69,4123,"rgb(118, 78, 159)"
7030,2020-06-07,Djibouti,0,46,4169,"rgb(118, 78, 159)"
7031,2020-06-08,Djibouti,2,38,4207,"rgb(118, 78, 159)"
7032,2020-06-09,Djibouti,3,71,4278,"rgb(118, 78, 159)"
7033,2020-06-10,Djibouti,3,53,4331,"rgb(118, 78, 159)"
7034,2020-06-11,Djibouti,0,42,4373,"rgb(118, 78, 159)"
7035,2020-06-12,Djibouti,3,25,4398,"rgb(118, 78, 159)"
7036,2020-06-13,Djibouti,1,43,4441,"rgb(118, 78, 159)"
7037,2020-06-14,Djibouti,3,8,4449,"rgb(118, 78, 159)"
7038,2020-06-15,Djibouti,2,16,4465,"rgb(118, 78, 159)"
7039,2020-06-16,Djibouti,0,36,4501,"rgb(118, 78, 159)"
7040,2020-06-17,Djibouti,0,38,4539,"rgb(118, 78, 159)"
7041,2020-06-18,Djibouti,0,6,4545,"rgb(118, 78, 159)"
7042,2020-06-19,Djibouti,0,12,4557,"rgb(118, 78, 159)"
7043,2020-06-20,Djibouti,2,8,4565,"rgb(118, 78, 159)"
7044,2020-06-21,Djibouti,0,0,4565,"rgb(118, 78, 159)"
7045,2020-06-22,Djibouti,0,17,4582,"rgb(118, 78, 159)"
7046,2020-06-23,Djibouti,3,17,4599,"rgb(118, 78, 159)"
7047,2020-06-24,Djibouti,1,18,4617,"rgb(118, 78, 159)"
7048,2020-06-25,Djibouti,3,13,4630,"rgb(118, 78, 159)"
7049,2020-06-26,Djibouti,0,5,4635,"rgb(118, 78, 159)"
7050,2020-06-27,Djibouti,0,8,4643,"rgb(118, 78, 159)"
7051,2020-06-28,Djibouti,0,0,4643,"rgb(118, 78, 159)"
7052,2020-06-29,Djibouti,0,0,4643,"rgb(118, 78, 159)"
7053,2020-06-30,Djibouti,1,13,4656,"rgb(118, 78, 159)"
7054,2020-07-01,Djibouti,1,26,4682,"rgb(118, 78, 159)"
7055,2020-07-02,Djibouti,1,22,4704,"rgb(118, 78, 159)"
7056,2020-07-03,Djibouti,0,11,4715,"rgb(118, 78, 159)"
7057,2020-07-04,Djibouti,0,21,4736,"rgb(118, 78, 159)"
7058,2020-07-05,Djibouti,0,0,4736,"rgb(118, 78, 159)"
7059,2020-07-06,Djibouti,0,56,4792,"rgb(118, 78, 159)"
7060,2020-07-07,Djibouti,0,30,4822,"rgb(118, 78, 159)"
7061,2020-07-08,Djibouti,0,56,4878,"rgb(118, 78, 159)"
7062,2020-07-09,Djibouti,0,11,4889,"rgb(118, 78, 159)"
7063,2020-07-10,Djibouti,1,66,4955,"rgb(118, 78, 159)"
7064,2020-07-11,Djibouti,0,0,4955,"rgb(118, 78, 159)"
7065,2020-07-12,Djibouti,0,0,4955,"rgb(118, 78, 159)"
7066,2020-07-13,Djibouti,0,17,4972,"rgb(118, 78, 159)"
7067,2019-12-31,Denmark,0,0,0,"rgb(237, 100, 90)"
7068,2020-01-01,Denmark,0,0,0,"rgb(237, 100, 90)"
7069,2020-01-02,Denmark,0,0,0,"rgb(237, 100, 90)"
7070,2020-01-03,Denmark,0,0,0,"rgb(237, 100, 90)"
7071,2020-01-04,Denmark,0,0,0,"rgb(237, 100, 90)"
7072,2020-01-05,Denmark,0,0,0,"rgb(237, 100, 90)"
7073,2020-01-06,Denmark,0,0,0,"rgb(237, 100, 90)"
7074,2020-01-07,Denmark,0,0,0,"rgb(237, 100, 90)"
7075,2020-01-08,Denmark,0,0,0,"rgb(237, 100, 90)"
7076,2020-01-09,Denmark,0,0,0,"rgb(237, 100, 90)"
7077,2020-01-10,Denmark,0,0,0,"rgb(237, 100, 90)"
7078,2020-01-11,Denmark,0,0,0,"rgb(237, 100, 90)"
7079,2020-01-12,Denmark,0,0,0,"rgb(237, 100, 90)"
7080,2020-01-13,Denmark,0,0,0,"rgb(237, 100, 90)"
7081,2020-01-14,Denmark,0,0,0,"rgb(237, 100, 90)"
7082,2020-01-15,Denmark,0,0,0,"rgb(237, 100, 90)"
7083,2020-01-16,Denmark,0,0,0,"rgb(237, 100, 90)"
7084,2020-01-17,Denmark,0,0,0,"rgb(237, 100, 90)"
7085,2020-01-18,Denmark,0,0,0,"rgb(237, 100, 90)"
7086,2020-01-19,Denmark,0,0,0,"rgb(237, 100, 90)"
7087,2020-01-20,Denmark,0,0,0,"rgb(237, 100, 90)"
7088,2020-01-21,Denmark,0,0,0,"rgb(237, 100, 90)"
7089,2020-01-22,Denmark,0,0,0,"rgb(237, 100, 90)"
7090,2020-01-23,Denmark,0,0,0,"rgb(237, 100, 90)"
7091,2020-01-24,Denmark,0,0,0,"rgb(237, 100, 90)"
7092,2020-01-25,Denmark,0,0,0,"rgb(237, 100, 90)"
7093,2020-01-26,Denmark,0,0,0,"rgb(237, 100, 90)"
7094,2020-01-27,Denmark,0,0,0,"rgb(237, 100, 90)"
7095,2020-01-28,Denmark,0,0,0,"rgb(237, 100, 90)"
7096,2020-01-29,Denmark,0,0,0,"rgb(237, 100, 90)"
7097,2020-01-30,Denmark,0,0,0,"rgb(237, 100, 90)"
7098,2020-01-31,Denmark,0,0,0,"rgb(237, 100, 90)"
7099,2020-02-01,Denmark,0,0,0,"rgb(237, 100, 90)"
7100,2020-02-02,Denmark,0,0,0,"rgb(237, 100, 90)"
7101,2020-02-03,Denmark,0,0,0,"rgb(237, 100, 90)"
7102,2020-02-04,Denmark,0,0,0,"rgb(237, 100, 90)"
7103,2020-02-05,Denmark,0,0,0,"rgb(237, 100, 90)"
7104,2020-02-06,Denmark,0,0,0,"rgb(237, 100, 90)"
7105,2020-02-07,Denmark,0,0,0,"rgb(237, 100, 90)"
7106,2020-02-08,Denmark,0,0,0,"rgb(237, 100, 90)"
7107,2020-02-09,Denmark,0,0,0,"rgb(237, 100, 90)"
7108,2020-02-10,Denmark,0,0,0,"rgb(237, 100, 90)"
7109,2020-02-11,Denmark,0,0,0,"rgb(237, 100, 90)"
7110,2020-02-12,Denmark,0,0,0,"rgb(237, 100, 90)"
7111,2020-02-13,Denmark,0,0,0,"rgb(237, 100, 90)"
7112,2020-02-14,Denmark,0,0,0,"rgb(237, 100, 90)"
7113,2020-02-15,Denmark,0,0,0,"rgb(237, 100, 90)"
7114,2020-02-16,Denmark,0,0,0,"rgb(237, 100, 90)"
7115,2020-02-17,Denmark,0,0,0,"rgb(237, 100, 90)"
7116,2020-02-18,Denmark,0,0,0,"rgb(237, 100, 90)"
7117,2020-02-19,Denmark,0,0,0,"rgb(237, 100, 90)"
7118,2020-02-20,Denmark,0,0,0,"rgb(237, 100, 90)"
7119,2020-02-21,Denmark,0,0,0,"rgb(237, 100, 90)"
7120,2020-02-22,Denmark,0,0,0,"rgb(237, 100, 90)"
7121,2020-02-23,Denmark,0,0,0,"rgb(237, 100, 90)"
7122,2020-02-24,Denmark,0,0,0,"rgb(237, 100, 90)"
7123,2020-02-25,Denmark,0,0,0,"rgb(237, 100, 90)"
7124,2020-02-26,Denmark,0,0,0,"rgb(237, 100, 90)"
7125,2020-02-27,Denmark,0,1,1,"rgb(237, 100, 90)"
7126,2020-02-28,Denmark,0,0,1,"rgb(237, 100, 90)"
7127,2020-02-29,Denmark,0,1,2,"rgb(237, 100, 90)"
7128,2020-03-01,Denmark,0,1,3,"rgb(237, 100, 90)"
7129,2020-03-02,Denmark,0,1,4,"rgb(237, 100, 90)"
7130,2020-03-03,Denmark,0,1,5,"rgb(237, 100, 90)"
7131,2020-03-04,Denmark,0,3,8,"rgb(237, 100, 90)"
7132,2020-03-05,Denmark,0,2,10,"rgb(237, 100, 90)"
7133,2020-03-06,Denmark,0,10,20,"rgb(237, 100, 90)"
7134,2020-03-07,Denmark,0,3,23,"rgb(237, 100, 90)"
7135,2020-03-08,Denmark,0,8,31,"rgb(237, 100, 90)"
7136,2020-03-09,Denmark,0,7,38,"rgb(237, 100, 90)"
7137,2020-03-10,Denmark,0,75,113,"rgb(237, 100, 90)"
7138,2020-03-11,Denmark,0,151,264,"rgb(237, 100, 90)"
7139,2020-03-12,Denmark,0,252,516,"rgb(237, 100, 90)"
7140,2020-03-13,Denmark,0,160,676,"rgb(237, 100, 90)"
7141,2020-03-14,Denmark,0,128,804,"rgb(237, 100, 90)"
7142,2020-03-15,Denmark,0,23,827,"rgb(237, 100, 90)"
7143,2020-03-16,Denmark,1,48,875,"rgb(237, 100, 90)"
7144,2020-03-17,Denmark,0,57,932,"rgb(237, 100, 90)"
7145,2020-03-18,Denmark,3,92,1024,"rgb(237, 100, 90)"
7146,2020-03-19,Denmark,0,91,1115,"rgb(237, 100, 90)"
7147,2020-03-20,Denmark,2,36,1151,"rgb(237, 100, 90)"
7148,2020-03-21,Denmark,3,104,1255,"rgb(237, 100, 90)"
7149,2020-03-22,Denmark,4,71,1326,"rgb(237, 100, 90)"
7150,2020-03-23,Denmark,0,69,1395,"rgb(237, 100, 90)"
7151,2020-03-24,Denmark,11,65,1460,"rgb(237, 100, 90)"
7152,2020-03-25,Denmark,8,131,1591,"rgb(237, 100, 90)"
7153,2020-03-26,Denmark,2,133,1724,"rgb(237, 100, 90)"
7154,2020-03-27,Denmark,7,153,1877,"rgb(237, 100, 90)"
7155,2020-03-28,Denmark,11,169,2046,"rgb(237, 100, 90)"
7156,2020-03-29,Denmark,13,155,2201,"rgb(237, 100, 90)"
7157,2020-03-30,Denmark,7,194,2395,"rgb(237, 100, 90)"
7158,2020-03-31,Denmark,5,182,2577,"rgb(237, 100, 90)"
7159,2020-04-01,Denmark,13,283,2860,"rgb(237, 100, 90)"
7160,2020-04-02,Denmark,14,247,3107,"rgb(237, 100, 90)"
7161,2020-04-03,Denmark,19,279,3386,"rgb(237, 100, 90)"
7162,2020-04-04,Denmark,16,371,3757,"rgb(237, 100, 90)"
7163,2020-04-05,Denmark,22,320,4077,"rgb(237, 100, 90)"
7164,2020-04-06,Denmark,18,292,4369,"rgb(237, 100, 90)"
7165,2020-04-07,Denmark,8,312,4681,"rgb(237, 100, 90)"
7166,2020-04-08,Denmark,16,390,5071,"rgb(237, 100, 90)"
7167,2020-04-09,Denmark,15,331,5402,"rgb(237, 100, 90)"
7168,2020-04-10,Denmark,19,233,5635,"rgb(237, 100, 90)"
7169,2020-04-11,Denmark,10,184,5819,"rgb(237, 100, 90)"
7170,2020-04-12,Denmark,13,177,5996,"rgb(237, 100, 90)"
7171,2020-04-13,Denmark,13,178,6174,"rgb(237, 100, 90)"
7172,2020-04-14,Denmark,12,144,6318,"rgb(237, 100, 90)"
7173,2020-04-15,Denmark,14,193,6511,"rgb(237, 100, 90)"
7174,2020-04-16,Denmark,10,170,6681,"rgb(237, 100, 90)"
7175,2020-04-17,Denmark,12,198,6879,"rgb(237, 100, 90)"
7176,2020-04-18,Denmark,15,194,7073,"rgb(237, 100, 90)"
7177,2020-04-19,Denmark,10,169,7242,"rgb(237, 100, 90)"
7178,2020-04-20,Denmark,9,142,7384,"rgb(237, 100, 90)"
7179,2020-04-21,Denmark,9,131,7515,"rgb(237, 100, 90)"
7180,2020-04-22,Denmark,6,180,7695,"rgb(237, 100, 90)"
7181,2020-04-23,Denmark,14,217,7912,"rgb(237, 100, 90)"
7182,2020-04-24,Denmark,10,161,8073,"rgb(237, 100, 90)"
7183,2020-04-25,Denmark,9,137,8210,"rgb(237, 100, 90)"
7184,2020-04-26,Denmark,15,235,8445,"rgb(237, 100, 90)"
7185,2020-04-27,Denmark,4,130,8575,"rgb(237, 100, 90)"
7186,2020-04-28,Denmark,5,123,8698,"rgb(237, 100, 90)"
7187,2020-04-29,Denmark,7,153,8851,"rgb(237, 100, 90)"
7188,2020-04-30,Denmark,9,157,9008,"rgb(237, 100, 90)"
7189,2020-05-01,Denmark,9,150,9158,"rgb(237, 100, 90)"
7190,2020-05-02,Denmark,10,153,9311,"rgb(237, 100, 90)"
7191,2020-05-03,Denmark,11,96,9407,"rgb(237, 100, 90)"
7192,2020-05-04,Denmark,8,116,9523,"rgb(237, 100, 90)"
7193,2020-05-05,Denmark,9,147,9670,"rgb(237, 100, 90)"
7194,2020-05-06,Denmark,7,151,9821,"rgb(237, 100, 90)"
7195,2020-05-07,Denmark,3,162,9983,"rgb(237, 100, 90)"
7196,2020-05-08,Denmark,6,100,10083,"rgb(237, 100, 90)"
7197,2020-05-09,Denmark,6,135,10218,"rgb(237, 100, 90)"
7198,2020-05-10,Denmark,4,101,10319,"rgb(237, 100, 90)"
7199,2020-05-11,Denmark,3,110,10429,"rgb(237, 100, 90)"
7200,2020-05-12,Denmark,5,84,10513,"rgb(237, 100, 90)"
7201,2020-05-13,Denmark,4,78,10591,"rgb(237, 100, 90)"
7202,2020-05-14,Denmark,6,76,10667,"rgb(237, 100, 90)"
7203,2020-05-15,Denmark,4,46,10713,"rgb(237, 100, 90)"
7204,2020-05-16,Denmark,0,78,10791,"rgb(237, 100, 90)"
7205,2020-05-17,Denmark,5,67,10858,"rgb(237, 100, 90)"
7206,2020-05-18,Denmark,4,69,10927,"rgb(237, 100, 90)"
7207,2020-05-19,Denmark,1,41,10968,"rgb(237, 100, 90)"
7208,2020-05-20,Denmark,3,76,11044,"rgb(237, 100, 90)"
7209,2020-05-21,Denmark,3,73,11117,"rgb(237, 100, 90)"
7210,2020-05-22,Denmark,7,65,11182,"rgb(237, 100, 90)"
7211,2020-05-23,Denmark,0,48,11230,"rgb(237, 100, 90)"
7212,2020-05-24,Denmark,0,59,11289,"rgb(237, 100, 90)"
7213,2020-05-25,Denmark,1,71,11360,"rgb(237, 100, 90)"
7214,2020-05-26,Denmark,1,27,11387,"rgb(237, 100, 90)"
7215,2020-05-27,Denmark,0,41,11428,"rgb(237, 100, 90)"
7216,2020-05-28,Denmark,2,52,11480,"rgb(237, 100, 90)"
7217,2020-05-29,Denmark,3,32,11512,"rgb(237, 100, 90)"
7218,2020-05-30,Denmark,0,81,11593,"rgb(237, 100, 90)"
7219,2020-05-31,Denmark,3,40,11633,"rgb(237, 100, 90)"
7220,2020-06-01,Denmark,3,36,11669,"rgb(237, 100, 90)"
7221,2020-06-02,Denmark,2,30,11699,"rgb(237, 100, 90)"
7222,2020-06-03,Denmark,4,35,11734,"rgb(237, 100, 90)"
7223,2020-06-04,Denmark,0,37,11771,"rgb(237, 100, 90)"
7224,2020-06-05,Denmark,2,40,11811,"rgb(237, 100, 90)"
7225,2020-06-06,Denmark,4,64,11875,"rgb(237, 100, 90)"
7226,2020-06-07,Denmark,1,49,11924,"rgb(237, 100, 90)"
7227,2020-06-08,Denmark,2,24,11948,"rgb(237, 100, 90)"
7228,2020-06-09,Denmark,4,14,11962,"rgb(237, 100, 90)"
7229,2020-06-10,Denmark,0,39,12001,"rgb(237, 100, 90)"
7230,2020-06-11,Denmark,0,15,12016,"rgb(237, 100, 90)"
7231,2020-06-12,Denmark,0,19,12035,"rgb(237, 100, 90)"
7232,2020-06-13,Denmark,1,64,12099,"rgb(237, 100, 90)"
7233,2020-06-14,Denmark,3,40,12139,"rgb(237, 100, 90)"
7234,2020-06-15,Denmark,0,54,12193,"rgb(237, 100, 90)"
7235,2020-06-16,Denmark,1,24,12217,"rgb(237, 100, 90)"
7236,2020-06-17,Denmark,0,33,12250,"rgb(237, 100, 90)"
7237,2020-06-18,Denmark,0,44,12294,"rgb(237, 100, 90)"
7238,2020-06-19,Denmark,2,50,12344,"rgb(237, 100, 90)"
7239,2020-06-20,Denmark,0,47,12391,"rgb(237, 100, 90)"
7240,2020-06-21,Denmark,0,0,12391,"rgb(237, 100, 90)"
7241,2020-06-22,Denmark,0,0,12391,"rgb(237, 100, 90)"
7242,2020-06-23,Denmark,2,136,12527,"rgb(237, 100, 90)"
7243,2020-06-24,Denmark,1,34,12561,"rgb(237, 100, 90)"
7244,2020-06-25,Denmark,0,54,12615,"rgb(237, 100, 90)"
7245,2020-06-26,Denmark,0,21,12636,"rgb(237, 100, 90)"
7246,2020-06-27,Denmark,1,39,12675,"rgb(237, 100, 90)"
7247,2020-06-28,Denmark,0,0,12675,"rgb(237, 100, 90)"
7248,2020-06-29,Denmark,0,0,12675,"rgb(237, 100, 90)"
7249,2020-06-30,Denmark,1,76,12751,"rgb(237, 100, 90)"
7250,2020-07-01,Denmark,0,17,12768,"rgb(237, 100, 90)"
7251,2020-07-02,Denmark,1,26,12794,"rgb(237, 100, 90)"
7252,2020-07-03,Denmark,0,21,12815,"rgb(237, 100, 90)"
7253,2020-07-04,Denmark,0,17,12832,"rgb(237, 100, 90)"
7254,2020-07-05,Denmark,0,0,12832,"rgb(237, 100, 90)"
7255,2020-07-06,Denmark,0,0,12832,"rgb(237, 100, 90)"
7256,2020-07-07,Denmark,1,46,12878,"rgb(237, 100, 90)"
7257,2020-07-08,Denmark,2,10,12888,"rgb(237, 100, 90)"
7258,2020-07-09,Denmark,0,12,12900,"rgb(237, 100, 90)"
7259,2020-07-10,Denmark,0,16,12916,"rgb(237, 100, 90)"
7260,2020-07-11,Denmark,0,30,12946,"rgb(237, 100, 90)"
7261,2020-07-12,Denmark,0,0,12946,"rgb(237, 100, 90)"
7262,2020-07-13,Denmark,0,0,12946,"rgb(237, 100, 90)"
7263,2020-03-23,Dominica,0,1,1,"rgb(165, 170, 153)"
7264,2020-03-24,Dominica,0,0,1,"rgb(165, 170, 153)"
7265,2020-03-25,Dominica,0,1,2,"rgb(165, 170, 153)"
7266,2020-03-26,Dominica,0,5,7,"rgb(165, 170, 153)"
7267,2020-03-27,Dominica,0,4,11,"rgb(165, 170, 153)"
7268,2020-03-28,Dominica,0,0,11,"rgb(165, 170, 153)"
7269,2020-03-29,Dominica,0,0,11,"rgb(165, 170, 153)"
7270,2020-03-30,Dominica,0,0,11,"rgb(165, 170, 153)"
7271,2020-03-31,Dominica,0,0,11,"rgb(165, 170, 153)"
7272,2020-04-01,Dominica,0,0,11,"rgb(165, 170, 153)"
7273,2020-04-02,Dominica,0,1,12,"rgb(165, 170, 153)"
7274,2020-04-03,Dominica,0,0,12,"rgb(165, 170, 153)"
7275,2020-04-04,Dominica,0,2,14,"rgb(165, 170, 153)"
7276,2020-04-05,Dominica,0,0,14,"rgb(165, 170, 153)"
7277,2020-04-06,Dominica,0,0,14,"rgb(165, 170, 153)"
7278,2020-04-07,Dominica,0,1,15,"rgb(165, 170, 153)"
7279,2020-04-08,Dominica,0,0,15,"rgb(165, 170, 153)"
7280,2020-04-09,Dominica,0,0,15,"rgb(165, 170, 153)"
7281,2020-04-10,Dominica,0,1,16,"rgb(165, 170, 153)"
7282,2020-04-11,Dominica,0,0,16,"rgb(165, 170, 153)"
7283,2020-04-12,Dominica,0,0,16,"rgb(165, 170, 153)"
7284,2020-04-13,Dominica,0,0,16,"rgb(165, 170, 153)"
7285,2020-04-14,Dominica,0,0,16,"rgb(165, 170, 153)"
7286,2020-04-15,Dominica,0,0,16,"rgb(165, 170, 153)"
7287,2020-04-16,Dominica,0,0,16,"rgb(165, 170, 153)"
7288,2020-04-17,Dominica,0,0,16,"rgb(165, 170, 153)"
7289,2020-04-18,Dominica,0,0,16,"rgb(165, 170, 153)"
7290,2020-04-19,Dominica,0,0,16,"rgb(165, 170, 153)"
7291,2020-04-20,Dominica,0,0,16,"rgb(165, 170, 153)"
7292,2020-04-21,Dominica,0,0,16,"rgb(165, 170, 153)"
7293,2020-04-22,Dominica,0,0,16,"rgb(165, 170, 153)"
7294,2020-04-23,Dominica,0,0,16,"rgb(165, 170, 153)"
7295,2020-04-24,Dominica,0,0,16,"rgb(165, 170, 153)"
7296,2020-04-25,Dominica,0,0,16,"rgb(165, 170, 153)"
7297,2020-04-26,Dominica,0,0,16,"rgb(165, 170, 153)"
7298,2020-04-27,Dominica,0,0,16,"rgb(165, 170, 153)"
7299,2020-04-28,Dominica,0,0,16,"rgb(165, 170, 153)"
7300,2020-04-29,Dominica,0,0,16,"rgb(165, 170, 153)"
7301,2020-04-30,Dominica,0,0,16,"rgb(165, 170, 153)"
7302,2020-05-01,Dominica,0,0,16,"rgb(165, 170, 153)"
7303,2020-05-02,Dominica,0,0,16,"rgb(165, 170, 153)"
7304,2020-05-03,Dominica,0,0,16,"rgb(165, 170, 153)"
7305,2020-05-04,Dominica,0,0,16,"rgb(165, 170, 153)"
7306,2020-05-05,Dominica,0,0,16,"rgb(165, 170, 153)"
7307,2020-05-06,Dominica,0,0,16,"rgb(165, 170, 153)"
7308,2020-05-07,Dominica,0,0,16,"rgb(165, 170, 153)"
7309,2020-05-08,Dominica,0,0,16,"rgb(165, 170, 153)"
7310,2020-05-09,Dominica,0,0,16,"rgb(165, 170, 153)"
7311,2020-05-10,Dominica,0,0,16,"rgb(165, 170, 153)"
7312,2020-05-11,Dominica,0,0,16,"rgb(165, 170, 153)"
7313,2020-05-12,Dominica,0,0,16,"rgb(165, 170, 153)"
7314,2020-05-13,Dominica,0,0,16,"rgb(165, 170, 153)"
7315,2020-05-14,Dominica,0,0,16,"rgb(165, 170, 153)"
7316,2020-05-15,Dominica,0,0,16,"rgb(165, 170, 153)"
7317,2020-05-16,Dominica,0,0,16,"rgb(165, 170, 153)"
7318,2020-05-17,Dominica,0,0,16,"rgb(165, 170, 153)"
7319,2020-05-18,Dominica,0,0,16,"rgb(165, 170, 153)"
7320,2020-05-19,Dominica,0,0,16,"rgb(165, 170, 153)"
7321,2020-05-20,Dominica,0,0,16,"rgb(165, 170, 153)"
7322,2020-05-21,Dominica,0,0,16,"rgb(165, 170, 153)"
7323,2020-05-22,Dominica,0,0,16,"rgb(165, 170, 153)"
7324,2020-05-23,Dominica,0,0,16,"rgb(165, 170, 153)"
7325,2020-05-24,Dominica,0,0,16,"rgb(165, 170, 153)"
7326,2020-05-25,Dominica,0,0,16,"rgb(165, 170, 153)"
7327,2020-05-26,Dominica,0,0,16,"rgb(165, 170, 153)"
7328,2020-05-27,Dominica,0,0,16,"rgb(165, 170, 153)"
7329,2020-05-28,Dominica,0,0,16,"rgb(165, 170, 153)"
7330,2020-05-29,Dominica,0,0,16,"rgb(165, 170, 153)"
7331,2020-05-30,Dominica,0,0,16,"rgb(165, 170, 153)"
7332,2020-05-31,Dominica,0,0,16,"rgb(165, 170, 153)"
7333,2020-06-01,Dominica,0,0,16,"rgb(165, 170, 153)"
7334,2020-06-02,Dominica,0,2,18,"rgb(165, 170, 153)"
7335,2020-06-03,Dominica,0,0,18,"rgb(165, 170, 153)"
7336,2020-06-04,Dominica,0,0,18,"rgb(165, 170, 153)"
7337,2020-06-05,Dominica,0,0,18,"rgb(165, 170, 153)"
7338,2020-06-06,Dominica,0,0,18,"rgb(165, 170, 153)"
7339,2020-06-07,Dominica,0,0,18,"rgb(165, 170, 153)"
7340,2020-06-08,Dominica,0,0,18,"rgb(165, 170, 153)"
7341,2020-06-09,Dominica,0,0,18,"rgb(165, 170, 153)"
7342,2020-06-10,Dominica,0,0,18,"rgb(165, 170, 153)"
7343,2020-06-11,Dominica,0,0,18,"rgb(165, 170, 153)"
7344,2020-06-12,Dominica,0,0,18,"rgb(165, 170, 153)"
7345,2020-06-13,Dominica,0,0,18,"rgb(165, 170, 153)"
7346,2020-06-14,Dominica,0,0,18,"rgb(165, 170, 153)"
7347,2020-06-15,Dominica,0,0,18,"rgb(165, 170, 153)"
7348,2020-06-16,Dominica,0,0,18,"rgb(165, 170, 153)"
7349,2020-06-17,Dominica,0,0,18,"rgb(165, 170, 153)"
7350,2020-06-18,Dominica,0,0,18,"rgb(165, 170, 153)"
7351,2020-06-19,Dominica,0,0,18,"rgb(165, 170, 153)"
7352,2020-06-20,Dominica,0,0,18,"rgb(165, 170, 153)"
7353,2020-06-21,Dominica,0,0,18,"rgb(165, 170, 153)"
7354,2020-06-22,Dominica,0,0,18,"rgb(165, 170, 153)"
7355,2020-06-23,Dominica,0,0,18,"rgb(165, 170, 153)"
7356,2020-06-24,Dominica,0,0,18,"rgb(165, 170, 153)"
7357,2020-06-25,Dominica,0,0,18,"rgb(165, 170, 153)"
7358,2020-06-26,Dominica,0,0,18,"rgb(165, 170, 153)"
7359,2020-06-27,Dominica,0,0,18,"rgb(165, 170, 153)"
7360,2020-06-28,Dominica,0,0,18,"rgb(165, 170, 153)"
7361,2020-06-29,Dominica,0,0,18,"rgb(165, 170, 153)"
7362,2020-06-30,Dominica,0,0,18,"rgb(165, 170, 153)"
7363,2020-07-01,Dominica,0,0,18,"rgb(165, 170, 153)"
7364,2020-07-02,Dominica,0,0,18,"rgb(165, 170, 153)"
7365,2020-07-03,Dominica,0,0,18,"rgb(165, 170, 153)"
7366,2020-07-04,Dominica,0,0,18,"rgb(165, 170, 153)"
7367,2020-07-05,Dominica,0,0,18,"rgb(165, 170, 153)"
7368,2020-07-06,Dominica,0,0,18,"rgb(165, 170, 153)"
7369,2020-07-07,Dominica,0,0,18,"rgb(165, 170, 153)"
7370,2020-07-08,Dominica,0,0,18,"rgb(165, 170, 153)"
7371,2020-07-09,Dominica,0,0,18,"rgb(165, 170, 153)"
7372,2020-07-10,Dominica,0,0,18,"rgb(165, 170, 153)"
7373,2020-07-11,Dominica,0,0,18,"rgb(165, 170, 153)"
7374,2020-07-12,Dominica,0,0,18,"rgb(165, 170, 153)"
7375,2020-07-13,Dominica,0,0,18,"rgb(165, 170, 153)"
7376,2019-12-31,Dominican Republic,0,0,0,"rgb(27,158,119)"
7377,2020-01-01,Dominican Republic,0,0,0,"rgb(27,158,119)"
7378,2020-01-02,Dominican Republic,0,0,0,"rgb(27,158,119)"
7379,2020-01-03,Dominican Republic,0,0,0,"rgb(27,158,119)"
7380,2020-01-04,Dominican Republic,0,0,0,"rgb(27,158,119)"
7381,2020-01-05,Dominican Republic,0,0,0,"rgb(27,158,119)"
7382,2020-01-06,Dominican Republic,0,0,0,"rgb(27,158,119)"
7383,2020-01-07,Dominican Republic,0,0,0,"rgb(27,158,119)"
7384,2020-01-08,Dominican Republic,0,0,0,"rgb(27,158,119)"
7385,2020-01-09,Dominican Republic,0,0,0,"rgb(27,158,119)"
7386,2020-01-10,Dominican Republic,0,0,0,"rgb(27,158,119)"
7387,2020-01-11,Dominican Republic,0,0,0,"rgb(27,158,119)"
7388,2020-01-12,Dominican Republic,0,0,0,"rgb(27,158,119)"
7389,2020-01-13,Dominican Republic,0,0,0,"rgb(27,158,119)"
7390,2020-01-14,Dominican Republic,0,0,0,"rgb(27,158,119)"
7391,2020-01-15,Dominican Republic,0,0,0,"rgb(27,158,119)"
7392,2020-01-16,Dominican Republic,0,0,0,"rgb(27,158,119)"
7393,2020-01-17,Dominican Republic,0,0,0,"rgb(27,158,119)"
7394,2020-01-18,Dominican Republic,0,0,0,"rgb(27,158,119)"
7395,2020-01-19,Dominican Republic,0,0,0,"rgb(27,158,119)"
7396,2020-01-20,Dominican Republic,0,0,0,"rgb(27,158,119)"
7397,2020-01-21,Dominican Republic,0,0,0,"rgb(27,158,119)"
7398,2020-01-22,Dominican Republic,0,0,0,"rgb(27,158,119)"
7399,2020-01-23,Dominican Republic,0,0,0,"rgb(27,158,119)"
7400,2020-01-24,Dominican Republic,0,0,0,"rgb(27,158,119)"
7401,2020-01-25,Dominican Republic,0,0,0,"rgb(27,158,119)"
7402,2020-01-26,Dominican Republic,0,0,0,"rgb(27,158,119)"
7403,2020-01-27,Dominican Republic,0,0,0,"rgb(27,158,119)"
7404,2020-01-28,Dominican Republic,0,0,0,"rgb(27,158,119)"
7405,2020-01-29,Dominican Republic,0,0,0,"rgb(27,158,119)"
7406,2020-01-30,Dominican Republic,0,0,0,"rgb(27,158,119)"
7407,2020-01-31,Dominican Republic,0,0,0,"rgb(27,158,119)"
7408,2020-02-01,Dominican Republic,0,0,0,"rgb(27,158,119)"
7409,2020-02-02,Dominican Republic,0,0,0,"rgb(27,158,119)"
7410,2020-02-03,Dominican Republic,0,0,0,"rgb(27,158,119)"
7411,2020-02-04,Dominican Republic,0,0,0,"rgb(27,158,119)"
7412,2020-02-05,Dominican Republic,0,0,0,"rgb(27,158,119)"
7413,2020-02-06,Dominican Republic,0,0,0,"rgb(27,158,119)"
7414,2020-02-07,Dominican Republic,0,0,0,"rgb(27,158,119)"
7415,2020-02-08,Dominican Republic,0,0,0,"rgb(27,158,119)"
7416,2020-02-09,Dominican Republic,0,0,0,"rgb(27,158,119)"
7417,2020-02-10,Dominican Republic,0,0,0,"rgb(27,158,119)"
7418,2020-02-11,Dominican Republic,0,0,0,"rgb(27,158,119)"
7419,2020-02-12,Dominican Republic,0,0,0,"rgb(27,158,119)"
7420,2020-02-13,Dominican Republic,0,0,0,"rgb(27,158,119)"
7421,2020-02-14,Dominican Republic,0,0,0,"rgb(27,158,119)"
7422,2020-02-15,Dominican Republic,0,0,0,"rgb(27,158,119)"
7423,2020-02-16,Dominican Republic,0,0,0,"rgb(27,158,119)"
7424,2020-02-17,Dominican Republic,0,0,0,"rgb(27,158,119)"
7425,2020-02-18,Dominican Republic,0,0,0,"rgb(27,158,119)"
7426,2020-02-19,Dominican Republic,0,0,0,"rgb(27,158,119)"
7427,2020-02-20,Dominican Republic,0,0,0,"rgb(27,158,119)"
7428,2020-02-21,Dominican Republic,0,0,0,"rgb(27,158,119)"
7429,2020-02-22,Dominican Republic,0,0,0,"rgb(27,158,119)"
7430,2020-02-23,Dominican Republic,0,0,0,"rgb(27,158,119)"
7431,2020-02-24,Dominican Republic,0,0,0,"rgb(27,158,119)"
7432,2020-02-25,Dominican Republic,0,0,0,"rgb(27,158,119)"
7433,2020-02-26,Dominican Republic,0,0,0,"rgb(27,158,119)"
7434,2020-02-27,Dominican Republic,0,0,0,"rgb(27,158,119)"
7435,2020-02-28,Dominican Republic,0,0,0,"rgb(27,158,119)"
7436,2020-02-29,Dominican Republic,0,0,0,"rgb(27,158,119)"
7437,2020-03-01,Dominican Republic,0,0,0,"rgb(27,158,119)"
7438,2020-03-02,Dominican Republic,0,1,1,"rgb(27,158,119)"
7439,2020-03-07,Dominican Republic,0,1,2,"rgb(27,158,119)"
7440,2020-03-10,Dominican Republic,0,3,5,"rgb(27,158,119)"
7441,2020-03-14,Dominican Republic,0,6,11,"rgb(27,158,119)"
7442,2020-03-15,Dominican Republic,0,0,11,"rgb(27,158,119)"
7443,2020-03-16,Dominican Republic,0,0,11,"rgb(27,158,119)"
7444,2020-03-17,Dominican Republic,0,0,11,"rgb(27,158,119)"
7445,2020-03-18,Dominican Republic,0,0,11,"rgb(27,158,119)"
7446,2020-03-19,Dominican Republic,0,10,21,"rgb(27,158,119)"
7447,2020-03-20,Dominican Republic,0,0,21,"rgb(27,158,119)"
7448,2020-03-21,Dominican Republic,2,13,34,"rgb(27,158,119)"
7449,2020-03-22,Dominican Republic,1,78,112,"rgb(27,158,119)"
7450,2020-03-23,Dominican Republic,0,90,202,"rgb(27,158,119)"
7451,2020-03-24,Dominican Republic,0,43,245,"rgb(27,158,119)"
7452,2020-03-25,Dominican Republic,3,67,312,"rgb(27,158,119)"
7453,2020-03-26,Dominican Republic,4,80,392,"rgb(27,158,119)"
7454,2020-03-27,Dominican Republic,0,96,488,"rgb(27,158,119)"
7455,2020-03-28,Dominican Republic,10,93,581,"rgb(27,158,119)"
7456,2020-03-29,Dominican Republic,8,138,719,"rgb(27,158,119)"
7457,2020-03-30,Dominican Republic,11,140,859,"rgb(27,158,119)"
7458,2020-03-31,Dominican Republic,3,42,901,"rgb(27,158,119)"
7459,2020-04-01,Dominican Republic,9,208,1109,"rgb(27,158,119)"
7460,2020-04-02,Dominican Republic,6,175,1284,"rgb(27,158,119)"
7461,2020-04-03,Dominican Republic,3,96,1380,"rgb(27,158,119)"
7462,2020-04-04,Dominican Republic,8,108,1488,"rgb(27,158,119)"
7463,2020-04-05,Dominican Republic,9,90,1578,"rgb(27,158,119)"
7464,2020-04-06,Dominican Republic,5,167,1745,"rgb(27,158,119)"
7465,2020-04-07,Dominican Republic,4,83,1828,"rgb(27,158,119)"
7466,2020-04-08,Dominican Republic,12,128,1956,"rgb(27,158,119)"
7467,2020-04-09,Dominican Republic,10,155,2111,"rgb(27,158,119)"
7468,2020-04-10,Dominican Republic,10,238,2349,"rgb(27,158,119)"
7469,2020-04-11,Dominican Republic,8,271,2620,"rgb(27,158,119)"
7470,2020-04-12,Dominican Republic,9,139,2759,"rgb(27,158,119)"
7471,2020-04-13,Dominican Republic,38,208,2967,"rgb(27,158,119)"
7472,2020-04-14,Dominican Republic,4,200,3167,"rgb(27,158,119)"
7473,2020-04-15,Dominican Republic,6,119,3286,"rgb(27,158,119)"
7474,2020-04-16,Dominican Republic,6,328,3614,"rgb(27,158,119)"
7475,2020-04-17,Dominican Republic,7,141,3755,"rgb(27,158,119)"
7476,2020-04-18,Dominican Republic,4,371,4126,"rgb(27,158,119)"
7477,2020-04-19,Dominican Republic,17,209,4335,"rgb(27,158,119)"
7478,2020-04-20,Dominican Republic,9,345,4680,"rgb(27,158,119)"
7479,2020-04-21,Dominican Republic,9,284,4964,"rgb(27,158,119)"
7480,2020-04-22,Dominican Republic,10,80,5044,"rgb(27,158,119)"
7481,2020-04-23,Dominican Republic,15,256,5300,"rgb(27,158,119)"
7482,2020-04-24,Dominican Republic,5,243,5543,"rgb(27,158,119)"
7483,2020-04-25,Dominican Republic,2,206,5749,"rgb(27,158,119)"
7484,2020-04-26,Dominican Republic,6,177,5926,"rgb(27,158,119)"
7485,2020-04-27,Dominican Republic,5,209,6135,"rgb(27,158,119)"
7486,2020-04-28,Dominican Republic,0,0,6135,"rgb(27,158,119)"
7487,2020-04-29,Dominican Republic,8,281,6416,"rgb(27,158,119)"
7488,2020-04-30,Dominican Republic,7,236,6652,"rgb(27,158,119)"
7489,2020-05-01,Dominican Republic,8,320,6972,"rgb(27,158,119)"
7490,2020-05-02,Dominican Republic,12,316,7288,"rgb(27,158,119)"
7491,2020-05-03,Dominican Republic,13,290,7578,"rgb(27,158,119)"
7492,2020-05-04,Dominican Republic,7,376,7954,"rgb(27,158,119)"
7493,2020-05-05,Dominican Republic,13,281,8235,"rgb(27,158,119)"
7494,2020-05-06,Dominican Republic,8,245,8480,"rgb(27,158,119)"
7495,2020-05-07,Dominican Republic,8,327,8807,"rgb(27,158,119)"
7496,2020-05-08,Dominican Republic,11,288,9095,"rgb(27,158,119)"
7497,2020-05-09,Dominican Republic,7,281,9376,"rgb(27,158,119)"
7498,2020-05-10,Dominican Republic,5,506,9882,"rgb(27,158,119)"
7499,2020-05-11,Dominican Republic,3,465,10347,"rgb(27,158,119)"
7500,2020-05-12,Dominican Republic,5,287,10634,"rgb(27,158,119)"
7501,2020-05-13,Dominican Republic,9,266,10900,"rgb(27,158,119)"
7502,2020-05-14,Dominican Republic,7,296,11196,"rgb(27,158,119)"
7503,2020-05-15,Dominican Republic,13,124,11320,"rgb(27,158,119)"
7504,2020-05-16,Dominican Republic,2,419,11739,"rgb(27,158,119)"
7505,2020-05-17,Dominican Republic,0,154,11893,"rgb(27,158,119)"
7506,2020-05-18,Dominican Republic,4,421,12314,"rgb(27,158,119)"
7507,2020-05-19,Dominican Republic,6,411,12725,"rgb(27,158,119)"
7508,2020-05-20,Dominican Republic,7,498,13223,"rgb(27,158,119)"
7509,2020-05-21,Dominican Republic,5,254,13477,"rgb(27,158,119)"
7510,2020-05-22,Dominican Republic,2,180,13657,"rgb(27,158,119)"
7511,2020-05-23,Dominican Republic,8,332,13989,"rgb(27,158,119)"
7512,2020-05-24,Dominican Republic,2,433,14422,"rgb(27,158,119)"
7513,2020-05-25,Dominican Republic,0,0,14422,"rgb(27,158,119)"
7514,2020-05-26,Dominican Republic,2,651,15073,"rgb(27,158,119)"
7515,2020-05-27,Dominican Republic,8,191,15264,"rgb(27,158,119)"
7516,2020-05-28,Dominican Republic,6,459,15723,"rgb(27,158,119)"
7517,2020-05-29,Dominican Republic,11,345,16068,"rgb(27,158,119)"
7518,2020-05-30,Dominican Republic,3,463,16531,"rgb(27,158,119)"
7519,2020-05-31,Dominican Republic,10,377,16908,"rgb(27,158,119)"
7520,2020-06-01,Dominican Republic,4,377,17285,"rgb(27,158,119)"
7521,2020-06-02,Dominican Republic,0,287,17572,"rgb(27,158,119)"
7522,2020-06-03,Dominican Republic,13,180,17752,"rgb(27,158,119)"
7523,2020-06-04,Dominican Republic,1,288,18040,"rgb(27,158,119)"
7524,2020-06-05,Dominican Republic,4,279,18319,"rgb(27,158,119)"
7525,2020-06-06,Dominican Republic,5,389,18708,"rgb(27,158,119)"
7526,2020-06-07,Dominican Republic,11,487,19195,"rgb(27,158,119)"
7527,2020-06-08,Dominican Republic,2,405,19600,"rgb(27,158,119)"
7528,2020-06-09,Dominican Republic,1,526,20126,"rgb(27,158,119)"
7529,2020-06-10,Dominican Republic,5,289,20415,"rgb(27,158,119)"
7530,2020-06-11,Dominican Republic,6,393,20808,"rgb(27,158,119)"
7531,2020-06-12,Dominican Republic,11,629,21437,"rgb(27,158,119)"
7532,2020-06-13,Dominican Republic,7,571,22008,"rgb(27,158,119)"
7533,2020-06-14,Dominican Republic,9,564,22572,"rgb(27,158,119)"
7534,2020-06-15,Dominican Republic,15,390,22962,"rgb(27,158,119)"
7535,2020-06-16,Dominican Republic,13,309,23271,"rgb(27,158,119)"
7536,2020-06-17,Dominican Republic,10,415,23686,"rgb(27,158,119)"
7537,2020-06-18,Dominican Republic,18,419,24105,"rgb(27,158,119)"
7538,2020-06-19,Dominican Republic,2,540,24645,"rgb(27,158,119)"
7539,2020-06-20,Dominican Republic,12,423,25068,"rgb(27,158,119)"
7540,2020-06-21,Dominican Republic,8,710,25778,"rgb(27,158,119)"
7541,2020-06-22,Dominican Republic,7,899,26677,"rgb(27,158,119)"
7542,2020-06-23,Dominican Republic,7,693,27370,"rgb(27,158,119)"
7543,2020-06-24,Dominican Republic,6,566,27936,"rgb(27,158,119)"
7544,2020-06-25,Dominican Republic,16,695,28631,"rgb(27,158,119)"
7545,2020-06-26,Dominican Republic,7,510,29141,"rgb(27,158,119)"
7546,2020-06-27,Dominican Republic,14,623,29764,"rgb(27,158,119)"
7547,2020-06-28,Dominican Republic,6,855,30619,"rgb(27,158,119)"
7548,2020-06-29,Dominican Republic,8,754,31373,"rgb(27,158,119)"
7549,2020-06-30,Dominican Republic,7,443,31816,"rgb(27,158,119)"
7550,2020-07-01,Dominican Republic,14,752,32568,"rgb(27,158,119)"
7551,2020-07-02,Dominican Republic,7,819,33387,"rgb(27,158,119)"
7552,2020-07-03,Dominican Republic,11,810,34197,"rgb(27,158,119)"
7553,2020-07-04,Dominican Republic,10,951,35148,"rgb(27,158,119)"
7554,2020-07-05,Dominican Republic,11,1036,36184,"rgb(27,158,119)"
7555,2020-07-06,Dominican Republic,8,1241,37425,"rgb(27,158,119)"
7556,2020-07-07,Dominican Republic,10,703,38128,"rgb(27,158,119)"
7557,2020-07-08,Dominican Republic,17,302,38430,"rgb(27,158,119)"
7558,2020-07-09,Dominican Republic,8,1158,39588,"rgb(27,158,119)"
7559,2020-07-10,Dominican Republic,13,1202,40790,"rgb(27,158,119)"
7560,2020-07-11,Dominican Republic,22,1125,41915,"rgb(27,158,119)"
7561,2020-07-12,Dominican Republic,16,1199,43114,"rgb(27,158,119)"
7562,2020-07-13,Dominican Republic,17,1418,44532,"rgb(27,158,119)"
7563,2019-12-31,Algeria,0,0,0,"rgb(217,95,2)"
7564,2020-01-01,Algeria,0,0,0,"rgb(217,95,2)"
7565,2020-01-02,Algeria,0,0,0,"rgb(217,95,2)"
7566,2020-01-03,Algeria,0,0,0,"rgb(217,95,2)"
7567,2020-01-04,Algeria,0,0,0,"rgb(217,95,2)"
7568,2020-01-05,Algeria,0,0,0,"rgb(217,95,2)"
7569,2020-01-06,Algeria,0,0,0,"rgb(217,95,2)"
7570,2020-01-07,Algeria,0,0,0,"rgb(217,95,2)"
7571,2020-01-08,Algeria,0,0,0,"rgb(217,95,2)"
7572,2020-01-09,Algeria,0,0,0,"rgb(217,95,2)"
7573,2020-01-10,Algeria,0,0,0,"rgb(217,95,2)"
7574,2020-01-11,Algeria,0,0,0,"rgb(217,95,2)"
7575,2020-01-12,Algeria,0,0,0,"rgb(217,95,2)"
7576,2020-01-13,Algeria,0,0,0,"rgb(217,95,2)"
7577,2020-01-14,Algeria,0,0,0,"rgb(217,95,2)"
7578,2020-01-15,Algeria,0,0,0,"rgb(217,95,2)"
7579,2020-01-16,Algeria,0,0,0,"rgb(217,95,2)"
7580,2020-01-17,Algeria,0,0,0,"rgb(217,95,2)"
7581,2020-01-18,Algeria,0,0,0,"rgb(217,95,2)"
7582,2020-01-19,Algeria,0,0,0,"rgb(217,95,2)"
7583,2020-01-20,Algeria,0,0,0,"rgb(217,95,2)"
7584,2020-01-21,Algeria,0,0,0,"rgb(217,95,2)"
7585,2020-01-22,Algeria,0,0,0,"rgb(217,95,2)"
7586,2020-01-23,Algeria,0,0,0,"rgb(217,95,2)"
7587,2020-01-24,Algeria,0,0,0,"rgb(217,95,2)"
7588,2020-01-25,Algeria,0,0,0,"rgb(217,95,2)"
7589,2020-01-26,Algeria,0,0,0,"rgb(217,95,2)"
7590,2020-01-27,Algeria,0,0,0,"rgb(217,95,2)"
7591,2020-01-28,Algeria,0,0,0,"rgb(217,95,2)"
7592,2020-01-29,Algeria,0,0,0,"rgb(217,95,2)"
7593,2020-01-30,Algeria,0,0,0,"rgb(217,95,2)"
7594,2020-01-31,Algeria,0,0,0,"rgb(217,95,2)"
7595,2020-02-01,Algeria,0,0,0,"rgb(217,95,2)"
7596,2020-02-02,Algeria,0,0,0,"rgb(217,95,2)"
7597,2020-02-03,Algeria,0,0,0,"rgb(217,95,2)"
7598,2020-02-04,Algeria,0,0,0,"rgb(217,95,2)"
7599,2020-02-05,Algeria,0,0,0,"rgb(217,95,2)"
7600,2020-02-06,Algeria,0,0,0,"rgb(217,95,2)"
7601,2020-02-07,Algeria,0,0,0,"rgb(217,95,2)"
7602,2020-02-08,Algeria,0,0,0,"rgb(217,95,2)"
7603,2020-02-09,Algeria,0,0,0,"rgb(217,95,2)"
7604,2020-02-10,Algeria,0,0,0,"rgb(217,95,2)"
7605,2020-02-11,Algeria,0,0,0,"rgb(217,95,2)"
7606,2020-02-12,Algeria,0,0,0,"rgb(217,95,2)"
7607,2020-02-13,Algeria,0,0,0,"rgb(217,95,2)"
7608,2020-02-14,Algeria,0,0,0,"rgb(217,95,2)"
7609,2020-02-15,Algeria,0,0,0,"rgb(217,95,2)"
7610,2020-02-16,Algeria,0,0,0,"rgb(217,95,2)"
7611,2020-02-17,Algeria,0,0,0,"rgb(217,95,2)"
7612,2020-02-18,Algeria,0,0,0,"rgb(217,95,2)"
7613,2020-02-19,Algeria,0,0,0,"rgb(217,95,2)"
7614,2020-02-20,Algeria,0,0,0,"rgb(217,95,2)"
7615,2020-02-21,Algeria,0,0,0,"rgb(217,95,2)"
7616,2020-02-22,Algeria,0,0,0,"rgb(217,95,2)"
7617,2020-02-23,Algeria,0,0,0,"rgb(217,95,2)"
7618,2020-02-24,Algeria,0,0,0,"rgb(217,95,2)"
7619,2020-02-25,Algeria,0,0,0,"rgb(217,95,2)"
7620,2020-02-26,Algeria,0,1,1,"rgb(217,95,2)"
7621,2020-02-27,Algeria,0,0,1,"rgb(217,95,2)"
7622,2020-02-28,Algeria,0,0,1,"rgb(217,95,2)"
7623,2020-02-29,Algeria,0,0,1,"rgb(217,95,2)"
7624,2020-03-01,Algeria,0,2,3,"rgb(217,95,2)"
7625,2020-03-02,Algeria,0,0,3,"rgb(217,95,2)"
7626,2020-03-04,Algeria,0,2,5,"rgb(217,95,2)"
7627,2020-03-05,Algeria,0,7,12,"rgb(217,95,2)"
7628,2020-03-06,Algeria,0,5,17,"rgb(217,95,2)"
7629,2020-03-09,Algeria,0,3,20,"rgb(217,95,2)"
7630,2020-03-12,Algeria,0,0,20,"rgb(217,95,2)"
7631,2020-03-13,Algeria,1,5,25,"rgb(217,95,2)"
7632,2020-03-14,Algeria,1,1,26,"rgb(217,95,2)"
7633,2020-03-15,Algeria,0,11,37,"rgb(217,95,2)"
7634,2020-03-16,Algeria,2,11,48,"rgb(217,95,2)"
7635,2020-03-17,Algeria,0,10,58,"rgb(217,95,2)"
7636,2020-03-18,Algeria,1,2,60,"rgb(217,95,2)"
7637,2020-03-19,Algeria,1,12,72,"rgb(217,95,2)"
7638,2020-03-20,Algeria,1,18,90,"rgb(217,95,2)"
7639,2020-03-21,Algeria,3,12,102,"rgb(217,95,2)"
7640,2020-03-22,Algeria,5,37,139,"rgb(217,95,2)"
7641,2020-03-23,Algeria,2,62,201,"rgb(217,95,2)"
7642,2020-03-24,Algeria,0,29,230,"rgb(217,95,2)"
7643,2020-03-25,Algeria,2,34,264,"rgb(217,95,2)"
7644,2020-03-26,Algeria,2,38,302,"rgb(217,95,2)"
7645,2020-03-27,Algeria,4,65,367,"rgb(217,95,2)"
7646,2020-03-28,Algeria,1,42,409,"rgb(217,95,2)"
7647,2020-03-29,Algeria,3,45,454,"rgb(217,95,2)"
7648,2020-03-30,Algeria,2,57,511,"rgb(217,95,2)"
7649,2020-03-31,Algeria,4,73,584,"rgb(217,95,2)"
7650,2020-04-01,Algeria,9,132,716,"rgb(217,95,2)"
7651,2020-04-02,Algeria,14,131,847,"rgb(217,95,2)"
7652,2020-04-03,Algeria,5,139,986,"rgb(217,95,2)"
7653,2020-04-04,Algeria,42,185,1171,"rgb(217,95,2)"
7654,2020-04-05,Algeria,25,80,1251,"rgb(217,95,2)"
7655,2020-04-06,Algeria,22,69,1320,"rgb(217,95,2)"
7656,2020-04-07,Algeria,21,103,1423,"rgb(217,95,2)"
7657,2020-04-08,Algeria,20,45,1468,"rgb(217,95,2)"
7658,2020-04-09,Algeria,12,104,1572,"rgb(217,95,2)"
7659,2020-04-10,Algeria,30,94,1666,"rgb(217,95,2)"
7660,2020-04-11,Algeria,21,95,1761,"rgb(217,95,2)"
7661,2020-04-12,Algeria,19,64,1825,"rgb(217,95,2)"
7662,2020-04-13,Algeria,18,89,1914,"rgb(217,95,2)"
7663,2020-04-14,Algeria,20,69,1983,"rgb(217,95,2)"
7664,2020-04-15,Algeria,12,87,2070,"rgb(217,95,2)"
7665,2020-04-16,Algeria,11,90,2160,"rgb(217,95,2)"
7666,2020-04-17,Algeria,12,108,2268,"rgb(217,95,2)"
7667,2020-04-18,Algeria,16,150,2418,"rgb(217,95,2)"
7668,2020-04-19,Algeria,3,117,2535,"rgb(217,95,2)"
7669,2020-04-20,Algeria,8,94,2629,"rgb(217,95,2)"
7670,2020-04-21,Algeria,9,89,2718,"rgb(217,95,2)"
7671,2020-04-22,Algeria,8,93,2811,"rgb(217,95,2)"
7672,2020-04-23,Algeria,10,99,2910,"rgb(217,95,2)"
7673,2020-04-24,Algeria,5,97,3007,"rgb(217,95,2)"
7674,2020-04-25,Algeria,8,120,3127,"rgb(217,95,2)"
7675,2020-04-26,Algeria,4,129,3256,"rgb(217,95,2)"
7676,2020-04-27,Algeria,6,126,3382,"rgb(217,95,2)"
7677,2020-04-28,Algeria,7,135,3517,"rgb(217,95,2)"
7678,2020-04-29,Algeria,5,132,3649,"rgb(217,95,2)"
7679,2020-04-30,Algeria,7,199,3848,"rgb(217,95,2)"
7680,2020-05-01,Algeria,6,158,4006,"rgb(217,95,2)"
7681,2020-05-02,Algeria,3,148,4154,"rgb(217,95,2)"
7682,2020-05-03,Algeria,6,141,4295,"rgb(217,95,2)"
7683,2020-05-04,Algeria,4,179,4474,"rgb(217,95,2)"
7684,2020-05-05,Algeria,2,174,4648,"rgb(217,95,2)"
7685,2020-05-06,Algeria,5,190,4838,"rgb(217,95,2)"
7686,2020-05-07,Algeria,6,159,4997,"rgb(217,95,2)"
7687,2020-05-08,Algeria,7,185,5182,"rgb(217,95,2)"
7688,2020-05-09,Algeria,5,187,5369,"rgb(217,95,2)"
7689,2020-05-10,Algeria,6,189,5558,"rgb(217,95,2)"
7690,2020-05-11,Algeria,8,165,5723,"rgb(217,95,2)"
7691,2020-05-12,Algeria,5,168,5891,"rgb(217,95,2)"
7692,2020-05-13,Algeria,8,176,6067,"rgb(217,95,2)"
7693,2020-05-14,Algeria,7,186,6253,"rgb(217,95,2)"
7694,2020-05-15,Algeria,7,189,6442,"rgb(217,95,2)"
7695,2020-05-16,Algeria,7,187,6629,"rgb(217,95,2)"
7696,2020-05-17,Algeria,6,192,6821,"rgb(217,95,2)"
7697,2020-05-18,Algeria,6,198,7019,"rgb(217,95,2)"
7698,2020-05-19,Algeria,7,182,7201,"rgb(217,95,2)"
7699,2020-05-20,Algeria,6,176,7377,"rgb(217,95,2)"
7700,2020-05-21,Algeria,7,165,7542,"rgb(217,95,2)"
7701,2020-05-22,Algeria,7,186,7728,"rgb(217,95,2)"
7702,2020-05-23,Algeria,7,190,7918,"rgb(217,95,2)"
7703,2020-05-24,Algeria,10,195,8113,"rgb(217,95,2)"
7704,2020-05-25,Algeria,8,193,8306,"rgb(217,95,2)"
7705,2020-05-26,Algeria,9,197,8503,"rgb(217,95,2)"
7706,2020-05-27,Algeria,8,194,8697,"rgb(217,95,2)"
7707,2020-05-28,Algeria,6,160,8857,"rgb(217,95,2)"
7708,2020-05-29,Algeria,7,140,8997,"rgb(217,95,2)"
7709,2020-05-30,Algeria,8,137,9134,"rgb(217,95,2)"
7710,2020-05-31,Algeria,8,133,9267,"rgb(217,95,2)"
7711,2020-06-01,Algeria,7,127,9394,"rgb(217,95,2)"
7712,2020-06-02,Algeria,8,119,9513,"rgb(217,95,2)"
7713,2020-06-03,Algeria,6,113,9626,"rgb(217,95,2)"
7714,2020-06-04,Algeria,0,0,9626,"rgb(217,95,2)"
7715,2020-06-05,Algeria,14,205,9831,"rgb(217,95,2)"
7716,2020-06-06,Algeria,9,104,9935,"rgb(217,95,2)"
7717,2020-06-07,Algeria,8,115,10050,"rgb(217,95,2)"
7718,2020-06-08,Algeria,9,104,10154,"rgb(217,95,2)"
7719,2020-06-09,Algeria,8,111,10265,"rgb(217,95,2)"
7720,2020-06-10,Algeria,9,117,10382,"rgb(217,95,2)"
7721,2020-06-11,Algeria,8,102,10484,"rgb(217,95,2)"
7722,2020-06-12,Algeria,9,105,10589,"rgb(217,95,2)"
7723,2020-06-13,Algeria,10,109,10698,"rgb(217,95,2)"
7724,2020-06-14,Algeria,9,112,10810,"rgb(217,95,2)"
7725,2020-06-15,Algeria,7,109,10919,"rgb(217,95,2)"
7726,2020-06-16,Algeria,10,112,11031,"rgb(217,95,2)"
7727,2020-06-17,Algeria,11,116,11147,"rgb(217,95,2)"
7728,2020-06-18,Algeria,11,121,11268,"rgb(217,95,2)"
7729,2020-06-19,Algeria,12,117,11385,"rgb(217,95,2)"
7730,2020-06-20,Algeria,14,119,11504,"rgb(217,95,2)"
7731,2020-06-21,Algeria,12,127,11631,"rgb(217,95,2)"
7732,2020-06-22,Algeria,8,140,11771,"rgb(217,95,2)"
7733,2020-06-23,Algeria,7,149,11920,"rgb(217,95,2)"
7734,2020-06-24,Algeria,9,156,12076,"rgb(217,95,2)"
7735,2020-06-25,Algeria,8,172,12248,"rgb(217,95,2)"
7736,2020-06-26,Algeria,9,197,12445,"rgb(217,95,2)"
7737,2020-06-27,Algeria,7,240,12685,"rgb(217,95,2)"
7738,2020-06-28,Algeria,7,283,12968,"rgb(217,95,2)"
7739,2020-06-29,Algeria,5,305,13273,"rgb(217,95,2)"
7740,2020-06-30,Algeria,8,298,13571,"rgb(217,95,2)"
7741,2020-07-01,Algeria,7,336,13907,"rgb(217,95,2)"
7742,2020-07-02,Algeria,8,365,14272,"rgb(217,95,2)"
7743,2020-07-03,Algeria,8,385,14657,"rgb(217,95,2)"
7744,2020-07-04,Algeria,9,413,15070,"rgb(217,95,2)"
7745,2020-07-05,Algeria,9,430,15500,"rgb(217,95,2)"
7746,2020-07-06,Algeria,6,441,15941,"rgb(217,95,2)"
7747,2020-07-07,Algeria,7,463,16404,"rgb(217,95,2)"
7748,2020-07-08,Algeria,9,475,16879,"rgb(217,95,2)"
7749,2020-07-09,Algeria,10,469,17348,"rgb(217,95,2)"
7750,2020-07-10,Algeria,10,460,17808,"rgb(217,95,2)"
7751,2020-07-11,Algeria,0,0,17808,"rgb(217,95,2)"
7752,2020-07-12,Algeria,16,904,18712,"rgb(217,95,2)"
7753,2020-07-13,Algeria,7,483,19195,"rgb(217,95,2)"
7754,2019-12-31,Ecuador,0,0,0,"rgb(117,112,179)"
7755,2020-01-01,Ecuador,0,0,0,"rgb(117,112,179)"
7756,2020-01-02,Ecuador,0,0,0,"rgb(117,112,179)"
7757,2020-01-03,Ecuador,0,0,0,"rgb(117,112,179)"
7758,2020-01-04,Ecuador,0,0,0,"rgb(117,112,179)"
7759,2020-01-05,Ecuador,0,0,0,"rgb(117,112,179)"
7760,2020-01-06,Ecuador,0,0,0,"rgb(117,112,179)"
7761,2020-01-07,Ecuador,0,0,0,"rgb(117,112,179)"
7762,2020-01-08,Ecuador,0,0,0,"rgb(117,112,179)"
7763,2020-01-09,Ecuador,0,0,0,"rgb(117,112,179)"
7764,2020-01-10,Ecuador,0,0,0,"rgb(117,112,179)"
7765,2020-01-11,Ecuador,0,0,0,"rgb(117,112,179)"
7766,2020-01-12,Ecuador,0,0,0,"rgb(117,112,179)"
7767,2020-01-13,Ecuador,0,0,0,"rgb(117,112,179)"
7768,2020-01-14,Ecuador,0,0,0,"rgb(117,112,179)"
7769,2020-01-15,Ecuador,0,0,0,"rgb(117,112,179)"
7770,2020-01-16,Ecuador,0,0,0,"rgb(117,112,179)"
7771,2020-01-17,Ecuador,0,0,0,"rgb(117,112,179)"
7772,2020-01-18,Ecuador,0,0,0,"rgb(117,112,179)"
7773,2020-01-19,Ecuador,0,0,0,"rgb(117,112,179)"
7774,2020-01-20,Ecuador,0,0,0,"rgb(117,112,179)"
7775,2020-01-21,Ecuador,0,0,0,"rgb(117,112,179)"
7776,2020-01-22,Ecuador,0,0,0,"rgb(117,112,179)"
7777,2020-01-23,Ecuador,0,0,0,"rgb(117,112,179)"
7778,2020-01-24,Ecuador,0,0,0,"rgb(117,112,179)"
7779,2020-01-25,Ecuador,0,0,0,"rgb(117,112,179)"
7780,2020-01-26,Ecuador,0,0,0,"rgb(117,112,179)"
7781,2020-01-27,Ecuador,0,0,0,"rgb(117,112,179)"
7782,2020-01-28,Ecuador,0,0,0,"rgb(117,112,179)"
7783,2020-01-29,Ecuador,0,0,0,"rgb(117,112,179)"
7784,2020-01-30,Ecuador,0,0,0,"rgb(117,112,179)"
7785,2020-01-31,Ecuador,0,0,0,"rgb(117,112,179)"
7786,2020-02-01,Ecuador,0,0,0,"rgb(117,112,179)"
7787,2020-02-02,Ecuador,0,0,0,"rgb(117,112,179)"
7788,2020-02-03,Ecuador,0,0,0,"rgb(117,112,179)"
7789,2020-02-04,Ecuador,0,0,0,"rgb(117,112,179)"
7790,2020-02-05,Ecuador,0,0,0,"rgb(117,112,179)"
7791,2020-02-06,Ecuador,0,0,0,"rgb(117,112,179)"
7792,2020-02-07,Ecuador,0,0,0,"rgb(117,112,179)"
7793,2020-02-08,Ecuador,0,0,0,"rgb(117,112,179)"
7794,2020-02-09,Ecuador,0,0,0,"rgb(117,112,179)"
7795,2020-02-10,Ecuador,0,0,0,"rgb(117,112,179)"
7796,2020-02-11,Ecuador,0,0,0,"rgb(117,112,179)"
7797,2020-02-12,Ecuador,0,0,0,"rgb(117,112,179)"
7798,2020-02-13,Ecuador,0,0,0,"rgb(117,112,179)"
7799,2020-02-14,Ecuador,0,0,0,"rgb(117,112,179)"
7800,2020-02-15,Ecuador,0,0,0,"rgb(117,112,179)"
7801,2020-02-16,Ecuador,0,0,0,"rgb(117,112,179)"
7802,2020-02-17,Ecuador,0,0,0,"rgb(117,112,179)"
7803,2020-02-18,Ecuador,0,0,0,"rgb(117,112,179)"
7804,2020-02-19,Ecuador,0,0,0,"rgb(117,112,179)"
7805,2020-02-20,Ecuador,0,0,0,"rgb(117,112,179)"
7806,2020-02-21,Ecuador,0,0,0,"rgb(117,112,179)"
7807,2020-02-22,Ecuador,0,0,0,"rgb(117,112,179)"
7808,2020-02-23,Ecuador,0,0,0,"rgb(117,112,179)"
7809,2020-02-24,Ecuador,0,0,0,"rgb(117,112,179)"
7810,2020-02-25,Ecuador,0,0,0,"rgb(117,112,179)"
7811,2020-02-26,Ecuador,0,0,0,"rgb(117,112,179)"
7812,2020-02-27,Ecuador,0,0,0,"rgb(117,112,179)"
7813,2020-02-28,Ecuador,0,0,0,"rgb(117,112,179)"
7814,2020-02-29,Ecuador,0,0,0,"rgb(117,112,179)"
7815,2020-03-01,Ecuador,0,1,1,"rgb(117,112,179)"
7816,2020-03-02,Ecuador,0,5,6,"rgb(117,112,179)"
7817,2020-03-03,Ecuador,0,1,7,"rgb(117,112,179)"
7818,2020-03-05,Ecuador,0,3,10,"rgb(117,112,179)"
7819,2020-03-06,Ecuador,0,3,13,"rgb(117,112,179)"
7820,2020-03-09,Ecuador,0,1,14,"rgb(117,112,179)"
7821,2020-03-10,Ecuador,0,1,15,"rgb(117,112,179)"
7822,2020-03-11,Ecuador,0,2,17,"rgb(117,112,179)"
7823,2020-03-14,Ecuador,1,6,23,"rgb(117,112,179)"
7824,2020-03-15,Ecuador,1,5,28,"rgb(117,112,179)"
7825,2020-03-16,Ecuador,0,9,37,"rgb(117,112,179)"
7826,2020-03-17,Ecuador,0,21,58,"rgb(117,112,179)"
7827,2020-03-18,Ecuador,0,53,111,"rgb(117,112,179)"
7828,2020-03-19,Ecuador,1,57,168,"rgb(117,112,179)"
7829,2020-03-20,Ecuador,0,31,199,"rgb(117,112,179)"
7830,2020-03-21,Ecuador,4,227,426,"rgb(117,112,179)"
7831,2020-03-22,Ecuador,0,106,532,"rgb(117,112,179)"
7832,2020-03-23,Ecuador,7,257,789,"rgb(117,112,179)"
7833,2020-03-24,Ecuador,4,192,981,"rgb(117,112,179)"
7834,2020-03-25,Ecuador,9,101,1082,"rgb(117,112,179)"
7835,2020-03-26,Ecuador,2,129,1211,"rgb(117,112,179)"
7836,2020-03-27,Ecuador,5,192,1403,"rgb(117,112,179)"
7837,2020-03-28,Ecuador,7,224,1627,"rgb(117,112,179)"
7838,2020-03-29,Ecuador,7,208,1835,"rgb(117,112,179)"
7839,2020-03-30,Ecuador,10,55,1890,"rgb(117,112,179)"
7840,2020-03-31,Ecuador,4,76,1966,"rgb(117,112,179)"
7841,2020-04-01,Ecuador,17,336,2302,"rgb(117,112,179)"
7842,2020-04-02,Ecuador,41,456,2758,"rgb(117,112,179)"
7843,2020-04-03,Ecuador,0,405,3163,"rgb(117,112,179)"
7844,2020-04-04,Ecuador,25,205,3368,"rgb(117,112,179)"
7845,2020-04-05,Ecuador,27,97,3465,"rgb(117,112,179)"
7846,2020-04-06,Ecuador,8,181,3646,"rgb(117,112,179)"
7847,2020-04-07,Ecuador,11,101,3747,"rgb(117,112,179)"
7848,2020-04-08,Ecuador,29,248,3995,"rgb(117,112,179)"
7849,2020-04-09,Ecuador,22,455,4450,"rgb(117,112,179)"
7850,2020-04-10,Ecuador,30,515,4965,"rgb(117,112,179)"
7851,2020-04-11,Ecuador,25,2196,7161,"rgb(117,112,179)"
7852,2020-04-12,Ecuador,18,96,7257,"rgb(117,112,179)"
7853,2020-04-13,Ecuador,18,209,7466,"rgb(117,112,179)"
7854,2020-04-14,Ecuador,22,63,7529,"rgb(117,112,179)"
7855,2020-04-15,Ecuador,0,74,7603,"rgb(117,112,179)"
7856,2020-04-16,Ecuador,33,255,7858,"rgb(117,112,179)"
7857,2020-04-17,Ecuador,15,367,8225,"rgb(117,112,179)"
7858,2020-04-18,Ecuador,18,225,8450,"rgb(117,112,179)"
7859,2020-04-19,Ecuador,35,572,9022,"rgb(117,112,179)"
7860,2020-04-20,Ecuador,18,446,9468,"rgb(117,112,179)"
7861,2020-04-21,Ecuador,33,660,10128,"rgb(117,112,179)"
7862,2020-04-22,Ecuador,13,270,10398,"rgb(117,112,179)"
7863,2020-04-23,Ecuador,17,452,10850,"rgb(117,112,179)"
7864,2020-04-24,Ecuador,23,333,11183,"rgb(117,112,179)"
7865,2020-04-25,Ecuador,16,0,11183,"rgb(117,112,179)"
7866,2020-04-26,Ecuador,0,0,11183,"rgb(117,112,179)"
7867,2020-04-27,Ecuador,0,11536,22719,"rgb(117,112,179)"
7868,2020-04-28,Ecuador,87,521,23240,"rgb(117,112,179)"
7869,2020-04-29,Ecuador,208,1018,24258,"rgb(117,112,179)"
7870,2020-04-30,Ecuador,12,417,24675,"rgb(117,112,179)"
7871,2020-05-01,Ecuador,17,259,24934,"rgb(117,112,179)"
7872,2020-05-02,Ecuador,163,1402,26336,"rgb(117,112,179)"
7873,2020-05-03,Ecuador,308,1128,27464,"rgb(117,112,179)"
7874,2020-05-04,Ecuador,193,2074,29538,"rgb(117,112,179)"
7875,2020-05-05,Ecuador,5,2343,31881,"rgb(117,112,179)"
7876,2020-05-06,Ecuador,0,0,31881,"rgb(117,112,179)"
7877,2020-05-07,Ecuador,49,-2461,29420,"rgb(117,112,179)"
7878,2020-05-08,Ecuador,36,878,30298,"rgb(117,112,179)"
7879,2020-05-09,Ecuador,50,-1480,28818,"rgb(117,112,179)"
7880,2020-05-10,Ecuador,13,253,29071,"rgb(117,112,179)"
7881,2020-05-11,Ecuador,410,488,29559,"rgb(117,112,179)"
7882,2020-05-12,Ecuador,18,-50,29509,"rgb(117,112,179)"
7883,2020-05-13,Ecuador,182,910,30419,"rgb(117,112,179)"
7884,2020-05-14,Ecuador,7,67,30486,"rgb(117,112,179)"
7885,2020-05-15,Ecuador,4,16,30502,"rgb(117,112,179)"
7886,2020-05-16,Ecuador,256,965,31467,"rgb(117,112,179)"
7887,2020-05-17,Ecuador,94,1296,32763,"rgb(117,112,179)"
7888,2020-05-18,Ecuador,48,419,33182,"rgb(117,112,179)"
7889,2020-05-19,Ecuador,63,400,33582,"rgb(117,112,179)"
7890,2020-05-20,Ecuador,40,569,34151,"rgb(117,112,179)"
7891,2020-05-21,Ecuador,49,703,34854,"rgb(117,112,179)"
7892,2020-05-22,Ecuador,51,452,35306,"rgb(117,112,179)"
7893,2020-05-23,Ecuador,117,522,35828,"rgb(117,112,179)"
7894,2020-05-24,Ecuador,40,430,36258,"rgb(117,112,179)"
7895,2020-05-25,Ecuador,12,498,36756,"rgb(117,112,179)"
7896,2020-05-26,Ecuador,95,599,37355,"rgb(117,112,179)"
7897,2020-05-27,Ecuador,0,0,37355,"rgb(117,112,179)"
7898,2020-05-28,Ecuador,72,748,38103,"rgb(117,112,179)"
7899,2020-05-29,Ecuador,38,368,38471,"rgb(117,112,179)"
7900,2020-05-30,Ecuador,21,100,38571,"rgb(117,112,179)"
7901,2020-05-31,Ecuador,0,0,38571,"rgb(117,112,179)"
7902,2020-06-01,Ecuador,24,527,39098,"rgb(117,112,179)"
7903,2020-06-02,Ecuador,36,896,39994,"rgb(117,112,179)"
7904,2020-06-03,Ecuador,44,420,40414,"rgb(117,112,179)"
7905,2020-06-04,Ecuador,48,552,40966,"rgb(117,112,179)"
7906,2020-06-05,Ecuador,0,0,40966,"rgb(117,112,179)"
7907,2020-06-06,Ecuador,48,609,41575,"rgb(117,112,179)"
7908,2020-06-07,Ecuador,74,1153,42728,"rgb(117,112,179)"
7909,2020-06-08,Ecuador,13,392,43120,"rgb(117,112,179)"
7910,2020-06-09,Ecuador,21,258,43378,"rgb(117,112,179)"
7911,2020-06-10,Ecuador,48,539,43917,"rgb(117,112,179)"
7912,2020-06-11,Ecuador,30,523,44440,"rgb(117,112,179)"
7913,2020-06-12,Ecuador,0,0,44440,"rgb(117,112,179)"
7914,2020-06-13,Ecuador,108,1338,45778,"rgb(117,112,179)"
7915,2020-06-14,Ecuador,46,578,46356,"rgb(117,112,179)"
7916,2020-06-15,Ecuador,22,395,46751,"rgb(117,112,179)"
7917,2020-06-16,Ecuador,33,571,47322,"rgb(117,112,179)"
7918,2020-06-17,Ecuador,41,621,47943,"rgb(117,112,179)"
7919,2020-06-18,Ecuador,37,547,48490,"rgb(117,112,179)"
7920,2020-06-19,Ecuador,80,607,49097,"rgb(117,112,179)"
7921,2020-06-20,Ecuador,69,634,49731,"rgb(117,112,179)"
7922,2020-06-21,Ecuador,43,452,50183,"rgb(117,112,179)"
7923,2020-06-22,Ecuador,24,457,50640,"rgb(117,112,179)"
7924,2020-06-23,Ecuador,0,0,50640,"rgb(117,112,179)"
7925,2020-06-24,Ecuador,51,1003,51643,"rgb(117,112,179)"
7926,2020-06-25,Ecuador,35,691,52334,"rgb(117,112,179)"
7927,2020-06-26,Ecuador,34,822,53156,"rgb(117,112,179)"
7928,2020-06-27,Ecuador,63,700,53856,"rgb(117,112,179)"
7929,2020-06-28,Ecuador,18,718,54574,"rgb(117,112,179)"
7930,2020-06-29,Ecuador,5,681,55255,"rgb(117,112,179)"
7931,2020-06-30,Ecuador,73,410,55665,"rgb(117,112,179)"
7932,2020-07-01,Ecuador,25,767,56432,"rgb(117,112,179)"
7933,2020-07-02,Ecuador,49,1825,58257,"rgb(117,112,179)"
7934,2020-07-03,Ecuador,63,1211,59468,"rgb(117,112,179)"
7935,2020-07-04,Ecuador,61,1189,60657,"rgb(117,112,179)"
7936,2020-07-05,Ecuador,69,878,61535,"rgb(117,112,179)"
7937,2020-07-06,Ecuador,12,423,61958,"rgb(117,112,179)"
7938,2020-07-07,Ecuador,40,422,62380,"rgb(117,112,179)"
7939,2020-07-08,Ecuador,52,865,63245,"rgb(117,112,179)"
7940,2020-07-09,Ecuador,27,976,64221,"rgb(117,112,179)"
7941,2020-07-10,Ecuador,39,797,65018,"rgb(117,112,179)"
7942,2020-07-11,Ecuador,44,783,65801,"rgb(117,112,179)"
7943,2020-07-12,Ecuador,48,1408,67209,"rgb(117,112,179)"
7944,2020-07-13,Ecuador,16,661,67870,"rgb(117,112,179)"
7945,2019-12-31,Estonia,0,0,0,"rgb(231,41,138)"
7946,2020-01-01,Estonia,0,0,0,"rgb(231,41,138)"
7947,2020-01-02,Estonia,0,0,0,"rgb(231,41,138)"
7948,2020-01-03,Estonia,0,0,0,"rgb(231,41,138)"
7949,2020-01-04,Estonia,0,0,0,"rgb(231,41,138)"
7950,2020-01-05,Estonia,0,0,0,"rgb(231,41,138)"
7951,2020-01-06,Estonia,0,0,0,"rgb(231,41,138)"
7952,2020-01-07,Estonia,0,0,0,"rgb(231,41,138)"
7953,2020-01-08,Estonia,0,0,0,"rgb(231,41,138)"
7954,2020-01-09,Estonia,0,0,0,"rgb(231,41,138)"
7955,2020-01-10,Estonia,0,0,0,"rgb(231,41,138)"
7956,2020-01-11,Estonia,0,0,0,"rgb(231,41,138)"
7957,2020-01-12,Estonia,0,0,0,"rgb(231,41,138)"
7958,2020-01-13,Estonia,0,0,0,"rgb(231,41,138)"
7959,2020-01-14,Estonia,0,0,0,"rgb(231,41,138)"
7960,2020-01-15,Estonia,0,0,0,"rgb(231,41,138)"
7961,2020-01-16,Estonia,0,0,0,"rgb(231,41,138)"
7962,2020-01-17,Estonia,0,0,0,"rgb(231,41,138)"
7963,2020-01-18,Estonia,0,0,0,"rgb(231,41,138)"
7964,2020-01-19,Estonia,0,0,0,"rgb(231,41,138)"
7965,2020-01-20,Estonia,0,0,0,"rgb(231,41,138)"
7966,2020-01-21,Estonia,0,0,0,"rgb(231,41,138)"
7967,2020-01-22,Estonia,0,0,0,"rgb(231,41,138)"
7968,2020-01-23,Estonia,0,0,0,"rgb(231,41,138)"
7969,2020-01-24,Estonia,0,0,0,"rgb(231,41,138)"
7970,2020-01-25,Estonia,0,0,0,"rgb(231,41,138)"
7971,2020-01-26,Estonia,0,0,0,"rgb(231,41,138)"
7972,2020-01-27,Estonia,0,0,0,"rgb(231,41,138)"
7973,2020-01-28,Estonia,0,0,0,"rgb(231,41,138)"
7974,2020-01-29,Estonia,0,0,0,"rgb(231,41,138)"
7975,2020-01-30,Estonia,0,0,0,"rgb(231,41,138)"
7976,2020-01-31,Estonia,0,0,0,"rgb(231,41,138)"
7977,2020-02-01,Estonia,0,0,0,"rgb(231,41,138)"
7978,2020-02-02,Estonia,0,0,0,"rgb(231,41,138)"
7979,2020-02-03,Estonia,0,0,0,"rgb(231,41,138)"
7980,2020-02-04,Estonia,0,0,0,"rgb(231,41,138)"
7981,2020-02-05,Estonia,0,0,0,"rgb(231,41,138)"
7982,2020-02-06,Estonia,0,0,0,"rgb(231,41,138)"
7983,2020-02-07,Estonia,0,0,0,"rgb(231,41,138)"
7984,2020-02-08,Estonia,0,0,0,"rgb(231,41,138)"
7985,2020-02-09,Estonia,0,0,0,"rgb(231,41,138)"
7986,2020-02-10,Estonia,0,0,0,"rgb(231,41,138)"
7987,2020-02-11,Estonia,0,0,0,"rgb(231,41,138)"
7988,2020-02-12,Estonia,0,0,0,"rgb(231,41,138)"
7989,2020-02-13,Estonia,0,0,0,"rgb(231,41,138)"
7990,2020-02-14,Estonia,0,0,0,"rgb(231,41,138)"
7991,2020-02-15,Estonia,0,0,0,"rgb(231,41,138)"
7992,2020-02-16,Estonia,0,0,0,"rgb(231,41,138)"
7993,2020-02-17,Estonia,0,0,0,"rgb(231,41,138)"
7994,2020-02-18,Estonia,0,0,0,"rgb(231,41,138)"
7995,2020-02-19,Estonia,0,0,0,"rgb(231,41,138)"
7996,2020-02-20,Estonia,0,0,0,"rgb(231,41,138)"
7997,2020-02-21,Estonia,0,0,0,"rgb(231,41,138)"
7998,2020-02-22,Estonia,0,0,0,"rgb(231,41,138)"
7999,2020-02-23,Estonia,0,0,0,"rgb(231,41,138)"
8000,2020-02-24,Estonia,0,0,0,"rgb(231,41,138)"
8001,2020-02-25,Estonia,0,0,0,"rgb(231,41,138)"
8002,2020-02-26,Estonia,0,0,0,"rgb(231,41,138)"
8003,2020-02-27,Estonia,0,0,0,"rgb(231,41,138)"
8004,2020-02-28,Estonia,0,1,1,"rgb(231,41,138)"
8005,2020-02-29,Estonia,0,0,1,"rgb(231,41,138)"
8006,2020-03-01,Estonia,0,0,1,"rgb(231,41,138)"
8007,2020-03-02,Estonia,0,0,1,"rgb(231,41,138)"
8008,2020-03-04,Estonia,0,1,2,"rgb(231,41,138)"
8009,2020-03-06,Estonia,0,3,5,"rgb(231,41,138)"
8010,2020-03-07,Estonia,0,5,10,"rgb(231,41,138)"
8011,2020-03-11,Estonia,0,3,13,"rgb(231,41,138)"
8012,2020-03-12,Estonia,0,3,16,"rgb(231,41,138)"
8013,2020-03-13,Estonia,0,11,27,"rgb(231,41,138)"
8014,2020-03-14,Estonia,0,52,79,"rgb(231,41,138)"
8015,2020-03-15,Estonia,0,36,115,"rgb(231,41,138)"
8016,2020-03-16,Estonia,0,56,171,"rgb(231,41,138)"
8017,2020-03-17,Estonia,0,34,205,"rgb(231,41,138)"
8018,2020-03-18,Estonia,0,20,225,"rgb(231,41,138)"
8019,2020-03-19,Estonia,0,33,258,"rgb(231,41,138)"
8020,2020-03-20,Estonia,0,9,267,"rgb(231,41,138)"
8021,2020-03-21,Estonia,0,16,283,"rgb(231,41,138)"
8022,2020-03-22,Estonia,0,23,306,"rgb(231,41,138)"
8023,2020-03-23,Estonia,0,20,326,"rgb(231,41,138)"
8024,2020-03-24,Estonia,0,26,352,"rgb(231,41,138)"
8025,2020-03-25,Estonia,0,17,369,"rgb(231,41,138)"
8026,2020-03-26,Estonia,1,35,404,"rgb(231,41,138)"
8027,2020-03-27,Estonia,0,134,538,"rgb(231,41,138)"
8028,2020-03-28,Estonia,0,37,575,"rgb(231,41,138)"
8029,2020-03-29,Estonia,0,65,640,"rgb(231,41,138)"
8030,2020-03-30,Estonia,2,39,679,"rgb(231,41,138)"
8031,2020-03-31,Estonia,0,36,715,"rgb(231,41,138)"
8032,2020-04-01,Estonia,1,30,745,"rgb(231,41,138)"
8033,2020-04-02,Estonia,1,34,779,"rgb(231,41,138)"
8034,2020-04-03,Estonia,6,79,858,"rgb(231,41,138)"
8035,2020-04-04,Estonia,1,103,961,"rgb(231,41,138)"
8036,2020-04-05,Estonia,1,57,1018,"rgb(231,41,138)"
8037,2020-04-06,Estonia,2,79,1097,"rgb(231,41,138)"
8038,2020-04-07,Estonia,4,11,1108,"rgb(231,41,138)"
8039,2020-04-08,Estonia,2,41,1149,"rgb(231,41,138)"
8040,2020-04-09,Estonia,3,36,1185,"rgb(231,41,138)"
8041,2020-04-10,Estonia,0,22,1207,"rgb(231,41,138)"
8042,2020-04-11,Estonia,0,51,1258,"rgb(231,41,138)"
8043,2020-04-12,Estonia,0,46,1304,"rgb(231,41,138)"
8044,2020-04-13,Estonia,1,5,1309,"rgb(231,41,138)"
8045,2020-04-14,Estonia,3,23,1332,"rgb(231,41,138)"
8046,2020-04-15,Estonia,3,41,1373,"rgb(231,41,138)"
8047,2020-04-16,Estonia,4,29,1402,"rgb(231,41,138)"
8048,2020-04-17,Estonia,1,32,1434,"rgb(231,41,138)"
8049,2020-04-18,Estonia,2,25,1459,"rgb(231,41,138)"
8050,2020-04-19,Estonia,0,53,1512,"rgb(231,41,138)"
8051,2020-04-20,Estonia,2,16,1528,"rgb(231,41,138)"
8052,2020-04-21,Estonia,0,7,1535,"rgb(231,41,138)"
8053,2020-04-22,Estonia,3,17,1552,"rgb(231,41,138)"
8054,2020-04-23,Estonia,1,7,1559,"rgb(231,41,138)"
8055,2020-04-24,Estonia,1,33,1592,"rgb(231,41,138)"
8056,2020-04-25,Estonia,1,13,1605,"rgb(231,41,138)"
8057,2020-04-26,Estonia,0,30,1635,"rgb(231,41,138)"
8058,2020-04-27,Estonia,3,8,1643,"rgb(231,41,138)"
8059,2020-04-28,Estonia,1,4,1647,"rgb(231,41,138)"
8060,2020-04-29,Estonia,0,13,1660,"rgb(231,41,138)"
8061,2020-04-30,Estonia,0,6,1666,"rgb(231,41,138)"
8062,2020-05-01,Estonia,2,23,1689,"rgb(231,41,138)"
8063,2020-05-02,Estonia,0,5,1694,"rgb(231,41,138)"
8064,2020-05-03,Estonia,1,5,1699,"rgb(231,41,138)"
8065,2020-05-04,Estonia,2,1,1700,"rgb(231,41,138)"
8066,2020-05-05,Estonia,0,3,1703,"rgb(231,41,138)"
8067,2020-05-06,Estonia,0,8,1711,"rgb(231,41,138)"
8068,2020-05-07,Estonia,0,2,1713,"rgb(231,41,138)"
8069,2020-05-08,Estonia,1,7,1720,"rgb(231,41,138)"
8070,2020-05-09,Estonia,0,5,1725,"rgb(231,41,138)"
8071,2020-05-10,Estonia,4,8,1733,"rgb(231,41,138)"
8072,2020-05-11,Estonia,0,6,1739,"rgb(231,41,138)"
8073,2020-05-12,Estonia,1,2,1741,"rgb(231,41,138)"
8074,2020-05-13,Estonia,0,5,1746,"rgb(231,41,138)"
8075,2020-05-14,Estonia,0,5,1751,"rgb(231,41,138)"
8076,2020-05-15,Estonia,1,7,1758,"rgb(231,41,138)"
8077,2020-05-16,Estonia,1,8,1766,"rgb(231,41,138)"
8078,2020-05-17,Estonia,0,4,1770,"rgb(231,41,138)"
8079,2020-05-18,Estonia,0,4,1774,"rgb(231,41,138)"
8080,2020-05-19,Estonia,1,10,1784,"rgb(231,41,138)"
8081,2020-05-20,Estonia,0,7,1791,"rgb(231,41,138)"
8082,2020-05-21,Estonia,0,3,1794,"rgb(231,41,138)"
8083,2020-05-22,Estonia,0,6,1800,"rgb(231,41,138)"
8084,2020-05-23,Estonia,0,7,1807,"rgb(231,41,138)"
8085,2020-05-24,Estonia,0,14,1821,"rgb(231,41,138)"
8086,2020-05-25,Estonia,0,2,1823,"rgb(231,41,138)"
8087,2020-05-26,Estonia,1,1,1824,"rgb(231,41,138)"
8088,2020-05-27,Estonia,0,10,1834,"rgb(231,41,138)"
8089,2020-05-28,Estonia,1,6,1840,"rgb(231,41,138)"
8090,2020-05-29,Estonia,0,11,1851,"rgb(231,41,138)"
8091,2020-05-30,Estonia,1,8,1859,"rgb(231,41,138)"
8092,2020-05-31,Estonia,0,6,1865,"rgb(231,41,138)"
8093,2020-06-01,Estonia,1,4,1869,"rgb(231,41,138)"
8094,2020-06-02,Estonia,0,1,1870,"rgb(231,41,138)"
8095,2020-06-03,Estonia,0,0,1870,"rgb(231,41,138)"
8096,2020-06-04,Estonia,1,10,1880,"rgb(231,41,138)"
8097,2020-06-05,Estonia,0,10,1890,"rgb(231,41,138)"
8098,2020-06-06,Estonia,0,20,1910,"rgb(231,41,138)"
8099,2020-06-07,Estonia,0,21,1931,"rgb(231,41,138)"
8100,2020-06-08,Estonia,0,8,1939,"rgb(231,41,138)"
8101,2020-06-09,Estonia,0,1,1940,"rgb(231,41,138)"
8102,2020-06-10,Estonia,0,7,1947,"rgb(231,41,138)"
8103,2020-06-11,Estonia,0,11,1958,"rgb(231,41,138)"
8104,2020-06-12,Estonia,0,7,1965,"rgb(231,41,138)"
8105,2020-06-13,Estonia,0,5,1970,"rgb(231,41,138)"
8106,2020-06-14,Estonia,0,3,1973,"rgb(231,41,138)"
8107,2020-06-15,Estonia,0,0,1973,"rgb(231,41,138)"
8108,2020-06-16,Estonia,0,1,1974,"rgb(231,41,138)"
8109,2020-06-17,Estonia,0,1,1975,"rgb(231,41,138)"
8110,2020-06-18,Estonia,0,2,1977,"rgb(231,41,138)"
8111,2020-06-19,Estonia,0,0,1977,"rgb(231,41,138)"
8112,2020-06-20,Estonia,0,2,1979,"rgb(231,41,138)"
8113,2020-06-21,Estonia,0,2,1981,"rgb(231,41,138)"
8114,2020-06-22,Estonia,0,0,1981,"rgb(231,41,138)"
8115,2020-06-23,Estonia,0,0,1981,"rgb(231,41,138)"
8116,2020-06-24,Estonia,0,1,1982,"rgb(231,41,138)"
8117,2020-06-25,Estonia,0,1,1983,"rgb(231,41,138)"
8118,2020-06-26,Estonia,0,1,1984,"rgb(231,41,138)"
8119,2020-06-27,Estonia,0,2,1986,"rgb(231,41,138)"
8120,2020-06-28,Estonia,0,0,1986,"rgb(231,41,138)"
8121,2020-06-29,Estonia,0,1,1987,"rgb(231,41,138)"
8122,2020-06-30,Estonia,0,0,1987,"rgb(231,41,138)"
8123,2020-07-01,Estonia,0,2,1989,"rgb(231,41,138)"
8124,2020-07-02,Estonia,0,0,1989,"rgb(231,41,138)"
8125,2020-07-03,Estonia,0,1,1990,"rgb(231,41,138)"
8126,2020-07-04,Estonia,0,1,1991,"rgb(231,41,138)"
8127,2020-07-05,Estonia,0,2,1993,"rgb(231,41,138)"
8128,2020-07-06,Estonia,0,0,1993,"rgb(231,41,138)"
8129,2020-07-07,Estonia,0,1,1994,"rgb(231,41,138)"
8130,2020-07-08,Estonia,0,1,1995,"rgb(231,41,138)"
8131,2020-07-09,Estonia,0,8,2003,"rgb(231,41,138)"
8132,2020-07-10,Estonia,0,8,2011,"rgb(231,41,138)"
8133,2020-07-11,Estonia,0,2,2013,"rgb(231,41,138)"
8134,2020-07-12,Estonia,0,1,2014,"rgb(231,41,138)"
8135,2020-07-13,Estonia,0,0,2014,"rgb(231,41,138)"
8136,2019-12-31,Egypt,0,0,0,"rgb(102,166,30)"
8137,2020-01-01,Egypt,0,0,0,"rgb(102,166,30)"
8138,2020-01-02,Egypt,0,0,0,"rgb(102,166,30)"
8139,2020-01-03,Egypt,0,0,0,"rgb(102,166,30)"
8140,2020-01-04,Egypt,0,0,0,"rgb(102,166,30)"
8141,2020-01-05,Egypt,0,0,0,"rgb(102,166,30)"
8142,2020-01-06,Egypt,0,0,0,"rgb(102,166,30)"
8143,2020-01-07,Egypt,0,0,0,"rgb(102,166,30)"
8144,2020-01-08,Egypt,0,0,0,"rgb(102,166,30)"
8145,2020-01-09,Egypt,0,0,0,"rgb(102,166,30)"
8146,2020-01-10,Egypt,0,0,0,"rgb(102,166,30)"
8147,2020-01-11,Egypt,0,0,0,"rgb(102,166,30)"
8148,2020-01-12,Egypt,0,0,0,"rgb(102,166,30)"
8149,2020-01-13,Egypt,0,0,0,"rgb(102,166,30)"
8150,2020-01-14,Egypt,0,0,0,"rgb(102,166,30)"
8151,2020-01-15,Egypt,0,0,0,"rgb(102,166,30)"
8152,2020-01-16,Egypt,0,0,0,"rgb(102,166,30)"
8153,2020-01-17,Egypt,0,0,0,"rgb(102,166,30)"
8154,2020-01-18,Egypt,0,0,0,"rgb(102,166,30)"
8155,2020-01-19,Egypt,0,0,0,"rgb(102,166,30)"
8156,2020-01-20,Egypt,0,0,0,"rgb(102,166,30)"
8157,2020-01-21,Egypt,0,0,0,"rgb(102,166,30)"
8158,2020-01-22,Egypt,0,0,0,"rgb(102,166,30)"
8159,2020-01-23,Egypt,0,0,0,"rgb(102,166,30)"
8160,2020-01-24,Egypt,0,0,0,"rgb(102,166,30)"
8161,2020-01-25,Egypt,0,0,0,"rgb(102,166,30)"
8162,2020-01-26,Egypt,0,0,0,"rgb(102,166,30)"
8163,2020-01-27,Egypt,0,0,0,"rgb(102,166,30)"
8164,2020-01-28,Egypt,0,0,0,"rgb(102,166,30)"
8165,2020-01-29,Egypt,0,0,0,"rgb(102,166,30)"
8166,2020-01-30,Egypt,0,0,0,"rgb(102,166,30)"
8167,2020-01-31,Egypt,0,0,0,"rgb(102,166,30)"
8168,2020-02-01,Egypt,0,0,0,"rgb(102,166,30)"
8169,2020-02-02,Egypt,0,0,0,"rgb(102,166,30)"
8170,2020-02-03,Egypt,0,0,0,"rgb(102,166,30)"
8171,2020-02-04,Egypt,0,0,0,"rgb(102,166,30)"
8172,2020-02-05,Egypt,0,0,0,"rgb(102,166,30)"
8173,2020-02-06,Egypt,0,0,0,"rgb(102,166,30)"
8174,2020-02-07,Egypt,0,0,0,"rgb(102,166,30)"
8175,2020-02-08,Egypt,0,0,0,"rgb(102,166,30)"
8176,2020-02-09,Egypt,0,0,0,"rgb(102,166,30)"
8177,2020-02-10,Egypt,0,0,0,"rgb(102,166,30)"
8178,2020-02-11,Egypt,0,0,0,"rgb(102,166,30)"
8179,2020-02-12,Egypt,0,0,0,"rgb(102,166,30)"
8180,2020-02-13,Egypt,0,0,0,"rgb(102,166,30)"
8181,2020-02-14,Egypt,0,0,0,"rgb(102,166,30)"
8182,2020-02-15,Egypt,0,1,1,"rgb(102,166,30)"
8183,2020-02-16,Egypt,0,0,1,"rgb(102,166,30)"
8184,2020-02-17,Egypt,0,0,1,"rgb(102,166,30)"
8185,2020-02-18,Egypt,0,0,1,"rgb(102,166,30)"
8186,2020-02-19,Egypt,0,0,1,"rgb(102,166,30)"
8187,2020-02-20,Egypt,0,0,1,"rgb(102,166,30)"
8188,2020-02-21,Egypt,0,0,1,"rgb(102,166,30)"
8189,2020-02-22,Egypt,0,0,1,"rgb(102,166,30)"
8190,2020-02-23,Egypt,0,0,1,"rgb(102,166,30)"
8191,2020-02-24,Egypt,0,0,1,"rgb(102,166,30)"
8192,2020-02-25,Egypt,0,0,1,"rgb(102,166,30)"
8193,2020-02-26,Egypt,0,0,1,"rgb(102,166,30)"
8194,2020-02-27,Egypt,0,0,1,"rgb(102,166,30)"
8195,2020-02-28,Egypt,0,0,1,"rgb(102,166,30)"
8196,2020-02-29,Egypt,0,0,1,"rgb(102,166,30)"
8197,2020-03-01,Egypt,0,0,1,"rgb(102,166,30)"
8198,2020-03-02,Egypt,0,1,2,"rgb(102,166,30)"
8199,2020-03-06,Egypt,0,1,3,"rgb(102,166,30)"
8200,2020-03-07,Egypt,0,12,15,"rgb(102,166,30)"
8201,2020-03-09,Egypt,1,34,49,"rgb(102,166,30)"
8202,2020-03-10,Egypt,0,6,55,"rgb(102,166,30)"
8203,2020-03-11,Egypt,0,4,59,"rgb(102,166,30)"
8204,2020-03-12,Egypt,0,1,60,"rgb(102,166,30)"
8205,2020-03-13,Egypt,1,20,80,"rgb(102,166,30)"
8206,2020-03-14,Egypt,0,13,93,"rgb(102,166,30)"
8207,2020-03-15,Egypt,0,0,93,"rgb(102,166,30)"
8208,2020-03-16,Egypt,0,17,110,"rgb(102,166,30)"
8209,2020-03-17,Egypt,0,16,126,"rgb(102,166,30)"
8210,2020-03-18,Egypt,2,40,166,"rgb(102,166,30)"
8211,2020-03-19,Egypt,2,30,196,"rgb(102,166,30)"
8212,2020-03-20,Egypt,0,14,210,"rgb(102,166,30)"
8213,2020-03-21,Egypt,1,46,256,"rgb(102,166,30)"
8214,2020-03-22,Egypt,1,29,285,"rgb(102,166,30)"
8215,2020-03-23,Egypt,2,9,294,"rgb(102,166,30)"
8216,2020-03-24,Egypt,4,33,327,"rgb(102,166,30)"
8217,2020-03-25,Egypt,5,39,366,"rgb(102,166,30)"
8218,2020-03-26,Egypt,2,76,442,"rgb(102,166,30)"
8219,2020-03-27,Egypt,0,14,456,"rgb(102,166,30)"
8220,2020-03-28,Egypt,3,39,495,"rgb(102,166,30)"
8221,2020-03-29,Egypt,6,41,536,"rgb(102,166,30)"
8222,2020-03-30,Egypt,6,40,576,"rgb(102,166,30)"
8223,2020-03-31,Egypt,4,33,609,"rgb(102,166,30)"
8224,2020-04-01,Egypt,1,47,656,"rgb(102,166,30)"
8225,2020-04-02,Egypt,5,54,710,"rgb(102,166,30)"
8226,2020-04-03,Egypt,6,69,779,"rgb(102,166,30)"
8227,2020-04-04,Egypt,0,0,779,"rgb(102,166,30)"
8228,2020-04-05,Egypt,14,206,985,"rgb(102,166,30)"
8229,2020-04-06,Egypt,5,85,1070,"rgb(102,166,30)"
8230,2020-04-07,Egypt,7,3,1073,"rgb(102,166,30)"
8231,2020-04-08,Egypt,7,249,1322,"rgb(102,166,30)"
8232,2020-04-09,Egypt,18,238,1560,"rgb(102,166,30)"
8233,2020-04-10,Egypt,15,139,1699,"rgb(102,166,30)"
8234,2020-04-11,Egypt,17,95,1794,"rgb(102,166,30)"
8235,2020-04-12,Egypt,11,145,1939,"rgb(102,166,30)"
8236,2020-04-13,Egypt,13,126,2065,"rgb(102,166,30)"
8237,2020-04-14,Egypt,5,125,2190,"rgb(102,166,30)"
8238,2020-04-15,Egypt,14,160,2350,"rgb(102,166,30)"
8239,2020-04-16,Egypt,5,155,2505,"rgb(102,166,30)"
8240,2020-04-17,Egypt,13,168,2673,"rgb(102,166,30)"
8241,2020-04-18,Egypt,9,171,2844,"rgb(102,166,30)"
8242,2020-04-19,Egypt,19,188,3032,"rgb(102,166,30)"
8243,2020-04-20,Egypt,15,112,3144,"rgb(102,166,30)"
8244,2020-04-21,Egypt,11,189,3333,"rgb(102,166,30)"
8245,2020-04-22,Egypt,14,157,3490,"rgb(102,166,30)"
8246,2020-04-23,Egypt,0,0,3490,"rgb(102,166,30)"
8247,2020-04-24,Egypt,12,169,3659,"rgb(102,166,30)"
8248,2020-04-25,Egypt,18,433,4092,"rgb(102,166,30)"
8249,2020-04-26,Egypt,13,227,4319,"rgb(102,166,30)"
8250,2020-04-27,Egypt,0,0,4319,"rgb(102,166,30)"
8251,2020-04-28,Egypt,30,463,4782,"rgb(102,166,30)"
8252,2020-04-29,Egypt,22,260,5042,"rgb(102,166,30)"
8253,2020-04-30,Egypt,21,226,5268,"rgb(102,166,30)"
8254,2020-05-01,Egypt,12,269,5537,"rgb(102,166,30)"
8255,2020-05-02,Egypt,14,358,5895,"rgb(102,166,30)"
8256,2020-05-03,Egypt,9,298,6193,"rgb(102,166,30)"
8257,2020-05-04,Egypt,14,272,6465,"rgb(102,166,30)"
8258,2020-05-05,Egypt,7,348,6813,"rgb(102,166,30)"
8259,2020-05-06,Egypt,16,388,7201,"rgb(102,166,30)"
8260,2020-05-07,Egypt,17,387,7588,"rgb(102,166,30)"
8261,2020-05-08,Egypt,13,393,7981,"rgb(102,166,30)"
8262,2020-05-09,Egypt,21,495,8476,"rgb(102,166,30)"
8263,2020-05-10,Egypt,11,488,8964,"rgb(102,166,30)"
8264,2020-05-11,Egypt,11,436,9400,"rgb(102,166,30)"
8265,2020-05-12,Egypt,8,346,9746,"rgb(102,166,30)"
8266,2020-05-13,Egypt,11,347,10093,"rgb(102,166,30)"
8267,2020-05-14,Egypt,12,338,10431,"rgb(102,166,30)"
8268,2020-05-15,Egypt,15,398,10829,"rgb(102,166,30)"
8269,2020-05-16,Egypt,21,399,11228,"rgb(102,166,30)"
8270,2020-05-17,Egypt,20,491,11719,"rgb(102,166,30)"
8271,2020-05-18,Egypt,18,510,12229,"rgb(102,166,30)"
8272,2020-05-19,Egypt,15,535,12764,"rgb(102,166,30)"
8273,2020-05-20,Egypt,14,720,13484,"rgb(102,166,30)"
8274,2020-05-21,Egypt,21,745,14229,"rgb(102,166,30)"
8275,2020-05-22,Egypt,16,774,15003,"rgb(102,166,30)"
8276,2020-05-23,Egypt,11,783,15786,"rgb(102,166,30)"
8277,2020-05-24,Egypt,28,827,16613,"rgb(102,166,30)"
8278,2020-05-25,Egypt,29,652,17265,"rgb(102,166,30)"
8279,2020-05-26,Egypt,19,702,17967,"rgb(102,166,30)"
8280,2020-05-27,Egypt,14,789,18756,"rgb(102,166,30)"
8281,2020-05-28,Egypt,19,910,19666,"rgb(102,166,30)"
8282,2020-05-29,Egypt,29,1127,20793,"rgb(102,166,30)"
8283,2020-05-30,Egypt,34,1289,22082,"rgb(102,166,30)"
8284,2020-05-31,Egypt,34,1367,23449,"rgb(102,166,30)"
8285,2020-06-01,Egypt,46,1536,24985,"rgb(102,166,30)"
8286,2020-06-02,Egypt,46,1399,26384,"rgb(102,166,30)"
8287,2020-06-03,Egypt,47,1152,27536,"rgb(102,166,30)"
8288,2020-06-04,Egypt,36,1079,28615,"rgb(102,166,30)"
8289,2020-06-05,Egypt,38,1152,29767,"rgb(102,166,30)"
8290,2020-06-06,Egypt,40,1348,31115,"rgb(102,166,30)"
8291,2020-06-07,Egypt,32,1497,32612,"rgb(102,166,30)"
8292,2020-06-08,Egypt,39,1467,34079,"rgb(102,166,30)"
8293,2020-06-09,Egypt,34,1365,35444,"rgb(102,166,30)"
8294,2020-06-10,Egypt,35,1385,36829,"rgb(102,166,30)"
8295,2020-06-11,Egypt,36,1455,38284,"rgb(102,166,30)"
8296,2020-06-12,Egypt,35,1442,39726,"rgb(102,166,30)"
8297,2020-06-13,Egypt,45,1578,41304,"rgb(102,166,30)"
8298,2020-06-14,Egypt,62,1676,42980,"rgb(102,166,30)"
8299,2020-06-15,Egypt,91,1618,44598,"rgb(102,166,30)"
8300,2020-06-16,Egypt,97,1691,46289,"rgb(102,166,30)"
8301,2020-06-17,Egypt,94,1567,47856,"rgb(102,166,30)"
8302,2020-06-18,Egypt,84,1363,49219,"rgb(102,166,30)"
8303,2020-06-19,Egypt,88,1218,50437,"rgb(102,166,30)"
8304,2020-06-20,Egypt,79,1774,52211,"rgb(102,166,30)"
8305,2020-06-21,Egypt,89,1547,53758,"rgb(102,166,30)"
8306,2020-06-22,Egypt,87,1475,55233,"rgb(102,166,30)"
8307,2020-06-23,Egypt,85,1576,56809,"rgb(102,166,30)"
8308,2020-06-24,Egypt,87,1332,58141,"rgb(102,166,30)"
8309,2020-06-25,Egypt,0,0,58141,"rgb(102,166,30)"
8310,2020-06-26,Egypt,168,2989,61130,"rgb(102,166,30)"
8311,2020-06-27,Egypt,87,1625,62755,"rgb(102,166,30)"
8312,2020-06-28,Egypt,88,1168,63923,"rgb(102,166,30)"
8313,2020-06-29,Egypt,81,1265,65188,"rgb(102,166,30)"
8314,2020-06-30,Egypt,83,1566,66754,"rgb(102,166,30)"
8315,2020-07-01,Egypt,81,1557,68311,"rgb(102,166,30)"
8316,2020-07-02,Egypt,81,1503,69814,"rgb(102,166,30)"
8317,2020-07-03,Egypt,86,1485,71299,"rgb(102,166,30)"
8318,2020-07-04,Egypt,81,1412,72711,"rgb(102,166,30)"
8319,2020-07-05,Egypt,79,1324,74035,"rgb(102,166,30)"
8320,2020-07-06,Egypt,63,1218,75253,"rgb(102,166,30)"
8321,2020-07-07,Egypt,79,969,76222,"rgb(102,166,30)"
8322,2020-07-08,Egypt,67,1057,77279,"rgb(102,166,30)"
8323,2020-07-09,Egypt,75,1025,78304,"rgb(102,166,30)"
8324,2020-07-10,Egypt,53,950,79254,"rgb(102,166,30)"
8325,2020-07-11,Egypt,85,981,80235,"rgb(102,166,30)"
8326,2020-07-12,Egypt,67,923,81158,"rgb(102,166,30)"
8327,2020-07-13,Egypt,0,0,81158,"rgb(102,166,30)"
8328,2020-04-26,Western Sahara,0,6,6,"rgb(230,171,2)"
8329,2020-04-27,Western Sahara,0,0,6,"rgb(230,171,2)"
8330,2020-04-28,Western Sahara,0,0,6,"rgb(230,171,2)"
8331,2020-04-29,Western Sahara,0,0,6,"rgb(230,171,2)"
8332,2020-04-30,Western Sahara,0,0,6,"rgb(230,171,2)"
8333,2020-05-01,Western Sahara,0,0,6,"rgb(230,171,2)"
8334,2020-05-02,Western Sahara,0,0,6,"rgb(230,171,2)"
8335,2020-05-03,Western Sahara,0,0,6,"rgb(230,171,2)"
8336,2020-05-04,Western Sahara,0,0,6,"rgb(230,171,2)"
8337,2020-05-05,Western Sahara,0,0,6,"rgb(230,171,2)"
8338,2020-05-06,Western Sahara,0,0,6,"rgb(230,171,2)"
8339,2020-05-07,Western Sahara,0,0,6,"rgb(230,171,2)"
8340,2020-05-08,Western Sahara,0,0,6,"rgb(230,171,2)"
8341,2020-05-09,Western Sahara,0,0,6,"rgb(230,171,2)"
8342,2020-05-10,Western Sahara,0,0,6,"rgb(230,171,2)"
8343,2020-05-11,Western Sahara,0,0,6,"rgb(230,171,2)"
8344,2020-05-12,Western Sahara,0,0,6,"rgb(230,171,2)"
8345,2020-05-13,Western Sahara,0,0,6,"rgb(230,171,2)"
8346,2020-05-14,Western Sahara,0,0,6,"rgb(230,171,2)"
8347,2020-05-15,Western Sahara,0,0,6,"rgb(230,171,2)"
8348,2020-05-16,Western Sahara,0,0,6,"rgb(230,171,2)"
8349,2020-05-17,Western Sahara,0,0,6,"rgb(230,171,2)"
8350,2020-05-18,Western Sahara,0,0,6,"rgb(230,171,2)"
8351,2020-05-19,Western Sahara,0,0,6,"rgb(230,171,2)"
8352,2020-05-20,Western Sahara,0,0,6,"rgb(230,171,2)"
8353,2020-05-21,Western Sahara,0,0,6,"rgb(230,171,2)"
8354,2020-05-22,Western Sahara,0,0,6,"rgb(230,171,2)"
8355,2020-05-23,Western Sahara,0,0,6,"rgb(230,171,2)"
8356,2020-05-24,Western Sahara,0,0,6,"rgb(230,171,2)"
8357,2020-05-25,Western Sahara,0,0,6,"rgb(230,171,2)"
8358,2020-05-26,Western Sahara,0,0,6,"rgb(230,171,2)"
8359,2020-05-27,Western Sahara,0,0,6,"rgb(230,171,2)"
8360,2020-05-28,Western Sahara,0,0,6,"rgb(230,171,2)"
8361,2020-05-29,Western Sahara,0,0,6,"rgb(230,171,2)"
8362,2020-05-30,Western Sahara,1,17,23,"rgb(230,171,2)"
8363,2020-05-31,Western Sahara,0,0,23,"rgb(230,171,2)"
8364,2020-06-01,Western Sahara,0,0,23,"rgb(230,171,2)"
8365,2020-06-02,Western Sahara,0,0,23,"rgb(230,171,2)"
8366,2020-06-03,Western Sahara,0,0,23,"rgb(230,171,2)"
8367,2020-06-04,Western Sahara,0,0,23,"rgb(230,171,2)"
8368,2020-06-05,Western Sahara,0,0,23,"rgb(230,171,2)"
8369,2020-06-06,Western Sahara,0,0,23,"rgb(230,171,2)"
8370,2020-06-07,Western Sahara,0,0,23,"rgb(230,171,2)"
8371,2020-06-08,Western Sahara,0,0,23,"rgb(230,171,2)"
8372,2020-06-09,Western Sahara,0,0,23,"rgb(230,171,2)"
8373,2020-06-10,Western Sahara,0,0,23,"rgb(230,171,2)"
8374,2020-06-11,Western Sahara,0,0,23,"rgb(230,171,2)"
8375,2020-06-12,Western Sahara,0,0,23,"rgb(230,171,2)"
8376,2020-06-13,Western Sahara,0,0,23,"rgb(230,171,2)"
8377,2020-06-14,Western Sahara,0,0,23,"rgb(230,171,2)"
8378,2020-06-15,Western Sahara,0,0,23,"rgb(230,171,2)"
8379,2020-06-16,Western Sahara,0,0,23,"rgb(230,171,2)"
8380,2020-06-17,Western Sahara,0,0,23,"rgb(230,171,2)"
8381,2020-06-18,Western Sahara,0,0,23,"rgb(230,171,2)"
8382,2020-06-19,Western Sahara,0,0,23,"rgb(230,171,2)"
8383,2020-06-20,Western Sahara,0,2,25,"rgb(230,171,2)"
8384,2020-06-21,Western Sahara,0,0,25,"rgb(230,171,2)"
8385,2020-06-22,Western Sahara,0,0,25,"rgb(230,171,2)"
8386,2020-06-23,Western Sahara,0,0,25,"rgb(230,171,2)"
8387,2020-06-24,Western Sahara,0,0,25,"rgb(230,171,2)"
8388,2020-06-25,Western Sahara,0,0,25,"rgb(230,171,2)"
8389,2020-06-26,Western Sahara,0,0,25,"rgb(230,171,2)"
8390,2020-06-27,Western Sahara,0,0,25,"rgb(230,171,2)"
8391,2020-06-28,Western Sahara,0,183,208,"rgb(230,171,2)"
8392,2020-06-29,Western Sahara,0,0,208,"rgb(230,171,2)"
8393,2020-06-30,Western Sahara,0,0,208,"rgb(230,171,2)"
8394,2020-07-01,Western Sahara,0,172,380,"rgb(230,171,2)"
8395,2020-07-02,Western Sahara,0,81,461,"rgb(230,171,2)"
8396,2020-07-03,Western Sahara,0,0,461,"rgb(230,171,2)"
8397,2020-07-04,Western Sahara,0,58,519,"rgb(230,171,2)"
8398,2020-07-05,Western Sahara,0,0,519,"rgb(230,171,2)"
8399,2020-07-06,Western Sahara,0,0,519,"rgb(230,171,2)"
8400,2020-07-07,Western Sahara,0,0,519,"rgb(230,171,2)"
8401,2020-07-08,Western Sahara,0,0,519,"rgb(230,171,2)"
8402,2020-07-09,Western Sahara,0,0,519,"rgb(230,171,2)"
8403,2020-07-10,Western Sahara,0,0,519,"rgb(230,171,2)"
8404,2020-07-11,Western Sahara,0,0,519,"rgb(230,171,2)"
8405,2020-07-12,Western Sahara,0,0,519,"rgb(230,171,2)"
8406,2020-07-13,Western Sahara,0,0,519,"rgb(230,171,2)"
8407,2019-12-31,Greece,0,0,0,"rgb(166,118,29)"
8408,2020-01-01,Greece,0,0,0,"rgb(166,118,29)"
8409,2020-01-02,Greece,0,0,0,"rgb(166,118,29)"
8410,2020-01-03,Greece,0,0,0,"rgb(166,118,29)"
8411,2020-01-04,Greece,0,0,0,"rgb(166,118,29)"
8412,2020-01-05,Greece,0,0,0,"rgb(166,118,29)"
8413,2020-01-06,Greece,0,0,0,"rgb(166,118,29)"
8414,2020-01-07,Greece,0,0,0,"rgb(166,118,29)"
8415,2020-01-08,Greece,0,0,0,"rgb(166,118,29)"
8416,2020-01-09,Greece,0,0,0,"rgb(166,118,29)"
8417,2020-01-10,Greece,0,0,0,"rgb(166,118,29)"
8418,2020-01-11,Greece,0,0,0,"rgb(166,118,29)"
8419,2020-01-12,Greece,0,0,0,"rgb(166,118,29)"
8420,2020-01-13,Greece,0,0,0,"rgb(166,118,29)"
8421,2020-01-14,Greece,0,0,0,"rgb(166,118,29)"
8422,2020-01-15,Greece,0,0,0,"rgb(166,118,29)"
8423,2020-01-16,Greece,0,0,0,"rgb(166,118,29)"
8424,2020-01-17,Greece,0,0,0,"rgb(166,118,29)"
8425,2020-01-18,Greece,0,0,0,"rgb(166,118,29)"
8426,2020-01-19,Greece,0,0,0,"rgb(166,118,29)"
8427,2020-01-20,Greece,0,0,0,"rgb(166,118,29)"
8428,2020-01-21,Greece,0,0,0,"rgb(166,118,29)"
8429,2020-01-22,Greece,0,0,0,"rgb(166,118,29)"
8430,2020-01-23,Greece,0,0,0,"rgb(166,118,29)"
8431,2020-01-24,Greece,0,0,0,"rgb(166,118,29)"
8432,2020-01-25,Greece,0,0,0,"rgb(166,118,29)"
8433,2020-01-26,Greece,0,0,0,"rgb(166,118,29)"
8434,2020-01-27,Greece,0,0,0,"rgb(166,118,29)"
8435,2020-01-28,Greece,0,0,0,"rgb(166,118,29)"
8436,2020-01-29,Greece,0,0,0,"rgb(166,118,29)"
8437,2020-01-30,Greece,0,0,0,"rgb(166,118,29)"
8438,2020-01-31,Greece,0,0,0,"rgb(166,118,29)"
8439,2020-02-01,Greece,0,0,0,"rgb(166,118,29)"
8440,2020-02-02,Greece,0,0,0,"rgb(166,118,29)"
8441,2020-02-03,Greece,0,0,0,"rgb(166,118,29)"
8442,2020-02-04,Greece,0,0,0,"rgb(166,118,29)"
8443,2020-02-05,Greece,0,0,0,"rgb(166,118,29)"
8444,2020-02-06,Greece,0,0,0,"rgb(166,118,29)"
8445,2020-02-07,Greece,0,0,0,"rgb(166,118,29)"
8446,2020-02-08,Greece,0,0,0,"rgb(166,118,29)"
8447,2020-02-09,Greece,0,0,0,"rgb(166,118,29)"
8448,2020-02-10,Greece,0,0,0,"rgb(166,118,29)"
8449,2020-02-11,Greece,0,0,0,"rgb(166,118,29)"
8450,2020-02-12,Greece,0,0,0,"rgb(166,118,29)"
8451,2020-02-13,Greece,0,0,0,"rgb(166,118,29)"
8452,2020-02-14,Greece,0,0,0,"rgb(166,118,29)"
8453,2020-02-15,Greece,0,0,0,"rgb(166,118,29)"
8454,2020-02-16,Greece,0,0,0,"rgb(166,118,29)"
8455,2020-02-17,Greece,0,0,0,"rgb(166,118,29)"
8456,2020-02-18,Greece,0,0,0,"rgb(166,118,29)"
8457,2020-02-19,Greece,0,0,0,"rgb(166,118,29)"
8458,2020-02-20,Greece,0,0,0,"rgb(166,118,29)"
8459,2020-02-21,Greece,0,0,0,"rgb(166,118,29)"
8460,2020-02-22,Greece,0,0,0,"rgb(166,118,29)"
8461,2020-02-23,Greece,0,0,0,"rgb(166,118,29)"
8462,2020-02-24,Greece,0,0,0,"rgb(166,118,29)"
8463,2020-02-25,Greece,0,0,0,"rgb(166,118,29)"
8464,2020-02-26,Greece,0,0,0,"rgb(166,118,29)"
8465,2020-02-27,Greece,0,1,1,"rgb(166,118,29)"
8466,2020-02-28,Greece,0,2,3,"rgb(166,118,29)"
8467,2020-02-29,Greece,0,1,4,"rgb(166,118,29)"
8468,2020-03-01,Greece,0,3,7,"rgb(166,118,29)"
8469,2020-03-02,Greece,0,0,7,"rgb(166,118,29)"
8470,2020-03-05,Greece,0,3,10,"rgb(166,118,29)"
8471,2020-03-06,Greece,0,22,32,"rgb(166,118,29)"
8472,2020-03-07,Greece,0,13,45,"rgb(166,118,29)"
8473,2020-03-08,Greece,0,21,66,"rgb(166,118,29)"
8474,2020-03-09,Greece,0,7,73,"rgb(166,118,29)"
8475,2020-03-10,Greece,0,11,84,"rgb(166,118,29)"
8476,2020-03-11,Greece,0,6,90,"rgb(166,118,29)"
8477,2020-03-12,Greece,1,9,99,"rgb(166,118,29)"
8478,2020-03-13,Greece,0,34,133,"rgb(166,118,29)"
8479,2020-03-14,Greece,0,57,190,"rgb(166,118,29)"
8480,2020-03-15,Greece,2,38,228,"rgb(166,118,29)"
8481,2020-03-16,Greece,1,103,331,"rgb(166,118,29)"
8482,2020-03-17,Greece,0,21,352,"rgb(166,118,29)"
8483,2020-03-18,Greece,1,35,387,"rgb(166,118,29)"
8484,2020-03-19,Greece,0,31,418,"rgb(166,118,29)"
8485,2020-03-20,Greece,0,46,464,"rgb(166,118,29)"
8486,2020-03-21,Greece,3,31,495,"rgb(166,118,29)"
8487,2020-03-22,Greece,5,35,530,"rgb(166,118,29)"
8488,2020-03-23,Greece,2,94,624,"rgb(166,118,29)"
8489,2020-03-24,Greece,2,71,695,"rgb(166,118,29)"
8490,2020-03-25,Greece,3,48,743,"rgb(166,118,29)"
8491,2020-03-26,Greece,2,78,821,"rgb(166,118,29)"
8492,2020-03-27,Greece,4,71,892,"rgb(166,118,29)"
8493,2020-03-28,Greece,2,74,966,"rgb(166,118,29)"
8494,2020-03-29,Greece,4,95,1061,"rgb(166,118,29)"
8495,2020-03-30,Greece,6,95,1156,"rgb(166,118,29)"
8496,2020-03-31,Greece,5,56,1212,"rgb(166,118,29)"
8497,2020-04-01,Greece,6,102,1314,"rgb(166,118,29)"
8498,2020-04-02,Greece,1,61,1375,"rgb(166,118,29)"
8499,2020-04-03,Greece,3,139,1514,"rgb(166,118,29)"
8500,2020-04-04,Greece,6,99,1613,"rgb(166,118,29)"
8501,2020-04-05,Greece,9,60,1673,"rgb(166,118,29)"
8502,2020-04-06,Greece,5,62,1735,"rgb(166,118,29)"
8503,2020-04-07,Greece,6,20,1755,"rgb(166,118,29)"
8504,2020-04-08,Greece,2,77,1832,"rgb(166,118,29)"
8505,2020-04-09,Greece,2,52,1884,"rgb(166,118,29)"
8506,2020-04-10,Greece,3,71,1955,"rgb(166,118,29)"
8507,2020-04-11,Greece,4,56,2011,"rgb(166,118,29)"
8508,2020-04-12,Greece,3,70,2081,"rgb(166,118,29)"
8509,2020-04-13,Greece,5,33,2114,"rgb(166,118,29)"
8510,2020-04-14,Greece,1,31,2145,"rgb(166,118,29)"
8511,2020-04-15,Greece,2,25,2170,"rgb(166,118,29)"
8512,2020-04-16,Greece,1,22,2192,"rgb(166,118,29)"
8513,2020-04-17,Greece,3,15,2207,"rgb(166,118,29)"
8514,2020-04-18,Greece,0,0,2207,"rgb(166,118,29)"
8515,2020-04-19,Greece,0,0,2207,"rgb(166,118,29)"
8516,2020-04-20,Greece,5,28,2235,"rgb(166,118,29)"
8517,2020-04-21,Greece,6,10,2245,"rgb(166,118,29)"
8518,2020-04-22,Greece,5,156,2401,"rgb(166,118,29)"
8519,2020-04-23,Greece,0,7,2408,"rgb(166,118,29)"
8520,2020-04-24,Greece,4,55,2463,"rgb(166,118,29)"
8521,2020-04-25,Greece,5,27,2490,"rgb(166,118,29)"
8522,2020-04-26,Greece,0,16,2506,"rgb(166,118,29)"
8523,2020-04-27,Greece,0,0,2506,"rgb(166,118,29)"
8524,2020-04-28,Greece,6,28,2534,"rgb(166,118,29)"
8525,2020-04-29,Greece,0,0,2534,"rgb(166,118,29)"
8526,2020-04-30,Greece,3,42,2576,"rgb(166,118,29)"
8527,2020-05-01,Greece,1,15,2591,"rgb(166,118,29)"
8528,2020-05-02,Greece,0,0,2591,"rgb(166,118,29)"
8529,2020-05-03,Greece,3,29,2620,"rgb(166,118,29)"
8530,2020-05-04,Greece,1,6,2626,"rgb(166,118,29)"
8531,2020-05-05,Greece,2,6,2632,"rgb(166,118,29)"
8532,2020-05-06,Greece,0,10,2642,"rgb(166,118,29)"
8533,2020-05-07,Greece,1,21,2663,"rgb(166,118,29)"
8534,2020-05-08,Greece,1,15,2678,"rgb(166,118,29)"
8535,2020-05-09,Greece,2,13,2691,"rgb(166,118,29)"
8536,2020-05-10,Greece,1,19,2710,"rgb(166,118,29)"
8537,2020-05-11,Greece,0,6,2716,"rgb(166,118,29)"
8538,2020-05-12,Greece,0,10,2726,"rgb(166,118,29)"
8539,2020-05-13,Greece,1,18,2744,"rgb(166,118,29)"
8540,2020-05-14,Greece,3,16,2760,"rgb(166,118,29)"
8541,2020-05-15,Greece,1,10,2770,"rgb(166,118,29)"
8542,2020-05-16,Greece,4,40,2810,"rgb(166,118,29)"
8543,2020-05-17,Greece,2,9,2819,"rgb(166,118,29)"
8544,2020-05-18,Greece,1,15,2834,"rgb(166,118,29)"
8545,2020-05-19,Greece,2,2,2836,"rgb(166,118,29)"
8546,2020-05-20,Greece,0,4,2840,"rgb(166,118,29)"
8547,2020-05-21,Greece,1,10,2850,"rgb(166,118,29)"
8548,2020-05-22,Greece,2,3,2853,"rgb(166,118,29)"
8549,2020-05-23,Greece,1,20,2873,"rgb(166,118,29)"
8550,2020-05-24,Greece,2,3,2876,"rgb(166,118,29)"
8551,2020-05-25,Greece,0,2,2878,"rgb(166,118,29)"
8552,2020-05-26,Greece,1,4,2882,"rgb(166,118,29)"
8553,2020-05-27,Greece,1,10,2892,"rgb(166,118,29)"
8554,2020-05-28,Greece,0,11,2903,"rgb(166,118,29)"
8555,2020-05-29,Greece,2,3,2906,"rgb(166,118,29)"
8556,2020-05-30,Greece,0,3,2909,"rgb(166,118,29)"
8557,2020-05-31,Greece,0,6,2915,"rgb(166,118,29)"
8558,2020-06-01,Greece,0,2,2917,"rgb(166,118,29)"
8559,2020-06-02,Greece,0,0,2917,"rgb(166,118,29)"
8560,2020-06-03,Greece,4,1,2918,"rgb(166,118,29)"
8561,2020-06-04,Greece,0,19,2937,"rgb(166,118,29)"
8562,2020-06-05,Greece,0,0,2937,"rgb(166,118,29)"
8563,2020-06-06,Greece,0,0,2937,"rgb(166,118,29)"
8564,2020-06-07,Greece,1,15,2952,"rgb(166,118,29)"
8565,2020-06-08,Greece,0,0,2952,"rgb(166,118,29)"
8566,2020-06-09,Greece,2,97,3049,"rgb(166,118,29)"
8567,2020-06-10,Greece,1,9,3058,"rgb(166,118,29)"
8568,2020-06-11,Greece,0,10,3068,"rgb(166,118,29)"
8569,2020-06-12,Greece,0,20,3088,"rgb(166,118,29)"
8570,2020-06-13,Greece,0,20,3108,"rgb(166,118,29)"
8571,2020-06-14,Greece,0,4,3112,"rgb(166,118,29)"
8572,2020-06-15,Greece,0,9,3121,"rgb(166,118,29)"
8573,2020-06-16,Greece,1,13,3134,"rgb(166,118,29)"
8574,2020-06-17,Greece,1,14,3148,"rgb(166,118,29)"
8575,2020-06-18,Greece,2,55,3203,"rgb(166,118,29)"
8576,2020-06-19,Greece,1,24,3227,"rgb(166,118,29)"
8577,2020-06-20,Greece,1,10,3237,"rgb(166,118,29)"
8578,2020-06-21,Greece,1,19,3256,"rgb(166,118,29)"
8579,2020-06-22,Greece,0,10,3266,"rgb(166,118,29)"
8580,2020-06-23,Greece,0,21,3287,"rgb(166,118,29)"
8581,2020-06-24,Greece,0,15,3302,"rgb(166,118,29)"
8582,2020-06-25,Greece,0,8,3310,"rgb(166,118,29)"
8583,2020-06-26,Greece,1,11,3321,"rgb(166,118,29)"
8584,2020-06-27,Greece,0,22,3343,"rgb(166,118,29)"
8585,2020-06-28,Greece,0,23,3366,"rgb(166,118,29)"
8586,2020-06-29,Greece,0,10,3376,"rgb(166,118,29)"
8587,2020-06-30,Greece,0,14,3390,"rgb(166,118,29)"
8588,2020-07-01,Greece,1,19,3409,"rgb(166,118,29)"
8589,2020-07-02,Greece,0,23,3432,"rgb(166,118,29)"
8590,2020-07-03,Greece,0,26,3458,"rgb(166,118,29)"
8591,2020-07-04,Greece,0,28,3486,"rgb(166,118,29)"
8592,2020-07-05,Greece,0,25,3511,"rgb(166,118,29)"
8593,2020-07-06,Greece,0,8,3519,"rgb(166,118,29)"
8594,2020-07-07,Greece,0,43,3562,"rgb(166,118,29)"
8595,2020-07-08,Greece,1,27,3589,"rgb(166,118,29)"
8596,2020-07-09,Greece,0,33,3622,"rgb(166,118,29)"
8597,2020-07-10,Greece,0,50,3672,"rgb(166,118,29)"
8598,2020-07-11,Greece,0,60,3732,"rgb(166,118,29)"
8599,2020-07-12,Greece,0,40,3772,"rgb(166,118,29)"
8600,2020-07-13,Greece,0,31,3803,"rgb(166,118,29)"
8601,2020-03-22,Eritrea,0,1,1,"rgb(102,102,102)"
8602,2020-03-23,Eritrea,0,0,1,"rgb(102,102,102)"
8603,2020-03-24,Eritrea,0,0,1,"rgb(102,102,102)"
8604,2020-03-25,Eritrea,0,0,1,"rgb(102,102,102)"
8605,2020-03-26,Eritrea,0,3,4,"rgb(102,102,102)"
8606,2020-03-27,Eritrea,0,2,6,"rgb(102,102,102)"
8607,2020-03-28,Eritrea,0,0,6,"rgb(102,102,102)"
8608,2020-03-29,Eritrea,0,0,6,"rgb(102,102,102)"
8609,2020-03-30,Eritrea,0,6,12,"rgb(102,102,102)"
8610,2020-03-31,Eritrea,0,0,12,"rgb(102,102,102)"
8611,2020-04-01,Eritrea,0,3,15,"rgb(102,102,102)"
8612,2020-04-02,Eritrea,0,3,18,"rgb(102,102,102)"
8613,2020-04-03,Eritrea,0,4,22,"rgb(102,102,102)"
8614,2020-04-04,Eritrea,0,0,22,"rgb(102,102,102)"
8615,2020-04-05,Eritrea,0,7,29,"rgb(102,102,102)"
8616,2020-04-06,Eritrea,0,0,29,"rgb(102,102,102)"
8617,2020-04-07,Eritrea,0,2,31,"rgb(102,102,102)"
8618,2020-04-08,Eritrea,0,0,31,"rgb(102,102,102)"
8619,2020-04-09,Eritrea,0,2,33,"rgb(102,102,102)"
8620,2020-04-10,Eritrea,0,0,33,"rgb(102,102,102)"
8621,2020-04-11,Eritrea,0,1,34,"rgb(102,102,102)"
8622,2020-04-12,Eritrea,0,0,34,"rgb(102,102,102)"
8623,2020-04-13,Eritrea,0,0,34,"rgb(102,102,102)"
8624,2020-04-14,Eritrea,0,0,34,"rgb(102,102,102)"
8625,2020-04-15,Eritrea,0,1,35,"rgb(102,102,102)"
8626,2020-04-16,Eritrea,0,0,35,"rgb(102,102,102)"
8627,2020-04-17,Eritrea,0,0,35,"rgb(102,102,102)"
8628,2020-04-18,Eritrea,0,0,35,"rgb(102,102,102)"
8629,2020-04-19,Eritrea,0,0,35,"rgb(102,102,102)"
8630,2020-04-20,Eritrea,0,4,39,"rgb(102,102,102)"
8631,2020-04-21,Eritrea,0,0,39,"rgb(102,102,102)"
8632,2020-04-22,Eritrea,0,0,39,"rgb(102,102,102)"
8633,2020-04-23,Eritrea,0,0,39,"rgb(102,102,102)"
8634,2020-04-24,Eritrea,0,0,39,"rgb(102,102,102)"
8635,2020-04-25,Eritrea,0,0,39,"rgb(102,102,102)"
8636,2020-04-26,Eritrea,0,0,39,"rgb(102,102,102)"
8637,2020-04-27,Eritrea,0,0,39,"rgb(102,102,102)"
8638,2020-04-28,Eritrea,0,0,39,"rgb(102,102,102)"
8639,2020-04-29,Eritrea,0,0,39,"rgb(102,102,102)"
8640,2020-04-30,Eritrea,0,0,39,"rgb(102,102,102)"
8641,2020-05-01,Eritrea,0,0,39,"rgb(102,102,102)"
8642,2020-05-02,Eritrea,0,0,39,"rgb(102,102,102)"
8643,2020-05-03,Eritrea,0,0,39,"rgb(102,102,102)"
8644,2020-05-04,Eritrea,0,0,39,"rgb(102,102,102)"
8645,2020-05-05,Eritrea,0,0,39,"rgb(102,102,102)"
8646,2020-05-06,Eritrea,0,0,39,"rgb(102,102,102)"
8647,2020-05-07,Eritrea,0,0,39,"rgb(102,102,102)"
8648,2020-05-08,Eritrea,0,0,39,"rgb(102,102,102)"
8649,2020-05-09,Eritrea,0,0,39,"rgb(102,102,102)"
8650,2020-05-10,Eritrea,0,0,39,"rgb(102,102,102)"
8651,2020-05-11,Eritrea,0,0,39,"rgb(102,102,102)"
8652,2020-05-12,Eritrea,0,0,39,"rgb(102,102,102)"
8653,2020-05-13,Eritrea,0,0,39,"rgb(102,102,102)"
8654,2020-05-14,Eritrea,0,0,39,"rgb(102,102,102)"
8655,2020-05-15,Eritrea,0,0,39,"rgb(102,102,102)"
8656,2020-05-16,Eritrea,0,0,39,"rgb(102,102,102)"
8657,2020-05-17,Eritrea,0,0,39,"rgb(102,102,102)"
8658,2020-05-18,Eritrea,0,0,39,"rgb(102,102,102)"
8659,2020-05-19,Eritrea,0,0,39,"rgb(102,102,102)"
8660,2020-05-20,Eritrea,0,0,39,"rgb(102,102,102)"
8661,2020-05-21,Eritrea,0,0,39,"rgb(102,102,102)"
8662,2020-05-22,Eritrea,0,0,39,"rgb(102,102,102)"
8663,2020-05-23,Eritrea,0,0,39,"rgb(102,102,102)"
8664,2020-05-24,Eritrea,0,0,39,"rgb(102,102,102)"
8665,2020-05-25,Eritrea,0,0,39,"rgb(102,102,102)"
8666,2020-05-26,Eritrea,0,0,39,"rgb(102,102,102)"
8667,2020-05-27,Eritrea,0,0,39,"rgb(102,102,102)"
8668,2020-05-28,Eritrea,0,0,39,"rgb(102,102,102)"
8669,2020-05-29,Eritrea,0,0,39,"rgb(102,102,102)"
8670,2020-05-30,Eritrea,0,0,39,"rgb(102,102,102)"
8671,2020-05-31,Eritrea,0,0,39,"rgb(102,102,102)"
8672,2020-06-01,Eritrea,0,0,39,"rgb(102,102,102)"
8673,2020-06-02,Eritrea,0,0,39,"rgb(102,102,102)"
8674,2020-06-03,Eritrea,0,0,39,"rgb(102,102,102)"
8675,2020-06-04,Eritrea,0,1,40,"rgb(102,102,102)"
8676,2020-06-05,Eritrea,0,1,41,"rgb(102,102,102)"
8677,2020-06-06,Eritrea,0,0,41,"rgb(102,102,102)"
8678,2020-06-07,Eritrea,0,0,41,"rgb(102,102,102)"
8679,2020-06-08,Eritrea,0,0,41,"rgb(102,102,102)"
8680,2020-06-09,Eritrea,0,0,41,"rgb(102,102,102)"
8681,2020-06-10,Eritrea,0,0,41,"rgb(102,102,102)"
8682,2020-06-11,Eritrea,0,0,41,"rgb(102,102,102)"
8683,2020-06-12,Eritrea,0,0,41,"rgb(102,102,102)"
8684,2020-06-13,Eritrea,0,0,41,"rgb(102,102,102)"
8685,2020-06-14,Eritrea,0,24,65,"rgb(102,102,102)"
8686,2020-06-15,Eritrea,0,31,96,"rgb(102,102,102)"
8687,2020-06-16,Eritrea,0,13,109,"rgb(102,102,102)"
8688,2020-06-17,Eritrea,0,12,121,"rgb(102,102,102)"
8689,2020-06-18,Eritrea,0,10,131,"rgb(102,102,102)"
8690,2020-06-19,Eritrea,0,11,142,"rgb(102,102,102)"
8691,2020-06-20,Eritrea,0,0,142,"rgb(102,102,102)"
8692,2020-06-21,Eritrea,0,1,143,"rgb(102,102,102)"
8693,2020-06-22,Eritrea,0,0,143,"rgb(102,102,102)"
8694,2020-06-23,Eritrea,0,0,143,"rgb(102,102,102)"
8695,2020-06-24,Eritrea,0,0,143,"rgb(102,102,102)"
8696,2020-06-25,Eritrea,0,0,143,"rgb(102,102,102)"
8697,2020-06-26,Eritrea,0,1,144,"rgb(102,102,102)"
8698,2020-06-27,Eritrea,0,23,167,"rgb(102,102,102)"
8699,2020-06-28,Eritrea,0,24,191,"rgb(102,102,102)"
8700,2020-06-29,Eritrea,0,0,191,"rgb(102,102,102)"
8701,2020-06-30,Eritrea,0,0,191,"rgb(102,102,102)"
8702,2020-07-01,Eritrea,0,12,203,"rgb(102,102,102)"
8703,2020-07-02,Eritrea,0,0,203,"rgb(102,102,102)"
8704,2020-07-03,Eritrea,0,12,215,"rgb(102,102,102)"
8705,2020-07-04,Eritrea,0,0,215,"rgb(102,102,102)"
8706,2020-07-05,Eritrea,0,0,215,"rgb(102,102,102)"
8707,2020-07-06,Eritrea,0,0,215,"rgb(102,102,102)"
8708,2020-07-07,Eritrea,0,0,215,"rgb(102,102,102)"
8709,2020-07-08,Eritrea,0,0,215,"rgb(102,102,102)"
8710,2020-07-09,Eritrea,0,0,215,"rgb(102,102,102)"
8711,2020-07-10,Eritrea,0,17,232,"rgb(102,102,102)"
8712,2020-07-11,Eritrea,0,0,232,"rgb(102,102,102)"
8713,2020-07-12,Eritrea,0,0,232,"rgb(102,102,102)"
8714,2020-07-13,Eritrea,0,0,232,"rgb(102,102,102)"
8715,2019-12-31,Spain,0,0,0,"rgb(102, 197, 204)"
8716,2020-01-01,Spain,0,0,0,"rgb(102, 197, 204)"
8717,2020-01-02,Spain,0,0,0,"rgb(102, 197, 204)"
8718,2020-01-03,Spain,0,0,0,"rgb(102, 197, 204)"
8719,2020-01-04,Spain,0,0,0,"rgb(102, 197, 204)"
8720,2020-01-05,Spain,0,0,0,"rgb(102, 197, 204)"
8721,2020-01-06,Spain,0,0,0,"rgb(102, 197, 204)"
8722,2020-01-07,Spain,0,0,0,"rgb(102, 197, 204)"
8723,2020-01-08,Spain,0,0,0,"rgb(102, 197, 204)"
8724,2020-01-09,Spain,0,0,0,"rgb(102, 197, 204)"
8725,2020-01-10,Spain,0,0,0,"rgb(102, 197, 204)"
8726,2020-01-11,Spain,0,0,0,"rgb(102, 197, 204)"
8727,2020-01-12,Spain,0,0,0,"rgb(102, 197, 204)"
8728,2020-01-13,Spain,0,0,0,"rgb(102, 197, 204)"
8729,2020-01-14,Spain,0,0,0,"rgb(102, 197, 204)"
8730,2020-01-15,Spain,0,0,0,"rgb(102, 197, 204)"
8731,2020-01-16,Spain,0,0,0,"rgb(102, 197, 204)"
8732,2020-01-17,Spain,0,0,0,"rgb(102, 197, 204)"
8733,2020-01-18,Spain,0,0,0,"rgb(102, 197, 204)"
8734,2020-01-19,Spain,0,0,0,"rgb(102, 197, 204)"
8735,2020-01-20,Spain,0,0,0,"rgb(102, 197, 204)"
8736,2020-01-21,Spain,0,0,0,"rgb(102, 197, 204)"
8737,2020-01-22,Spain,0,0,0,"rgb(102, 197, 204)"
8738,2020-01-23,Spain,0,0,0,"rgb(102, 197, 204)"
8739,2020-01-24,Spain,0,0,0,"rgb(102, 197, 204)"
8740,2020-01-25,Spain,0,0,0,"rgb(102, 197, 204)"
8741,2020-01-26,Spain,0,0,0,"rgb(102, 197, 204)"
8742,2020-01-27,Spain,0,0,0,"rgb(102, 197, 204)"
8743,2020-01-28,Spain,0,0,0,"rgb(102, 197, 204)"
8744,2020-01-29,Spain,0,0,0,"rgb(102, 197, 204)"
8745,2020-01-30,Spain,0,0,0,"rgb(102, 197, 204)"
8746,2020-01-31,Spain,0,0,0,"rgb(102, 197, 204)"
8747,2020-02-01,Spain,0,1,1,"rgb(102, 197, 204)"
8748,2020-02-02,Spain,0,0,1,"rgb(102, 197, 204)"
8749,2020-02-03,Spain,0,0,1,"rgb(102, 197, 204)"
8750,2020-02-04,Spain,0,0,1,"rgb(102, 197, 204)"
8751,2020-02-05,Spain,0,0,1,"rgb(102, 197, 204)"
8752,2020-02-06,Spain,0,0,1,"rgb(102, 197, 204)"
8753,2020-02-07,Spain,0,0,1,"rgb(102, 197, 204)"
8754,2020-02-08,Spain,0,0,1,"rgb(102, 197, 204)"
8755,2020-02-09,Spain,0,0,1,"rgb(102, 197, 204)"
8756,2020-02-10,Spain,0,1,2,"rgb(102, 197, 204)"
8757,2020-02-11,Spain,0,0,2,"rgb(102, 197, 204)"
8758,2020-02-12,Spain,0,0,2,"rgb(102, 197, 204)"
8759,2020-02-13,Spain,0,0,2,"rgb(102, 197, 204)"
8760,2020-02-14,Spain,0,0,2,"rgb(102, 197, 204)"
8761,2020-02-15,Spain,0,0,2,"rgb(102, 197, 204)"
8762,2020-02-16,Spain,0,0,2,"rgb(102, 197, 204)"
8763,2020-02-17,Spain,0,0,2,"rgb(102, 197, 204)"
8764,2020-02-18,Spain,0,0,2,"rgb(102, 197, 204)"
8765,2020-02-19,Spain,0,0,2,"rgb(102, 197, 204)"
8766,2020-02-20,Spain,0,0,2,"rgb(102, 197, 204)"
8767,2020-02-21,Spain,0,0,2,"rgb(102, 197, 204)"
8768,2020-02-22,Spain,0,0,2,"rgb(102, 197, 204)"
8769,2020-02-23,Spain,0,0,2,"rgb(102, 197, 204)"
8770,2020-02-24,Spain,0,0,2,"rgb(102, 197, 204)"
8771,2020-02-25,Spain,0,1,3,"rgb(102, 197, 204)"
8772,2020-02-26,Spain,0,6,9,"rgb(102, 197, 204)"
8773,2020-02-27,Spain,0,8,17,"rgb(102, 197, 204)"
8774,2020-02-28,Spain,0,18,35,"rgb(102, 197, 204)"
8775,2020-02-29,Spain,0,19,54,"rgb(102, 197, 204)"
8776,2020-03-01,Spain,0,28,82,"rgb(102, 197, 204)"
8777,2020-03-02,Spain,0,54,136,"rgb(102, 197, 204)"
8778,2020-03-03,Spain,0,56,192,"rgb(102, 197, 204)"
8779,2020-03-04,Spain,0,75,267,"rgb(102, 197, 204)"
8780,2020-03-05,Spain,1,81,348,"rgb(102, 197, 204)"
8781,2020-03-06,Spain,2,183,531,"rgb(102, 197, 204)"
8782,2020-03-07,Spain,2,233,764,"rgb(102, 197, 204)"
8783,2020-03-08,Spain,0,330,1094,"rgb(102, 197, 204)"
8784,2020-03-09,Spain,0,433,1527,"rgb(102, 197, 204)"
8785,2020-03-10,Spain,23,772,2299,"rgb(102, 197, 204)"
8786,2020-03-11,Spain,7,975,3274,"rgb(102, 197, 204)"
8787,2020-03-12,Spain,12,1153,4427,"rgb(102, 197, 204)"
8788,2020-03-13,Spain,37,1531,5958,"rgb(102, 197, 204)"
8789,2020-03-14,Spain,37,1683,7641,"rgb(102, 197, 204)"
8790,2020-03-15,Spain,15,2144,9785,"rgb(102, 197, 204)"
8791,2020-03-16,Spain,152,1706,11491,"rgb(102, 197, 204)"
8792,2020-03-17,Spain,21,2503,13994,"rgb(102, 197, 204)"
8793,2020-03-18,Spain,182,3694,17688,"rgb(102, 197, 204)"
8794,2020-03-19,Spain,107,4047,21735,"rgb(102, 197, 204)"
8795,2020-03-20,Spain,169,4569,26304,"rgb(102, 197, 204)"
8796,2020-03-21,Spain,235,5446,31750,"rgb(102, 197, 204)"
8797,2020-03-22,Spain,324,4866,36616,"rgb(102, 197, 204)"
8798,2020-03-23,Spain,394,4646,41262,"rgb(102, 197, 204)"
8799,2020-03-24,Spain,462,7691,48953,"rgb(102, 197, 204)"
8800,2020-03-25,Spain,514,8553,57506,"rgb(102, 197, 204)"
8801,2020-03-26,Spain,738,8954,66460,"rgb(102, 197, 204)"
8802,2020-03-27,Spain,655,9181,75641,"rgb(102, 197, 204)"
8803,2020-03-28,Spain,769,8244,83885,"rgb(102, 197, 204)"
8804,2020-03-29,Spain,832,6424,90309,"rgb(102, 197, 204)"
8805,2020-03-30,Spain,838,5813,96122,"rgb(102, 197, 204)"
8806,2020-03-31,Spain,812,8145,104267,"rgb(102, 197, 204)"
8807,2020-04-01,Spain,849,7413,111680,"rgb(102, 197, 204)"
8808,2020-04-02,Spain,864,7583,119263,"rgb(102, 197, 204)"
8809,2020-04-03,Spain,950,7272,126535,"rgb(102, 197, 204)"
8810,2020-04-04,Spain,932,6663,133198,"rgb(102, 197, 204)"
8811,2020-04-05,Spain,809,5533,138731,"rgb(102, 197, 204)"
8812,2020-04-06,Spain,674,3667,142398,"rgb(102, 197, 204)"
8813,2020-04-07,Spain,637,5209,147607,"rgb(102, 197, 204)"
8814,2020-04-08,Spain,743,5583,153190,"rgb(102, 197, 204)"
8815,2020-04-09,Spain,757,5745,158935,"rgb(102, 197, 204)"
8816,2020-04-10,Spain,683,4537,163472,"rgb(102, 197, 204)"
8817,2020-04-11,Spain,605,4550,168022,"rgb(102, 197, 204)"
8818,2020-04-12,Spain,510,3899,171921,"rgb(102, 197, 204)"
8819,2020-04-13,Spain,619,3030,174951,"rgb(102, 197, 204)"
8820,2020-04-14,Spain,517,3116,178067,"rgb(102, 197, 204)"
8821,2020-04-15,Spain,787,4424,182491,"rgb(102, 197, 204)"
8822,2020-04-16,Spain,617,3820,186311,"rgb(102, 197, 204)"
8823,2020-04-17,Spain,585,3818,190129,"rgb(102, 197, 204)"
8824,2020-04-18,Spain,565,3836,193965,"rgb(102, 197, 204)"
8825,2020-04-19,Spain,410,-713,193252,"rgb(102, 197, 204)"
8826,2020-04-20,Spain,399,2218,195470,"rgb(102, 197, 204)"
8827,2020-04-21,Spain,430,2951,198421,"rgb(102, 197, 204)"
8828,2020-04-22,Spain,435,2312,200733,"rgb(102, 197, 204)"
8829,2020-04-23,Spain,440,2916,203649,"rgb(102, 197, 204)"
8830,2020-04-24,Spain,367,2114,205763,"rgb(102, 197, 204)"
8831,2020-04-25,Spain,378,2506,208269,"rgb(102, 197, 204)"
8832,2020-04-26,Spain,288,1641,209910,"rgb(102, 197, 204)"
8833,2020-04-27,Spain,0,1660,211570,"rgb(102, 197, 204)"
8834,2020-04-28,Spain,632,1525,213095,"rgb(102, 197, 204)"
8835,2020-04-29,Spain,453,847,213942,"rgb(102, 197, 204)"
8836,2020-04-30,Spain,268,1241,215183,"rgb(102, 197, 204)"
8837,2020-05-01,Spain,281,1387,216570,"rgb(102, 197, 204)"
8838,2020-05-02,Spain,276,1234,217804,"rgb(102, 197, 204)"
8839,2020-05-03,Spain,164,935,218739,"rgb(102, 197, 204)"
8840,2020-05-04,Spain,164,466,219205,"rgb(102, 197, 204)"
8841,2020-05-05,Spain,185,1039,220244,"rgb(102, 197, 204)"
8842,2020-05-06,Spain,244,880,221124,"rgb(102, 197, 204)"
8843,2020-05-07,Spain,213,921,222045,"rgb(102, 197, 204)"
8844,2020-05-08,Spain,181,1173,223218,"rgb(102, 197, 204)"
8845,2020-05-09,Spain,227,743,223961,"rgb(102, 197, 204)"
8846,2020-05-10,Spain,143,3416,227377,"rgb(102, 197, 204)"
8847,2020-05-11,Spain,123,393,227770,"rgb(102, 197, 204)"
8848,2020-05-12,Spain,176,482,228252,"rgb(102, 197, 204)"
8849,2020-05-13,Spain,184,439,228691,"rgb(102, 197, 204)"
8850,2020-05-14,Spain,217,849,229540,"rgb(102, 197, 204)"
8851,2020-05-15,Spain,138,643,230183,"rgb(102, 197, 204)"
8852,2020-05-16,Spain,104,515,230698,"rgb(102, 197, 204)"
8853,2020-05-17,Spain,87,652,231350,"rgb(102, 197, 204)"
8854,2020-05-18,Spain,59,256,231606,"rgb(102, 197, 204)"
8855,2020-05-19,Spain,69,431,232037,"rgb(102, 197, 204)"
8856,2020-05-20,Spain,110,518,232555,"rgb(102, 197, 204)"
8857,2020-05-21,Spain,52,482,233037,"rgb(102, 197, 204)"
8858,2020-05-22,Spain,688,1787,234824,"rgb(102, 197, 204)"
8859,2020-05-23,Spain,50,466,235290,"rgb(102, 197, 204)"
8860,2020-05-24,Spain,74,482,235772,"rgb(102, 197, 204)"
8861,2020-05-25,Spain,-1918,-372,235400,"rgb(102, 197, 204)"
8862,2020-05-26,Spain,283,859,236259,"rgb(102, 197, 204)"
8863,2020-05-27,Spain,1,510,236769,"rgb(102, 197, 204)"
8864,2020-05-28,Spain,1,1137,237906,"rgb(102, 197, 204)"
8865,2020-05-29,Spain,2,658,238564,"rgb(102, 197, 204)"
8866,2020-05-30,Spain,4,664,239228,"rgb(102, 197, 204)"
8867,2020-05-31,Spain,2,201,239429,"rgb(102, 197, 204)"
8868,2020-06-01,Spain,0,209,239638,"rgb(102, 197, 204)"
8869,2020-06-02,Spain,0,294,239932,"rgb(102, 197, 204)"
8870,2020-06-03,Spain,1,394,240326,"rgb(102, 197, 204)"
8871,2020-06-04,Spain,5,334,240660,"rgb(102, 197, 204)"
8872,2020-06-05,Spain,1,318,240978,"rgb(102, 197, 204)"
8873,2020-06-06,Spain,1,332,241310,"rgb(102, 197, 204)"
8874,2020-06-07,Spain,1,240,241550,"rgb(102, 197, 204)"
8875,2020-06-08,Spain,0,167,241717,"rgb(102, 197, 204)"
8876,2020-06-09,Spain,0,249,241966,"rgb(102, 197, 204)"
8877,2020-06-10,Spain,0,314,242280,"rgb(102, 197, 204)"
8878,2020-06-11,Spain,0,427,242707,"rgb(102, 197, 204)"
8879,2020-06-12,Spain,0,502,243209,"rgb(102, 197, 204)"
8880,2020-06-13,Spain,0,396,243605,"rgb(102, 197, 204)"
8881,2020-06-14,Spain,0,323,243928,"rgb(102, 197, 204)"
8882,2020-06-15,Spain,0,181,244109,"rgb(102, 197, 204)"
8883,2020-06-16,Spain,0,219,244328,"rgb(102, 197, 204)"
8884,2020-06-17,Spain,0,355,244683,"rgb(102, 197, 204)"
8885,2020-06-18,Spain,0,585,245268,"rgb(102, 197, 204)"
8886,2020-06-19,Spain,1179,307,245575,"rgb(102, 197, 204)"
8887,2020-06-20,Spain,7,363,245938,"rgb(102, 197, 204)"
8888,2020-06-21,Spain,1,334,246272,"rgb(102, 197, 204)"
8889,2020-06-22,Spain,1,232,246504,"rgb(102, 197, 204)"
8890,2020-06-23,Spain,1,248,246752,"rgb(102, 197, 204)"
8891,2020-06-24,Spain,2,334,247086,"rgb(102, 197, 204)"
8892,2020-06-25,Spain,3,400,247486,"rgb(102, 197, 204)"
8893,2020-06-26,Spain,8,419,247905,"rgb(102, 197, 204)"
8894,2020-06-27,Spain,3,564,248469,"rgb(102, 197, 204)"
8895,2020-06-28,Spain,2,301,248770,"rgb(102, 197, 204)"
8896,2020-06-29,Spain,3,200,248970,"rgb(102, 197, 204)"
8897,2020-06-30,Spain,9,301,249271,"rgb(102, 197, 204)"
8898,2020-07-01,Spain,8,388,249659,"rgb(102, 197, 204)"
8899,2020-07-02,Spain,5,444,250103,"rgb(102, 197, 204)"
8900,2020-07-03,Spain,17,442,250545,"rgb(102, 197, 204)"
8901,2020-07-04,Spain,0,0,250545,"rgb(102, 197, 204)"
8902,2020-07-05,Spain,0,0,250545,"rgb(102, 197, 204)"
8903,2020-07-06,Spain,3,1244,251789,"rgb(102, 197, 204)"
8904,2020-07-07,Spain,4,341,252130,"rgb(102, 197, 204)"
8905,2020-07-08,Spain,4,383,252513,"rgb(102, 197, 204)"
8906,2020-07-09,Spain,5,543,253056,"rgb(102, 197, 204)"
8907,2020-07-10,Spain,2,852,253908,"rgb(102, 197, 204)"
8908,2020-07-11,Spain,0,0,253908,"rgb(102, 197, 204)"
8909,2020-07-12,Spain,0,0,253908,"rgb(102, 197, 204)"
8910,2020-03-14,Ethiopia,0,1,1,"rgb(246, 207, 113)"
8911,2020-03-15,Ethiopia,0,0,1,"rgb(246, 207, 113)"
8912,2020-03-16,Ethiopia,0,3,4,"rgb(246, 207, 113)"
8913,2020-03-17,Ethiopia,0,1,5,"rgb(246, 207, 113)"
8914,2020-03-18,Ethiopia,0,0,5,"rgb(246, 207, 113)"
8915,2020-03-19,Ethiopia,0,1,6,"rgb(246, 207, 113)"
8916,2020-03-20,Ethiopia,0,1,7,"rgb(246, 207, 113)"
8917,2020-03-21,Ethiopia,0,2,9,"rgb(246, 207, 113)"
8918,2020-03-22,Ethiopia,0,0,9,"rgb(246, 207, 113)"
8919,2020-03-23,Ethiopia,0,2,11,"rgb(246, 207, 113)"
8920,2020-03-24,Ethiopia,0,0,11,"rgb(246, 207, 113)"
8921,2020-03-25,Ethiopia,0,0,11,"rgb(246, 207, 113)"
8922,2020-03-26,Ethiopia,0,1,12,"rgb(246, 207, 113)"
8923,2020-03-27,Ethiopia,0,0,12,"rgb(246, 207, 113)"
8924,2020-03-28,Ethiopia,0,4,16,"rgb(246, 207, 113)"
8925,2020-03-29,Ethiopia,0,0,16,"rgb(246, 207, 113)"
8926,2020-03-30,Ethiopia,0,0,16,"rgb(246, 207, 113)"
8927,2020-03-31,Ethiopia,0,7,23,"rgb(246, 207, 113)"
8928,2020-04-01,Ethiopia,0,2,25,"rgb(246, 207, 113)"
8929,2020-04-02,Ethiopia,0,4,29,"rgb(246, 207, 113)"
8930,2020-04-03,Ethiopia,0,0,29,"rgb(246, 207, 113)"
8931,2020-04-04,Ethiopia,0,6,35,"rgb(246, 207, 113)"
8932,2020-04-05,Ethiopia,0,3,38,"rgb(246, 207, 113)"
8933,2020-04-06,Ethiopia,2,5,43,"rgb(246, 207, 113)"
8934,2020-04-07,Ethiopia,0,1,44,"rgb(246, 207, 113)"
8935,2020-04-08,Ethiopia,0,8,52,"rgb(246, 207, 113)"
8936,2020-04-09,Ethiopia,0,3,55,"rgb(246, 207, 113)"
8937,2020-04-10,Ethiopia,0,1,56,"rgb(246, 207, 113)"
8938,2020-04-11,Ethiopia,0,9,65,"rgb(246, 207, 113)"
8939,2020-04-12,Ethiopia,1,4,69,"rgb(246, 207, 113)"
8940,2020-04-13,Ethiopia,0,2,71,"rgb(246, 207, 113)"
8941,2020-04-14,Ethiopia,0,3,74,"rgb(246, 207, 113)"
8942,2020-04-15,Ethiopia,0,8,82,"rgb(246, 207, 113)"
8943,2020-04-16,Ethiopia,0,3,85,"rgb(246, 207, 113)"
8944,2020-04-17,Ethiopia,0,7,92,"rgb(246, 207, 113)"
8945,2020-04-18,Ethiopia,0,4,96,"rgb(246, 207, 113)"
8946,2020-04-19,Ethiopia,0,9,105,"rgb(246, 207, 113)"
8947,2020-04-20,Ethiopia,0,3,108,"rgb(246, 207, 113)"
8948,2020-04-21,Ethiopia,0,3,111,"rgb(246, 207, 113)"
8949,2020-04-22,Ethiopia,0,3,114,"rgb(246, 207, 113)"
8950,2020-04-23,Ethiopia,0,2,116,"rgb(246, 207, 113)"
8951,2020-04-24,Ethiopia,0,0,116,"rgb(246, 207, 113)"
8952,2020-04-25,Ethiopia,0,1,117,"rgb(246, 207, 113)"
8953,2020-04-26,Ethiopia,0,5,122,"rgb(246, 207, 113)"
8954,2020-04-27,Ethiopia,0,1,123,"rgb(246, 207, 113)"
8955,2020-04-28,Ethiopia,0,1,124,"rgb(246, 207, 113)"
8956,2020-04-29,Ethiopia,0,2,126,"rgb(246, 207, 113)"
8957,2020-04-30,Ethiopia,0,4,130,"rgb(246, 207, 113)"
8958,2020-05-01,Ethiopia,0,1,131,"rgb(246, 207, 113)"
8959,2020-05-02,Ethiopia,0,2,133,"rgb(246, 207, 113)"
8960,2020-05-03,Ethiopia,0,0,133,"rgb(246, 207, 113)"
8961,2020-05-04,Ethiopia,0,2,135,"rgb(246, 207, 113)"
8962,2020-05-05,Ethiopia,0,5,140,"rgb(246, 207, 113)"
8963,2020-05-06,Ethiopia,1,5,145,"rgb(246, 207, 113)"
8964,2020-05-07,Ethiopia,0,17,162,"rgb(246, 207, 113)"
8965,2020-05-08,Ethiopia,0,29,191,"rgb(246, 207, 113)"
8966,2020-05-09,Ethiopia,0,3,194,"rgb(246, 207, 113)"
8967,2020-05-10,Ethiopia,1,16,210,"rgb(246, 207, 113)"
8968,2020-05-11,Ethiopia,0,29,239,"rgb(246, 207, 113)"
8969,2020-05-12,Ethiopia,0,11,250,"rgb(246, 207, 113)"
8970,2020-05-13,Ethiopia,0,11,261,"rgb(246, 207, 113)"
8971,2020-05-14,Ethiopia,0,2,263,"rgb(246, 207, 113)"
8972,2020-05-15,Ethiopia,0,9,272,"rgb(246, 207, 113)"
8973,2020-05-16,Ethiopia,0,15,287,"rgb(246, 207, 113)"
8974,2020-05-17,Ethiopia,0,19,306,"rgb(246, 207, 113)"
8975,2020-05-18,Ethiopia,0,11,317,"rgb(246, 207, 113)"
8976,2020-05-19,Ethiopia,0,35,352,"rgb(246, 207, 113)"
8977,2020-05-20,Ethiopia,0,13,365,"rgb(246, 207, 113)"
8978,2020-05-21,Ethiopia,0,24,389,"rgb(246, 207, 113)"
8979,2020-05-22,Ethiopia,0,10,399,"rgb(246, 207, 113)"
8980,2020-05-23,Ethiopia,0,34,433,"rgb(246, 207, 113)"
8981,2020-05-24,Ethiopia,0,61,494,"rgb(246, 207, 113)"
8982,2020-05-25,Ethiopia,0,88,582,"rgb(246, 207, 113)"
8983,2020-05-26,Ethiopia,0,73,655,"rgb(246, 207, 113)"
8984,2020-05-27,Ethiopia,1,46,701,"rgb(246, 207, 113)"
8985,2020-05-28,Ethiopia,0,30,731,"rgb(246, 207, 113)"
8986,2020-05-29,Ethiopia,1,100,831,"rgb(246, 207, 113)"
8987,2020-05-30,Ethiopia,1,137,968,"rgb(246, 207, 113)"
8988,2020-05-31,Ethiopia,0,95,1063,"rgb(246, 207, 113)"
8989,2020-06-01,Ethiopia,3,109,1172,"rgb(246, 207, 113)"
8990,2020-06-02,Ethiopia,1,85,1257,"rgb(246, 207, 113)"
8991,2020-06-03,Ethiopia,2,87,1344,"rgb(246, 207, 113)"
8992,2020-06-04,Ethiopia,3,142,1486,"rgb(246, 207, 113)"
8993,2020-06-05,Ethiopia,1,150,1636,"rgb(246, 207, 113)"
8994,2020-06-06,Ethiopia,1,169,1805,"rgb(246, 207, 113)"
8995,2020-06-07,Ethiopia,1,129,1934,"rgb(246, 207, 113)"
8996,2020-06-08,Ethiopia,7,86,2020,"rgb(246, 207, 113)"
8997,2020-06-09,Ethiopia,0,136,2156,"rgb(246, 207, 113)"
8998,2020-06-10,Ethiopia,5,180,2336,"rgb(246, 207, 113)"
8999,2020-06-11,Ethiopia,3,170,2506,"rgb(246, 207, 113)"
9000,2020-06-12,Ethiopia,5,164,2670,"rgb(246, 207, 113)"
9001,2020-06-13,Ethiopia,7,245,2915,"rgb(246, 207, 113)"
9002,2020-06-14,Ethiopia,8,251,3166,"rgb(246, 207, 113)"
9003,2020-06-15,Ethiopia,2,179,3345,"rgb(246, 207, 113)"
9004,2020-06-16,Ethiopia,3,176,3521,"rgb(246, 207, 113)"
9005,2020-06-17,Ethiopia,1,109,3630,"rgb(246, 207, 113)"
9006,2020-06-18,Ethiopia,2,129,3759,"rgb(246, 207, 113)"
9007,2020-06-19,Ethiopia,2,195,3954,"rgb(246, 207, 113)"
9008,2020-06-20,Ethiopia,7,116,4070,"rgb(246, 207, 113)"
9009,2020-06-21,Ethiopia,0,399,4469,"rgb(246, 207, 113)"
9010,2020-06-22,Ethiopia,2,63,4532,"rgb(246, 207, 113)"
9011,2020-06-23,Ethiopia,1,131,4663,"rgb(246, 207, 113)"
9012,2020-06-24,Ethiopia,0,185,4848,"rgb(246, 207, 113)"
9013,2020-06-25,Ethiopia,3,186,5034,"rgb(246, 207, 113)"
9014,2020-06-26,Ethiopia,3,141,5175,"rgb(246, 207, 113)"
9015,2020-06-27,Ethiopia,8,250,5425,"rgb(246, 207, 113)"
9016,2020-06-28,Ethiopia,5,145,5570,"rgb(246, 207, 113)"
9017,2020-06-29,Ethiopia,4,119,5689,"rgb(246, 207, 113)"
9018,2020-06-30,Ethiopia,5,157,5846,"rgb(246, 207, 113)"
9019,2020-07-01,Ethiopia,0,0,5846,"rgb(246, 207, 113)"
9020,2020-07-02,Ethiopia,0,0,5846,"rgb(246, 207, 113)"
9021,2020-07-03,Ethiopia,0,0,5846,"rgb(246, 207, 113)"
9022,2020-07-04,Ethiopia,0,0,5846,"rgb(246, 207, 113)"
9023,2020-07-05,Ethiopia,0,0,5846,"rgb(246, 207, 113)"
9024,2020-07-06,Ethiopia,0,0,5846,"rgb(246, 207, 113)"
9025,2020-07-07,Ethiopia,13,540,6386,"rgb(246, 207, 113)"
9026,2020-07-08,Ethiopia,3,280,6666,"rgb(246, 207, 113)"
9027,2020-07-09,Ethiopia,1,108,6774,"rgb(246, 207, 113)"
9028,2020-07-10,Ethiopia,0,199,6973,"rgb(246, 207, 113)"
9029,2020-07-11,Ethiopia,4,147,7120,"rgb(246, 207, 113)"
9030,2020-07-12,Ethiopia,0,282,7402,"rgb(246, 207, 113)"
9031,2020-07-13,Ethiopia,3,158,7560,"rgb(246, 207, 113)"
9032,2019-12-31,Finland,0,0,0,"rgb(248, 156, 116)"
9033,2020-01-01,Finland,0,0,0,"rgb(248, 156, 116)"
9034,2020-01-02,Finland,0,0,0,"rgb(248, 156, 116)"
9035,2020-01-03,Finland,0,0,0,"rgb(248, 156, 116)"
9036,2020-01-04,Finland,0,0,0,"rgb(248, 156, 116)"
9037,2020-01-05,Finland,0,0,0,"rgb(248, 156, 116)"
9038,2020-01-06,Finland,0,0,0,"rgb(248, 156, 116)"
9039,2020-01-07,Finland,0,0,0,"rgb(248, 156, 116)"
9040,2020-01-08,Finland,0,0,0,"rgb(248, 156, 116)"
9041,2020-01-09,Finland,0,0,0,"rgb(248, 156, 116)"
9042,2020-01-10,Finland,0,0,0,"rgb(248, 156, 116)"
9043,2020-01-11,Finland,0,0,0,"rgb(248, 156, 116)"
9044,2020-01-12,Finland,0,0,0,"rgb(248, 156, 116)"
9045,2020-01-13,Finland,0,0,0,"rgb(248, 156, 116)"
9046,2020-01-14,Finland,0,0,0,"rgb(248, 156, 116)"
9047,2020-01-15,Finland,0,0,0,"rgb(248, 156, 116)"
9048,2020-01-16,Finland,0,0,0,"rgb(248, 156, 116)"
9049,2020-01-17,Finland,0,0,0,"rgb(248, 156, 116)"
9050,2020-01-18,Finland,0,0,0,"rgb(248, 156, 116)"
9051,2020-01-19,Finland,0,0,0,"rgb(248, 156, 116)"
9052,2020-01-20,Finland,0,0,0,"rgb(248, 156, 116)"
9053,2020-01-21,Finland,0,0,0,"rgb(248, 156, 116)"
9054,2020-01-22,Finland,0,0,0,"rgb(248, 156, 116)"
9055,2020-01-23,Finland,0,0,0,"rgb(248, 156, 116)"
9056,2020-01-24,Finland,0,0,0,"rgb(248, 156, 116)"
9057,2020-01-25,Finland,0,0,0,"rgb(248, 156, 116)"
9058,2020-01-26,Finland,0,0,0,"rgb(248, 156, 116)"
9059,2020-01-27,Finland,0,0,0,"rgb(248, 156, 116)"
9060,2020-01-28,Finland,0,0,0,"rgb(248, 156, 116)"
9061,2020-01-29,Finland,0,0,0,"rgb(248, 156, 116)"
9062,2020-01-30,Finland,0,1,1,"rgb(248, 156, 116)"
9063,2020-01-31,Finland,0,0,1,"rgb(248, 156, 116)"
9064,2020-02-01,Finland,0,0,1,"rgb(248, 156, 116)"
9065,2020-02-02,Finland,0,0,1,"rgb(248, 156, 116)"
9066,2020-02-03,Finland,0,0,1,"rgb(248, 156, 116)"
9067,2020-02-04,Finland,0,0,1,"rgb(248, 156, 116)"
9068,2020-02-05,Finland,0,0,1,"rgb(248, 156, 116)"
9069,2020-02-06,Finland,0,0,1,"rgb(248, 156, 116)"
9070,2020-02-07,Finland,0,0,1,"rgb(248, 156, 116)"
9071,2020-02-08,Finland,0,0,1,"rgb(248, 156, 116)"
9072,2020-02-09,Finland,0,0,1,"rgb(248, 156, 116)"
9073,2020-02-10,Finland,0,0,1,"rgb(248, 156, 116)"
9074,2020-02-11,Finland,0,0,1,"rgb(248, 156, 116)"
9075,2020-02-12,Finland,0,0,1,"rgb(248, 156, 116)"
9076,2020-02-13,Finland,0,0,1,"rgb(248, 156, 116)"
9077,2020-02-14,Finland,0,0,1,"rgb(248, 156, 116)"
9078,2020-02-15,Finland,0,0,1,"rgb(248, 156, 116)"
9079,2020-02-16,Finland,0,0,1,"rgb(248, 156, 116)"
9080,2020-02-17,Finland,0,0,1,"rgb(248, 156, 116)"
9081,2020-02-18,Finland,0,0,1,"rgb(248, 156, 116)"
9082,2020-02-19,Finland,0,0,1,"rgb(248, 156, 116)"
9083,2020-02-20,Finland,0,0,1,"rgb(248, 156, 116)"
9084,2020-02-21,Finland,0,0,1,"rgb(248, 156, 116)"
9085,2020-02-22,Finland,0,0,1,"rgb(248, 156, 116)"
9086,2020-02-23,Finland,0,0,1,"rgb(248, 156, 116)"
9087,2020-02-24,Finland,0,0,1,"rgb(248, 156, 116)"
9088,2020-02-25,Finland,0,0,1,"rgb(248, 156, 116)"
9089,2020-02-26,Finland,0,0,1,"rgb(248, 156, 116)"
9090,2020-02-27,Finland,0,1,2,"rgb(248, 156, 116)"
9091,2020-02-28,Finland,0,0,2,"rgb(248, 156, 116)"
9092,2020-02-29,Finland,0,1,3,"rgb(248, 156, 116)"
9093,2020-03-01,Finland,0,0,3,"rgb(248, 156, 116)"
9094,2020-03-02,Finland,0,3,6,"rgb(248, 156, 116)"
9095,2020-03-04,Finland,0,1,7,"rgb(248, 156, 116)"
9096,2020-03-06,Finland,0,5,12,"rgb(248, 156, 116)"
9097,2020-03-07,Finland,0,7,19,"rgb(248, 156, 116)"
9098,2020-03-09,Finland,0,11,30,"rgb(248, 156, 116)"
9099,2020-03-10,Finland,0,10,40,"rgb(248, 156, 116)"
9100,2020-03-12,Finland,0,19,59,"rgb(248, 156, 116)"
9101,2020-03-13,Finland,0,96,155,"rgb(248, 156, 116)"
9102,2020-03-14,Finland,0,28,183,"rgb(248, 156, 116)"
9103,2020-03-15,Finland,0,27,210,"rgb(248, 156, 116)"
9104,2020-03-16,Finland,0,57,267,"rgb(248, 156, 116)"
9105,2020-03-17,Finland,0,5,272,"rgb(248, 156, 116)"
9106,2020-03-18,Finland,0,47,319,"rgb(248, 156, 116)"
9107,2020-03-19,Finland,0,50,369,"rgb(248, 156, 116)"
9108,2020-03-20,Finland,0,31,400,"rgb(248, 156, 116)"
9109,2020-03-21,Finland,0,50,450,"rgb(248, 156, 116)"
9110,2020-03-22,Finland,1,71,521,"rgb(248, 156, 116)"
9111,2020-03-23,Finland,0,105,626,"rgb(248, 156, 116)"
9112,2020-03-24,Finland,0,74,700,"rgb(248, 156, 116)"
9113,2020-03-25,Finland,0,92,792,"rgb(248, 156, 116)"
9114,2020-03-26,Finland,2,88,880,"rgb(248, 156, 116)"
9115,2020-03-27,Finland,1,78,958,"rgb(248, 156, 116)"
9116,2020-03-28,Finland,3,67,1025,"rgb(248, 156, 116)"
9117,2020-03-29,Finland,2,193,1218,"rgb(248, 156, 116)"
9118,2020-03-30,Finland,2,0,1218,"rgb(248, 156, 116)"
9119,2020-03-31,Finland,2,95,1313,"rgb(248, 156, 116)"
9120,2020-04-01,Finland,4,71,1384,"rgb(248, 156, 116)"
9121,2020-04-02,Finland,0,62,1446,"rgb(248, 156, 116)"
9122,2020-04-03,Finland,2,72,1518,"rgb(248, 156, 116)"
9123,2020-04-04,Finland,1,97,1615,"rgb(248, 156, 116)"
9124,2020-04-05,Finland,5,267,1882,"rgb(248, 156, 116)"
9125,2020-04-06,Finland,2,45,1927,"rgb(248, 156, 116)"
9126,2020-04-07,Finland,0,249,2176,"rgb(248, 156, 116)"
9127,2020-04-08,Finland,7,132,2308,"rgb(248, 156, 116)"
9128,2020-04-09,Finland,6,179,2487,"rgb(248, 156, 116)"
9129,2020-04-10,Finland,2,118,2605,"rgb(248, 156, 116)"
9130,2020-04-11,Finland,6,164,2769,"rgb(248, 156, 116)"
9131,2020-04-12,Finland,1,136,2905,"rgb(248, 156, 116)"
9132,2020-04-13,Finland,7,69,2974,"rgb(248, 156, 116)"
9133,2020-04-14,Finland,3,90,3064,"rgb(248, 156, 116)"
9134,2020-04-15,Finland,5,97,3161,"rgb(248, 156, 116)"
9135,2020-04-16,Finland,8,76,3237,"rgb(248, 156, 116)"
9136,2020-04-17,Finland,3,132,3369,"rgb(248, 156, 116)"
9137,2020-04-18,Finland,7,120,3489,"rgb(248, 156, 116)"
9138,2020-04-19,Finland,8,192,3681,"rgb(248, 156, 116)"
9139,2020-04-20,Finland,4,102,3783,"rgb(248, 156, 116)"
9140,2020-04-21,Finland,4,85,3868,"rgb(248, 156, 116)"
9141,2020-04-22,Finland,43,146,4014,"rgb(248, 156, 116)"
9142,2020-04-23,Finland,8,115,4129,"rgb(248, 156, 116)"
9143,2020-04-24,Finland,23,155,4284,"rgb(248, 156, 116)"
9144,2020-04-25,Finland,5,111,4395,"rgb(248, 156, 116)"
9145,2020-04-26,Finland,9,80,4475,"rgb(248, 156, 116)"
9146,2020-04-27,Finland,4,101,4576,"rgb(248, 156, 116)"
9147,2020-04-28,Finland,3,119,4695,"rgb(248, 156, 116)"
9148,2020-04-29,Finland,6,45,4740,"rgb(248, 156, 116)"
9149,2020-04-30,Finland,7,166,4906,"rgb(248, 156, 116)"
9150,2020-05-01,Finland,5,89,4995,"rgb(248, 156, 116)"
9151,2020-05-02,Finland,7,56,5051,"rgb(248, 156, 116)"
9152,2020-05-03,Finland,2,128,5179,"rgb(248, 156, 116)"
9153,2020-05-04,Finland,10,75,5254,"rgb(248, 156, 116)"
9154,2020-05-05,Finland,10,73,5327,"rgb(248, 156, 116)"
9155,2020-05-06,Finland,6,85,5412,"rgb(248, 156, 116)"
9156,2020-05-07,Finland,6,161,5573,"rgb(248, 156, 116)"
9157,2020-05-08,Finland,3,100,5673,"rgb(248, 156, 116)"
9158,2020-05-09,Finland,5,65,5738,"rgb(248, 156, 116)"
9159,2020-05-10,Finland,5,142,5880,"rgb(248, 156, 116)"
9160,2020-05-11,Finland,2,82,5962,"rgb(248, 156, 116)"
9161,2020-05-12,Finland,4,22,5984,"rgb(248, 156, 116)"
9162,2020-05-13,Finland,4,19,6003,"rgb(248, 156, 116)"
9163,2020-05-14,Finland,9,51,6054,"rgb(248, 156, 116)"
9164,2020-05-15,Finland,3,91,6145,"rgb(248, 156, 116)"
9165,2020-05-16,Finland,6,83,6228,"rgb(248, 156, 116)"
9166,2020-05-17,Finland,4,58,6286,"rgb(248, 156, 116)"
9167,2020-05-18,Finland,1,61,6347,"rgb(248, 156, 116)"
9168,2020-05-19,Finland,2,33,6380,"rgb(248, 156, 116)"
9169,2020-05-20,Finland,1,19,6399,"rgb(248, 156, 116)"
9170,2020-05-21,Finland,3,44,6443,"rgb(248, 156, 116)"
9171,2020-05-22,Finland,2,50,6493,"rgb(248, 156, 116)"
9172,2020-05-23,Finland,0,44,6537,"rgb(248, 156, 116)"
9173,2020-05-24,Finland,0,31,6568,"rgb(248, 156, 116)"
9174,2020-05-25,Finland,1,11,6579,"rgb(248, 156, 116)"
9175,2020-05-26,Finland,1,20,6599,"rgb(248, 156, 116)"
9176,2020-05-27,Finland,4,29,6628,"rgb(248, 156, 116)"
9177,2020-05-28,Finland,1,64,6692,"rgb(248, 156, 116)"
9178,2020-05-29,Finland,0,51,6743,"rgb(248, 156, 116)"
9179,2020-05-30,Finland,1,33,6776,"rgb(248, 156, 116)"
9180,2020-05-31,Finland,2,50,6826,"rgb(248, 156, 116)"
9181,2020-06-01,Finland,4,33,6859,"rgb(248, 156, 116)"
9182,2020-06-02,Finland,0,26,6885,"rgb(248, 156, 116)"
9183,2020-06-03,Finland,0,2,6887,"rgb(248, 156, 116)"
9184,2020-06-04,Finland,1,24,6911,"rgb(248, 156, 116)"
9185,2020-06-05,Finland,1,0,6911,"rgb(248, 156, 116)"
9186,2020-06-06,Finland,0,30,6941,"rgb(248, 156, 116)"
9187,2020-06-07,Finland,0,23,6964,"rgb(248, 156, 116)"
9188,2020-06-08,Finland,1,17,6981,"rgb(248, 156, 116)"
9189,2020-06-09,Finland,0,20,7001,"rgb(248, 156, 116)"
9190,2020-06-10,Finland,1,24,7025,"rgb(248, 156, 116)"
9191,2020-06-11,Finland,0,15,7040,"rgb(248, 156, 116)"
9192,2020-06-12,Finland,1,24,7064,"rgb(248, 156, 116)"
9193,2020-06-13,Finland,0,9,7073,"rgb(248, 156, 116)"
9194,2020-06-14,Finland,0,14,7087,"rgb(248, 156, 116)"
9195,2020-06-15,Finland,1,17,7104,"rgb(248, 156, 116)"
9196,2020-06-16,Finland,0,4,7108,"rgb(248, 156, 116)"
9197,2020-06-17,Finland,0,4,7112,"rgb(248, 156, 116)"
9198,2020-06-18,Finland,0,5,7117,"rgb(248, 156, 116)"
9199,2020-06-19,Finland,0,0,7117,"rgb(248, 156, 116)"
9200,2020-06-20,Finland,0,16,7133,"rgb(248, 156, 116)"
9201,2020-06-21,Finland,0,9,7142,"rgb(248, 156, 116)"
9202,2020-06-22,Finland,0,1,7143,"rgb(248, 156, 116)"
9203,2020-06-23,Finland,1,1,7144,"rgb(248, 156, 116)"
9204,2020-06-24,Finland,0,11,7155,"rgb(248, 156, 116)"
9205,2020-06-25,Finland,0,12,7167,"rgb(248, 156, 116)"
9206,2020-06-26,Finland,0,5,7172,"rgb(248, 156, 116)"
9207,2020-06-27,Finland,1,19,7191,"rgb(248, 156, 116)"
9208,2020-06-28,Finland,0,0,7191,"rgb(248, 156, 116)"
9209,2020-06-29,Finland,0,0,7191,"rgb(248, 156, 116)"
9210,2020-06-30,Finland,0,18,7209,"rgb(248, 156, 116)"
9211,2020-07-01,Finland,0,5,7214,"rgb(248, 156, 116)"
9212,2020-07-02,Finland,0,22,7236,"rgb(248, 156, 116)"
9213,2020-07-03,Finland,0,5,7241,"rgb(248, 156, 116)"
9214,2020-07-04,Finland,1,1,7242,"rgb(248, 156, 116)"
9215,2020-07-05,Finland,0,6,7248,"rgb(248, 156, 116)"
9216,2020-07-06,Finland,0,5,7253,"rgb(248, 156, 116)"
9217,2020-07-07,Finland,0,4,7257,"rgb(248, 156, 116)"
9218,2020-07-08,Finland,0,5,7262,"rgb(248, 156, 116)"
9219,2020-07-09,Finland,0,3,7265,"rgb(248, 156, 116)"
9220,2020-07-10,Finland,0,8,7273,"rgb(248, 156, 116)"
9221,2020-07-11,Finland,0,6,7279,"rgb(248, 156, 116)"
9222,2020-07-12,Finland,0,0,7279,"rgb(248, 156, 116)"
9223,2020-07-13,Finland,0,15,7294,"rgb(248, 156, 116)"
9224,2020-03-20,Fiji,0,1,1,"rgb(220, 176, 242)"
9225,2020-03-21,Fiji,0,0,1,"rgb(220, 176, 242)"
9226,2020-03-22,Fiji,0,1,2,"rgb(220, 176, 242)"
9227,2020-03-23,Fiji,0,1,3,"rgb(220, 176, 242)"
9228,2020-03-24,Fiji,0,1,4,"rgb(220, 176, 242)"
9229,2020-03-25,Fiji,0,1,5,"rgb(220, 176, 242)"
9230,2020-03-26,Fiji,0,0,5,"rgb(220, 176, 242)"
9231,2020-03-27,Fiji,0,0,5,"rgb(220, 176, 242)"
9232,2020-03-28,Fiji,0,0,5,"rgb(220, 176, 242)"
9233,2020-03-29,Fiji,0,0,5,"rgb(220, 176, 242)"
9234,2020-03-30,Fiji,0,0,5,"rgb(220, 176, 242)"
9235,2020-03-31,Fiji,0,0,5,"rgb(220, 176, 242)"
9236,2020-04-01,Fiji,0,0,5,"rgb(220, 176, 242)"
9237,2020-04-02,Fiji,0,2,7,"rgb(220, 176, 242)"
9238,2020-04-03,Fiji,0,0,7,"rgb(220, 176, 242)"
9239,2020-04-04,Fiji,0,5,12,"rgb(220, 176, 242)"
9240,2020-04-05,Fiji,0,0,12,"rgb(220, 176, 242)"
9241,2020-04-06,Fiji,0,2,14,"rgb(220, 176, 242)"
9242,2020-04-07,Fiji,0,0,14,"rgb(220, 176, 242)"
9243,2020-04-08,Fiji,0,1,15,"rgb(220, 176, 242)"
9244,2020-04-09,Fiji,0,0,15,"rgb(220, 176, 242)"
9245,2020-04-10,Fiji,0,0,15,"rgb(220, 176, 242)"
9246,2020-04-11,Fiji,0,1,16,"rgb(220, 176, 242)"
9247,2020-04-12,Fiji,0,0,16,"rgb(220, 176, 242)"
9248,2020-04-13,Fiji,0,0,16,"rgb(220, 176, 242)"
9249,2020-04-14,Fiji,0,0,16,"rgb(220, 176, 242)"
9250,2020-04-15,Fiji,0,0,16,"rgb(220, 176, 242)"
9251,2020-04-16,Fiji,0,0,16,"rgb(220, 176, 242)"
9252,2020-04-17,Fiji,0,1,17,"rgb(220, 176, 242)"
9253,2020-04-18,Fiji,0,0,17,"rgb(220, 176, 242)"
9254,2020-04-19,Fiji,0,0,17,"rgb(220, 176, 242)"
9255,2020-04-20,Fiji,0,0,17,"rgb(220, 176, 242)"
9256,2020-04-21,Fiji,0,1,18,"rgb(220, 176, 242)"
9257,2020-04-22,Fiji,0,0,18,"rgb(220, 176, 242)"
9258,2020-04-23,Fiji,0,0,18,"rgb(220, 176, 242)"
9259,2020-04-24,Fiji,0,0,18,"rgb(220, 176, 242)"
9260,2020-04-25,Fiji,0,0,18,"rgb(220, 176, 242)"
9261,2020-04-26,Fiji,0,0,18,"rgb(220, 176, 242)"
9262,2020-04-27,Fiji,0,0,18,"rgb(220, 176, 242)"
9263,2020-04-28,Fiji,0,0,18,"rgb(220, 176, 242)"
9264,2020-04-29,Fiji,0,0,18,"rgb(220, 176, 242)"
9265,2020-04-30,Fiji,0,0,18,"rgb(220, 176, 242)"
9266,2020-05-01,Fiji,0,0,18,"rgb(220, 176, 242)"
9267,2020-05-02,Fiji,0,0,18,"rgb(220, 176, 242)"
9268,2020-05-03,Fiji,0,0,18,"rgb(220, 176, 242)"
9269,2020-05-04,Fiji,0,0,18,"rgb(220, 176, 242)"
9270,2020-05-05,Fiji,0,0,18,"rgb(220, 176, 242)"
9271,2020-05-06,Fiji,0,0,18,"rgb(220, 176, 242)"
9272,2020-05-07,Fiji,0,0,18,"rgb(220, 176, 242)"
9273,2020-05-08,Fiji,0,0,18,"rgb(220, 176, 242)"
9274,2020-05-09,Fiji,0,0,18,"rgb(220, 176, 242)"
9275,2020-05-10,Fiji,0,0,18,"rgb(220, 176, 242)"
9276,2020-05-11,Fiji,0,0,18,"rgb(220, 176, 242)"
9277,2020-05-12,Fiji,0,0,18,"rgb(220, 176, 242)"
9278,2020-05-13,Fiji,0,0,18,"rgb(220, 176, 242)"
9279,2020-05-14,Fiji,0,0,18,"rgb(220, 176, 242)"
9280,2020-05-15,Fiji,0,0,18,"rgb(220, 176, 242)"
9281,2020-05-16,Fiji,0,0,18,"rgb(220, 176, 242)"
9282,2020-05-17,Fiji,0,0,18,"rgb(220, 176, 242)"
9283,2020-05-18,Fiji,0,0,18,"rgb(220, 176, 242)"
9284,2020-05-19,Fiji,0,0,18,"rgb(220, 176, 242)"
9285,2020-05-20,Fiji,0,0,18,"rgb(220, 176, 242)"
9286,2020-05-21,Fiji,0,0,18,"rgb(220, 176, 242)"
9287,2020-05-22,Fiji,0,0,18,"rgb(220, 176, 242)"
9288,2020-05-23,Fiji,0,0,18,"rgb(220, 176, 242)"
9289,2020-05-24,Fiji,0,0,18,"rgb(220, 176, 242)"
9290,2020-05-25,Fiji,0,0,18,"rgb(220, 176, 242)"
9291,2020-05-26,Fiji,0,0,18,"rgb(220, 176, 242)"
9292,2020-05-27,Fiji,0,0,18,"rgb(220, 176, 242)"
9293,2020-05-28,Fiji,0,0,18,"rgb(220, 176, 242)"
9294,2020-05-29,Fiji,0,0,18,"rgb(220, 176, 242)"
9295,2020-05-30,Fiji,0,0,18,"rgb(220, 176, 242)"
9296,2020-05-31,Fiji,0,0,18,"rgb(220, 176, 242)"
9297,2020-06-01,Fiji,0,0,18,"rgb(220, 176, 242)"
9298,2020-06-02,Fiji,0,0,18,"rgb(220, 176, 242)"
9299,2020-06-03,Fiji,0,0,18,"rgb(220, 176, 242)"
9300,2020-06-04,Fiji,0,0,18,"rgb(220, 176, 242)"
9301,2020-06-05,Fiji,0,0,18,"rgb(220, 176, 242)"
9302,2020-06-06,Fiji,0,0,18,"rgb(220, 176, 242)"
9303,2020-06-07,Fiji,0,0,18,"rgb(220, 176, 242)"
9304,2020-06-08,Fiji,0,0,18,"rgb(220, 176, 242)"
9305,2020-06-09,Fiji,0,0,18,"rgb(220, 176, 242)"
9306,2020-06-10,Fiji,0,0,18,"rgb(220, 176, 242)"
9307,2020-06-11,Fiji,0,0,18,"rgb(220, 176, 242)"
9308,2020-06-12,Fiji,0,0,18,"rgb(220, 176, 242)"
9309,2020-06-13,Fiji,0,0,18,"rgb(220, 176, 242)"
9310,2020-06-14,Fiji,0,0,18,"rgb(220, 176, 242)"
9311,2020-06-15,Fiji,0,0,18,"rgb(220, 176, 242)"
9312,2020-06-16,Fiji,0,0,18,"rgb(220, 176, 242)"
9313,2020-06-17,Fiji,0,0,18,"rgb(220, 176, 242)"
9314,2020-06-18,Fiji,0,0,18,"rgb(220, 176, 242)"
9315,2020-06-19,Fiji,0,0,18,"rgb(220, 176, 242)"
9316,2020-06-20,Fiji,0,0,18,"rgb(220, 176, 242)"
9317,2020-06-21,Fiji,0,0,18,"rgb(220, 176, 242)"
9318,2020-06-22,Fiji,0,0,18,"rgb(220, 176, 242)"
9319,2020-06-23,Fiji,0,0,18,"rgb(220, 176, 242)"
9320,2020-06-24,Fiji,0,0,18,"rgb(220, 176, 242)"
9321,2020-06-25,Fiji,0,0,18,"rgb(220, 176, 242)"
9322,2020-06-26,Fiji,0,0,18,"rgb(220, 176, 242)"
9323,2020-06-27,Fiji,0,0,18,"rgb(220, 176, 242)"
9324,2020-06-28,Fiji,0,0,18,"rgb(220, 176, 242)"
9325,2020-06-29,Fiji,0,0,18,"rgb(220, 176, 242)"
9326,2020-06-30,Fiji,0,0,18,"rgb(220, 176, 242)"
9327,2020-07-01,Fiji,0,0,18,"rgb(220, 176, 242)"
9328,2020-07-02,Fiji,0,0,18,"rgb(220, 176, 242)"
9329,2020-07-03,Fiji,0,0,18,"rgb(220, 176, 242)"
9330,2020-07-04,Fiji,0,0,18,"rgb(220, 176, 242)"
9331,2020-07-05,Fiji,0,0,18,"rgb(220, 176, 242)"
9332,2020-07-06,Fiji,0,0,18,"rgb(220, 176, 242)"
9333,2020-07-07,Fiji,0,1,19,"rgb(220, 176, 242)"
9334,2020-07-08,Fiji,0,0,19,"rgb(220, 176, 242)"
9335,2020-07-09,Fiji,0,2,21,"rgb(220, 176, 242)"
9336,2020-07-10,Fiji,0,0,21,"rgb(220, 176, 242)"
9337,2020-07-11,Fiji,0,0,21,"rgb(220, 176, 242)"
9338,2020-07-12,Fiji,0,0,21,"rgb(220, 176, 242)"
9339,2020-07-13,Fiji,0,5,26,"rgb(220, 176, 242)"
9340,2020-04-04,Falkland Islands,0,1,1,"rgb(135, 197, 95)"
9341,2020-04-05,Falkland Islands,0,0,1,"rgb(135, 197, 95)"
9342,2020-04-06,Falkland Islands,0,1,2,"rgb(135, 197, 95)"
9343,2020-04-07,Falkland Islands,0,0,2,"rgb(135, 197, 95)"
9344,2020-04-08,Falkland Islands,0,3,5,"rgb(135, 197, 95)"
9345,2020-04-09,Falkland Islands,0,0,5,"rgb(135, 197, 95)"
9346,2020-04-10,Falkland Islands,0,0,5,"rgb(135, 197, 95)"
9347,2020-04-11,Falkland Islands,0,0,5,"rgb(135, 197, 95)"
9348,2020-04-12,Falkland Islands,0,0,5,"rgb(135, 197, 95)"
9349,2020-04-13,Falkland Islands,0,0,5,"rgb(135, 197, 95)"
9350,2020-04-14,Falkland Islands,0,0,5,"rgb(135, 197, 95)"
9351,2020-04-15,Falkland Islands,0,6,11,"rgb(135, 197, 95)"
9352,2020-04-16,Falkland Islands,0,0,11,"rgb(135, 197, 95)"
9353,2020-04-17,Falkland Islands,0,0,11,"rgb(135, 197, 95)"
9354,2020-04-18,Falkland Islands,0,0,11,"rgb(135, 197, 95)"
9355,2020-04-19,Falkland Islands,0,0,11,"rgb(135, 197, 95)"
9356,2020-04-20,Falkland Islands,0,0,11,"rgb(135, 197, 95)"
9357,2020-04-21,Falkland Islands,0,0,11,"rgb(135, 197, 95)"
9358,2020-04-22,Falkland Islands,0,1,12,"rgb(135, 197, 95)"
9359,2020-04-23,Falkland Islands,0,0,12,"rgb(135, 197, 95)"
9360,2020-04-24,Falkland Islands,0,0,12,"rgb(135, 197, 95)"
9361,2020-04-25,Falkland Islands,0,0,12,"rgb(135, 197, 95)"
9362,2020-04-26,Falkland Islands,0,1,13,"rgb(135, 197, 95)"
9363,2020-04-27,Falkland Islands,0,0,13,"rgb(135, 197, 95)"
9364,2020-04-28,Falkland Islands,0,0,13,"rgb(135, 197, 95)"
9365,2020-04-29,Falkland Islands,0,0,13,"rgb(135, 197, 95)"
9366,2020-04-30,Falkland Islands,0,0,13,"rgb(135, 197, 95)"
9367,2020-05-01,Falkland Islands,0,0,13,"rgb(135, 197, 95)"
9368,2020-05-02,Falkland Islands,0,0,13,"rgb(135, 197, 95)"
9369,2020-05-03,Falkland Islands,0,0,13,"rgb(135, 197, 95)"
9370,2020-05-04,Falkland Islands,0,0,13,"rgb(135, 197, 95)"
9371,2020-05-05,Falkland Islands,0,0,13,"rgb(135, 197, 95)"
9372,2020-05-06,Falkland Islands,0,0,13,"rgb(135, 197, 95)"
9373,2020-05-07,Falkland Islands,0,0,13,"rgb(135, 197, 95)"
9374,2020-05-08,Falkland Islands,0,0,13,"rgb(135, 197, 95)"
9375,2020-05-09,Falkland Islands,0,0,13,"rgb(135, 197, 95)"
9376,2020-05-10,Falkland Islands,0,0,13,"rgb(135, 197, 95)"
9377,2020-05-11,Falkland Islands,0,0,13,"rgb(135, 197, 95)"
9378,2020-05-12,Falkland Islands,0,0,13,"rgb(135, 197, 95)"
9379,2020-05-13,Falkland Islands,0,0,13,"rgb(135, 197, 95)"
9380,2020-05-14,Falkland Islands,0,0,13,"rgb(135, 197, 95)"
9381,2020-05-15,Falkland Islands,0,0,13,"rgb(135, 197, 95)"
9382,2020-05-16,Falkland Islands,0,0,13,"rgb(135, 197, 95)"
9383,2020-05-17,Falkland Islands,0,0,13,"rgb(135, 197, 95)"
9384,2020-05-18,Falkland Islands,0,0,13,"rgb(135, 197, 95)"
9385,2020-05-19,Falkland Islands,0,0,13,"rgb(135, 197, 95)"
9386,2020-05-20,Falkland Islands,0,0,13,"rgb(135, 197, 95)"
9387,2020-05-21,Falkland Islands,0,0,13,"rgb(135, 197, 95)"
9388,2020-05-22,Falkland Islands,0,0,13,"rgb(135, 197, 95)"
9389,2020-05-23,Falkland Islands,0,0,13,"rgb(135, 197, 95)"
9390,2020-05-24,Falkland Islands,0,0,13,"rgb(135, 197, 95)"
9391,2020-05-25,Falkland Islands,0,0,13,"rgb(135, 197, 95)"
9392,2020-05-26,Falkland Islands,0,0,13,"rgb(135, 197, 95)"
9393,2020-05-27,Falkland Islands,0,0,13,"rgb(135, 197, 95)"
9394,2020-05-28,Falkland Islands,0,0,13,"rgb(135, 197, 95)"
9395,2020-05-29,Falkland Islands,0,0,13,"rgb(135, 197, 95)"
9396,2020-05-30,Falkland Islands,0,0,13,"rgb(135, 197, 95)"
9397,2020-05-31,Falkland Islands,0,0,13,"rgb(135, 197, 95)"
9398,2020-06-01,Falkland Islands,0,0,13,"rgb(135, 197, 95)"
9399,2020-06-02,Falkland Islands,0,0,13,"rgb(135, 197, 95)"
9400,2020-06-03,Falkland Islands,0,0,13,"rgb(135, 197, 95)"
9401,2020-06-04,Falkland Islands,0,0,13,"rgb(135, 197, 95)"
9402,2020-06-05,Falkland Islands,0,0,13,"rgb(135, 197, 95)"
9403,2020-06-06,Falkland Islands,0,0,13,"rgb(135, 197, 95)"
9404,2020-06-07,Falkland Islands,0,0,13,"rgb(135, 197, 95)"
9405,2020-06-08,Falkland Islands,0,0,13,"rgb(135, 197, 95)"
9406,2020-06-09,Falkland Islands,0,0,13,"rgb(135, 197, 95)"
9407,2020-06-10,Falkland Islands,0,0,13,"rgb(135, 197, 95)"
9408,2020-06-11,Falkland Islands,0,0,13,"rgb(135, 197, 95)"
9409,2020-06-12,Falkland Islands,0,0,13,"rgb(135, 197, 95)"
9410,2020-06-13,Falkland Islands,0,0,13,"rgb(135, 197, 95)"
9411,2020-06-14,Falkland Islands,0,0,13,"rgb(135, 197, 95)"
9412,2020-06-15,Falkland Islands,0,0,13,"rgb(135, 197, 95)"
9413,2020-06-16,Falkland Islands,0,0,13,"rgb(135, 197, 95)"
9414,2020-06-17,Falkland Islands,0,0,13,"rgb(135, 197, 95)"
9415,2020-06-18,Falkland Islands,0,0,13,"rgb(135, 197, 95)"
9416,2020-06-19,Falkland Islands,0,0,13,"rgb(135, 197, 95)"
9417,2020-06-20,Falkland Islands,0,0,13,"rgb(135, 197, 95)"
9418,2020-06-21,Falkland Islands,0,0,13,"rgb(135, 197, 95)"
9419,2020-06-22,Falkland Islands,0,0,13,"rgb(135, 197, 95)"
9420,2020-06-23,Falkland Islands,0,0,13,"rgb(135, 197, 95)"
9421,2020-06-24,Falkland Islands,0,0,13,"rgb(135, 197, 95)"
9422,2020-06-25,Falkland Islands,0,0,13,"rgb(135, 197, 95)"
9423,2020-06-26,Falkland Islands,0,0,13,"rgb(135, 197, 95)"
9424,2020-06-27,Falkland Islands,0,0,13,"rgb(135, 197, 95)"
9425,2020-06-28,Falkland Islands,0,0,13,"rgb(135, 197, 95)"
9426,2020-06-29,Falkland Islands,0,0,13,"rgb(135, 197, 95)"
9427,2020-06-30,Falkland Islands,0,0,13,"rgb(135, 197, 95)"
9428,2020-07-01,Falkland Islands,0,0,13,"rgb(135, 197, 95)"
9429,2020-07-02,Falkland Islands,0,0,13,"rgb(135, 197, 95)"
9430,2020-07-03,Falkland Islands,0,0,13,"rgb(135, 197, 95)"
9431,2020-07-04,Falkland Islands,0,0,13,"rgb(135, 197, 95)"
9432,2020-07-05,Falkland Islands,0,0,13,"rgb(135, 197, 95)"
9433,2020-07-06,Falkland Islands,0,0,13,"rgb(135, 197, 95)"
9434,2020-07-07,Falkland Islands,0,0,13,"rgb(135, 197, 95)"
9435,2020-07-08,Falkland Islands,0,0,13,"rgb(135, 197, 95)"
9436,2020-07-09,Falkland Islands,0,0,13,"rgb(135, 197, 95)"
9437,2020-07-10,Falkland Islands,0,0,13,"rgb(135, 197, 95)"
9438,2020-07-11,Falkland Islands,0,0,13,"rgb(135, 197, 95)"
9439,2020-07-12,Falkland Islands,0,0,13,"rgb(135, 197, 95)"
9440,2020-07-13,Falkland Islands,0,0,13,"rgb(135, 197, 95)"
9441,2020-03-06,Faroe Islands,0,1,1,"rgb(158, 185, 243)"
9442,2020-03-07,Faroe Islands,0,1,2,"rgb(158, 185, 243)"
9443,2020-03-08,Faroe Islands,0,1,3,"rgb(158, 185, 243)"
9444,2020-03-09,Faroe Islands,0,0,3,"rgb(158, 185, 243)"
9445,2020-03-10,Faroe Islands,0,0,3,"rgb(158, 185, 243)"
9446,2020-03-11,Faroe Islands,0,0,3,"rgb(158, 185, 243)"
9447,2020-03-12,Faroe Islands,0,0,3,"rgb(158, 185, 243)"
9448,2020-03-13,Faroe Islands,0,0,3,"rgb(158, 185, 243)"
9449,2020-03-14,Faroe Islands,0,0,3,"rgb(158, 185, 243)"
9450,2020-03-15,Faroe Islands,0,0,3,"rgb(158, 185, 243)"
9451,2020-03-16,Faroe Islands,0,6,9,"rgb(158, 185, 243)"
9452,2020-03-17,Faroe Islands,0,2,11,"rgb(158, 185, 243)"
9453,2020-03-18,Faroe Islands,0,7,18,"rgb(158, 185, 243)"
9454,2020-03-19,Faroe Islands,0,29,47,"rgb(158, 185, 243)"
9455,2020-03-20,Faroe Islands,0,25,72,"rgb(158, 185, 243)"
9456,2020-03-21,Faroe Islands,0,8,80,"rgb(158, 185, 243)"
9457,2020-03-22,Faroe Islands,0,12,92,"rgb(158, 185, 243)"
9458,2020-03-23,Faroe Islands,0,23,115,"rgb(158, 185, 243)"
9459,2020-03-24,Faroe Islands,0,3,118,"rgb(158, 185, 243)"
9460,2020-03-25,Faroe Islands,0,4,122,"rgb(158, 185, 243)"
9461,2020-03-26,Faroe Islands,0,10,132,"rgb(158, 185, 243)"
9462,2020-03-27,Faroe Islands,0,8,140,"rgb(158, 185, 243)"
9463,2020-03-28,Faroe Islands,0,4,144,"rgb(158, 185, 243)"
9464,2020-03-29,Faroe Islands,0,11,155,"rgb(158, 185, 243)"
9465,2020-03-30,Faroe Islands,0,4,159,"rgb(158, 185, 243)"
9466,2020-03-31,Faroe Islands,0,9,168,"rgb(158, 185, 243)"
9467,2020-04-01,Faroe Islands,0,1,169,"rgb(158, 185, 243)"
9468,2020-04-02,Faroe Islands,0,4,173,"rgb(158, 185, 243)"
9469,2020-04-03,Faroe Islands,0,4,177,"rgb(158, 185, 243)"
9470,2020-04-04,Faroe Islands,0,2,179,"rgb(158, 185, 243)"
9471,2020-04-05,Faroe Islands,0,2,181,"rgb(158, 185, 243)"
9472,2020-04-06,Faroe Islands,0,0,181,"rgb(158, 185, 243)"
9473,2020-04-07,Faroe Islands,0,2,183,"rgb(158, 185, 243)"
9474,2020-04-08,Faroe Islands,0,1,184,"rgb(158, 185, 243)"
9475,2020-04-09,Faroe Islands,0,0,184,"rgb(158, 185, 243)"
9476,2020-04-10,Faroe Islands,0,0,184,"rgb(158, 185, 243)"
9477,2020-04-11,Faroe Islands,0,0,184,"rgb(158, 185, 243)"
9478,2020-04-12,Faroe Islands,0,0,184,"rgb(158, 185, 243)"
9479,2020-04-13,Faroe Islands,0,0,184,"rgb(158, 185, 243)"
9480,2020-04-14,Faroe Islands,0,0,184,"rgb(158, 185, 243)"
9481,2020-04-15,Faroe Islands,0,0,184,"rgb(158, 185, 243)"
9482,2020-04-16,Faroe Islands,0,0,184,"rgb(158, 185, 243)"
9483,2020-04-17,Faroe Islands,0,0,184,"rgb(158, 185, 243)"
9484,2020-04-18,Faroe Islands,0,0,184,"rgb(158, 185, 243)"
9485,2020-04-19,Faroe Islands,0,0,184,"rgb(158, 185, 243)"
9486,2020-04-20,Faroe Islands,0,1,185,"rgb(158, 185, 243)"
9487,2020-04-21,Faroe Islands,0,0,185,"rgb(158, 185, 243)"
9488,2020-04-22,Faroe Islands,0,0,185,"rgb(158, 185, 243)"
9489,2020-04-23,Faroe Islands,0,0,185,"rgb(158, 185, 243)"
9490,2020-04-24,Faroe Islands,0,2,187,"rgb(158, 185, 243)"
9491,2020-04-25,Faroe Islands,0,0,187,"rgb(158, 185, 243)"
9492,2020-04-26,Faroe Islands,0,0,187,"rgb(158, 185, 243)"
9493,2020-04-27,Faroe Islands,0,0,187,"rgb(158, 185, 243)"
9494,2020-04-28,Faroe Islands,0,0,187,"rgb(158, 185, 243)"
9495,2020-04-29,Faroe Islands,0,0,187,"rgb(158, 185, 243)"
9496,2020-04-30,Faroe Islands,0,0,187,"rgb(158, 185, 243)"
9497,2020-05-01,Faroe Islands,0,0,187,"rgb(158, 185, 243)"
9498,2020-05-02,Faroe Islands,0,0,187,"rgb(158, 185, 243)"
9499,2020-05-03,Faroe Islands,0,0,187,"rgb(158, 185, 243)"
9500,2020-05-04,Faroe Islands,0,0,187,"rgb(158, 185, 243)"
9501,2020-05-05,Faroe Islands,0,0,187,"rgb(158, 185, 243)"
9502,2020-05-06,Faroe Islands,0,0,187,"rgb(158, 185, 243)"
9503,2020-05-07,Faroe Islands,0,0,187,"rgb(158, 185, 243)"
9504,2020-05-08,Faroe Islands,0,0,187,"rgb(158, 185, 243)"
9505,2020-05-09,Faroe Islands,0,0,187,"rgb(158, 185, 243)"
9506,2020-05-10,Faroe Islands,0,0,187,"rgb(158, 185, 243)"
9507,2020-05-11,Faroe Islands,0,0,187,"rgb(158, 185, 243)"
9508,2020-05-12,Faroe Islands,0,0,187,"rgb(158, 185, 243)"
9509,2020-05-13,Faroe Islands,0,0,187,"rgb(158, 185, 243)"
9510,2020-05-14,Faroe Islands,0,0,187,"rgb(158, 185, 243)"
9511,2020-05-15,Faroe Islands,0,0,187,"rgb(158, 185, 243)"
9512,2020-05-16,Faroe Islands,0,0,187,"rgb(158, 185, 243)"
9513,2020-05-17,Faroe Islands,0,0,187,"rgb(158, 185, 243)"
9514,2020-05-18,Faroe Islands,0,0,187,"rgb(158, 185, 243)"
9515,2020-05-19,Faroe Islands,0,0,187,"rgb(158, 185, 243)"
9516,2020-05-20,Faroe Islands,0,0,187,"rgb(158, 185, 243)"
9517,2020-05-21,Faroe Islands,0,0,187,"rgb(158, 185, 243)"
9518,2020-05-22,Faroe Islands,0,0,187,"rgb(158, 185, 243)"
9519,2020-05-23,Faroe Islands,0,0,187,"rgb(158, 185, 243)"
9520,2020-05-24,Faroe Islands,0,0,187,"rgb(158, 185, 243)"
9521,2020-05-25,Faroe Islands,0,0,187,"rgb(158, 185, 243)"
9522,2020-05-26,Faroe Islands,0,0,187,"rgb(158, 185, 243)"
9523,2020-05-27,Faroe Islands,0,0,187,"rgb(158, 185, 243)"
9524,2020-05-28,Faroe Islands,0,0,187,"rgb(158, 185, 243)"
9525,2020-05-29,Faroe Islands,0,0,187,"rgb(158, 185, 243)"
9526,2020-05-30,Faroe Islands,0,0,187,"rgb(158, 185, 243)"
9527,2020-05-31,Faroe Islands,0,0,187,"rgb(158, 185, 243)"
9528,2020-06-01,Faroe Islands,0,0,187,"rgb(158, 185, 243)"
9529,2020-06-02,Faroe Islands,0,0,187,"rgb(158, 185, 243)"
9530,2020-06-03,Faroe Islands,0,0,187,"rgb(158, 185, 243)"
9531,2020-06-04,Faroe Islands,0,0,187,"rgb(158, 185, 243)"
9532,2020-06-05,Faroe Islands,0,0,187,"rgb(158, 185, 243)"
9533,2020-06-06,Faroe Islands,0,0,187,"rgb(158, 185, 243)"
9534,2020-06-07,Faroe Islands,0,0,187,"rgb(158, 185, 243)"
9535,2020-06-08,Faroe Islands,0,0,187,"rgb(158, 185, 243)"
9536,2020-06-09,Faroe Islands,0,0,187,"rgb(158, 185, 243)"
9537,2020-06-10,Faroe Islands,0,0,187,"rgb(158, 185, 243)"
9538,2020-06-11,Faroe Islands,0,0,187,"rgb(158, 185, 243)"
9539,2020-06-12,Faroe Islands,0,0,187,"rgb(158, 185, 243)"
9540,2020-06-13,Faroe Islands,0,0,187,"rgb(158, 185, 243)"
9541,2020-06-14,Faroe Islands,0,0,187,"rgb(158, 185, 243)"
9542,2020-06-15,Faroe Islands,0,0,187,"rgb(158, 185, 243)"
9543,2020-06-16,Faroe Islands,0,0,187,"rgb(158, 185, 243)"
9544,2020-06-17,Faroe Islands,0,0,187,"rgb(158, 185, 243)"
9545,2020-06-18,Faroe Islands,0,0,187,"rgb(158, 185, 243)"
9546,2020-06-19,Faroe Islands,0,0,187,"rgb(158, 185, 243)"
9547,2020-06-20,Faroe Islands,0,0,187,"rgb(158, 185, 243)"
9548,2020-06-21,Faroe Islands,0,0,187,"rgb(158, 185, 243)"
9549,2020-06-22,Faroe Islands,0,0,187,"rgb(158, 185, 243)"
9550,2020-06-23,Faroe Islands,0,0,187,"rgb(158, 185, 243)"
9551,2020-06-24,Faroe Islands,0,0,187,"rgb(158, 185, 243)"
9552,2020-06-25,Faroe Islands,0,0,187,"rgb(158, 185, 243)"
9553,2020-06-26,Faroe Islands,0,0,187,"rgb(158, 185, 243)"
9554,2020-06-27,Faroe Islands,0,0,187,"rgb(158, 185, 243)"
9555,2020-06-28,Faroe Islands,0,0,187,"rgb(158, 185, 243)"
9556,2020-06-29,Faroe Islands,0,0,187,"rgb(158, 185, 243)"
9557,2020-06-30,Faroe Islands,0,0,187,"rgb(158, 185, 243)"
9558,2020-07-01,Faroe Islands,0,0,187,"rgb(158, 185, 243)"
9559,2020-07-02,Faroe Islands,0,0,187,"rgb(158, 185, 243)"
9560,2020-07-03,Faroe Islands,0,0,187,"rgb(158, 185, 243)"
9561,2020-07-04,Faroe Islands,0,0,187,"rgb(158, 185, 243)"
9562,2020-07-05,Faroe Islands,0,0,187,"rgb(158, 185, 243)"
9563,2020-07-06,Faroe Islands,0,0,187,"rgb(158, 185, 243)"
9564,2020-07-07,Faroe Islands,0,0,187,"rgb(158, 185, 243)"
9565,2020-07-08,Faroe Islands,0,1,188,"rgb(158, 185, 243)"
9566,2020-07-09,Faroe Islands,0,0,188,"rgb(158, 185, 243)"
9567,2020-07-10,Faroe Islands,0,0,188,"rgb(158, 185, 243)"
9568,2020-07-11,Faroe Islands,0,0,188,"rgb(158, 185, 243)"
9569,2020-07-12,Faroe Islands,0,0,188,"rgb(158, 185, 243)"
9570,2020-07-13,Faroe Islands,0,0,188,"rgb(158, 185, 243)"
9571,2019-12-31,France,0,0,0,"rgb(254, 136, 177)"
9572,2020-01-01,France,0,0,0,"rgb(254, 136, 177)"
9573,2020-01-02,France,0,0,0,"rgb(254, 136, 177)"
9574,2020-01-03,France,0,0,0,"rgb(254, 136, 177)"
9575,2020-01-04,France,0,0,0,"rgb(254, 136, 177)"
9576,2020-01-05,France,0,0,0,"rgb(254, 136, 177)"
9577,2020-01-06,France,0,0,0,"rgb(254, 136, 177)"
9578,2020-01-07,France,0,0,0,"rgb(254, 136, 177)"
9579,2020-01-08,France,0,0,0,"rgb(254, 136, 177)"
9580,2020-01-09,France,0,0,0,"rgb(254, 136, 177)"
9581,2020-01-10,France,0,0,0,"rgb(254, 136, 177)"
9582,2020-01-11,France,0,0,0,"rgb(254, 136, 177)"
9583,2020-01-12,France,0,0,0,"rgb(254, 136, 177)"
9584,2020-01-13,France,0,0,0,"rgb(254, 136, 177)"
9585,2020-01-14,France,0,0,0,"rgb(254, 136, 177)"
9586,2020-01-15,France,0,0,0,"rgb(254, 136, 177)"
9587,2020-01-16,France,0,0,0,"rgb(254, 136, 177)"
9588,2020-01-17,France,0,0,0,"rgb(254, 136, 177)"
9589,2020-01-18,France,0,0,0,"rgb(254, 136, 177)"
9590,2020-01-19,France,0,0,0,"rgb(254, 136, 177)"
9591,2020-01-20,France,0,0,0,"rgb(254, 136, 177)"
9592,2020-01-21,France,0,0,0,"rgb(254, 136, 177)"
9593,2020-01-22,France,0,0,0,"rgb(254, 136, 177)"
9594,2020-01-23,France,0,0,0,"rgb(254, 136, 177)"
9595,2020-01-24,France,0,0,0,"rgb(254, 136, 177)"
9596,2020-01-25,France,0,3,3,"rgb(254, 136, 177)"
9597,2020-01-26,France,0,0,3,"rgb(254, 136, 177)"
9598,2020-01-27,France,0,0,3,"rgb(254, 136, 177)"
9599,2020-01-28,France,0,0,3,"rgb(254, 136, 177)"
9600,2020-01-29,France,0,1,4,"rgb(254, 136, 177)"
9601,2020-01-30,France,0,1,5,"rgb(254, 136, 177)"
9602,2020-01-31,France,0,1,6,"rgb(254, 136, 177)"
9603,2020-02-01,France,0,0,6,"rgb(254, 136, 177)"
9604,2020-02-02,France,0,0,6,"rgb(254, 136, 177)"
9605,2020-02-03,France,0,0,6,"rgb(254, 136, 177)"
9606,2020-02-04,France,0,0,6,"rgb(254, 136, 177)"
9607,2020-02-05,France,0,0,6,"rgb(254, 136, 177)"
9608,2020-02-06,France,0,0,6,"rgb(254, 136, 177)"
9609,2020-02-07,France,0,0,6,"rgb(254, 136, 177)"
9610,2020-02-08,France,0,5,11,"rgb(254, 136, 177)"
9611,2020-02-09,France,0,0,11,"rgb(254, 136, 177)"
9612,2020-02-10,France,0,0,11,"rgb(254, 136, 177)"
9613,2020-02-11,France,0,0,11,"rgb(254, 136, 177)"
9614,2020-02-12,France,0,0,11,"rgb(254, 136, 177)"
9615,2020-02-13,France,0,0,11,"rgb(254, 136, 177)"
9616,2020-02-14,France,0,0,11,"rgb(254, 136, 177)"
9617,2020-02-15,France,1,0,11,"rgb(254, 136, 177)"
9618,2020-02-16,France,0,0,11,"rgb(254, 136, 177)"
9619,2020-02-17,France,0,1,12,"rgb(254, 136, 177)"
9620,2020-02-18,France,0,0,12,"rgb(254, 136, 177)"
9621,2020-02-19,France,0,0,12,"rgb(254, 136, 177)"
9622,2020-02-20,France,0,0,12,"rgb(254, 136, 177)"
9623,2020-02-21,France,0,0,12,"rgb(254, 136, 177)"
9624,2020-02-22,France,0,0,12,"rgb(254, 136, 177)"
9625,2020-02-23,France,0,0,12,"rgb(254, 136, 177)"
9626,2020-02-24,France,0,0,12,"rgb(254, 136, 177)"
9627,2020-02-25,France,0,0,12,"rgb(254, 136, 177)"
9628,2020-02-26,France,0,2,14,"rgb(254, 136, 177)"
9629,2020-02-27,France,1,3,17,"rgb(254, 136, 177)"
9630,2020-02-28,France,0,21,38,"rgb(254, 136, 177)"
9631,2020-02-29,France,0,19,57,"rgb(254, 136, 177)"
9632,2020-03-01,France,0,43,100,"rgb(254, 136, 177)"
9633,2020-03-02,France,0,30,130,"rgb(254, 136, 177)"
9634,2020-03-03,France,1,48,178,"rgb(254, 136, 177)"
9635,2020-03-04,France,1,34,212,"rgb(254, 136, 177)"
9636,2020-03-05,France,0,73,285,"rgb(254, 136, 177)"
9637,2020-03-06,France,3,138,423,"rgb(254, 136, 177)"
9638,2020-03-07,France,2,190,613,"rgb(254, 136, 177)"
9639,2020-03-08,France,1,103,716,"rgb(254, 136, 177)"
9640,2020-03-09,France,9,410,1126,"rgb(254, 136, 177)"
9641,2020-03-10,France,11,286,1412,"rgb(254, 136, 177)"
9642,2020-03-11,France,3,372,1784,"rgb(254, 136, 177)"
9643,2020-03-12,France,15,497,2281,"rgb(254, 136, 177)"
9644,2020-03-13,France,13,595,2876,"rgb(254, 136, 177)"
9645,2020-03-14,France,18,785,3661,"rgb(254, 136, 177)"
9646,2020-03-15,France,12,838,4499,"rgb(254, 136, 177)"
9647,2020-03-16,France,36,924,5423,"rgb(254, 136, 177)"
9648,2020-03-17,France,21,1210,6633,"rgb(254, 136, 177)"
9649,2020-03-18,France,27,1097,7730,"rgb(254, 136, 177)"
9650,2020-03-19,France,69,1404,9134,"rgb(254, 136, 177)"
9651,2020-03-20,France,128,1861,10995,"rgb(254, 136, 177)"
9652,2020-03-21,France,78,1617,12612,"rgb(254, 136, 177)"
9653,2020-03-22,France,112,1847,14459,"rgb(254, 136, 177)"
9654,2020-03-23,France,112,1559,16018,"rgb(254, 136, 177)"
9655,2020-03-24,France,186,3838,19856,"rgb(254, 136, 177)"
9656,2020-03-25,France,240,2446,22302,"rgb(254, 136, 177)"
9657,2020-03-26,France,231,2931,25233,"rgb(254, 136, 177)"
9658,2020-03-27,France,365,3922,29155,"rgb(254, 136, 177)"
9659,2020-03-28,France,299,3809,32964,"rgb(254, 136, 177)"
9660,2020-03-29,France,319,4611,37575,"rgb(254, 136, 177)"
9661,2020-03-30,France,292,2599,40174,"rgb(254, 136, 177)"
9662,2020-03-31,France,418,4376,44550,"rgb(254, 136, 177)"
9663,2020-04-01,France,499,7578,52128,"rgb(254, 136, 177)"
9664,2020-04-02,France,509,4861,56989,"rgb(254, 136, 177)"
9665,2020-04-03,France,471,2116,59105,"rgb(254, 136, 177)"
9666,2020-04-04,France,2004,5233,64338,"rgb(254, 136, 177)"
9667,2020-04-05,France,1053,4267,68605,"rgb(254, 136, 177)"
9668,2020-04-06,France,518,1873,70478,"rgb(254, 136, 177)"
9669,2020-04-07,France,833,3912,74390,"rgb(254, 136, 177)"
9670,2020-04-08,France,1417,3777,78167,"rgb(254, 136, 177)"
9671,2020-04-09,France,541,3881,82048,"rgb(254, 136, 177)"
9672,2020-04-10,France,1341,4286,86334,"rgb(254, 136, 177)"
9673,2020-04-11,France,987,4342,90676,"rgb(254, 136, 177)"
9674,2020-04-12,France,635,3114,93790,"rgb(254, 136, 177)"
9675,2020-04-13,France,561,1613,95403,"rgb(254, 136, 177)"
9676,2020-04-14,France,574,2673,98076,"rgb(254, 136, 177)"
9677,2020-04-15,France,762,5497,103573,"rgb(254, 136, 177)"
9678,2020-04-16,France,1438,2633,106206,"rgb(254, 136, 177)"
9679,2020-04-17,France,753,2641,108847,"rgb(254, 136, 177)"
9680,2020-04-18,France,761,405,109252,"rgb(254, 136, 177)"
9681,2020-04-19,France,642,2569,111821,"rgb(254, 136, 177)"
9682,2020-04-20,France,395,785,112606,"rgb(254, 136, 177)"
9683,2020-04-21,France,547,2051,114657,"rgb(254, 136, 177)"
9684,2020-04-22,France,531,2667,117324,"rgb(254, 136, 177)"
9685,2020-04-23,France,544,1827,119151,"rgb(254, 136, 177)"
9686,2020-04-24,France,516,1653,120804,"rgb(254, 136, 177)"
9687,2020-04-25,France,389,1773,122577,"rgb(254, 136, 177)"
9688,2020-04-26,France,369,1537,124114,"rgb(254, 136, 177)"
9689,2020-04-27,France,242,461,124575,"rgb(254, 136, 177)"
9690,2020-04-28,France,437,1195,125770,"rgb(254, 136, 177)"
9691,2020-04-29,France,367,1065,126835,"rgb(254, 136, 177)"
9692,2020-04-30,France,427,1607,128442,"rgb(254, 136, 177)"
9693,2020-05-01,France,289,1139,129581,"rgb(254, 136, 177)"
9694,2020-05-02,France,218,604,130185,"rgb(254, 136, 177)"
9695,2020-05-03,France,166,794,130979,"rgb(254, 136, 177)"
9696,2020-05-04,France,135,308,131287,"rgb(254, 136, 177)"
9697,2020-05-05,France,306,576,131863,"rgb(254, 136, 177)"
9698,2020-05-06,France,330,1104,132967,"rgb(254, 136, 177)"
9699,2020-05-07,France,278,4183,137150,"rgb(254, 136, 177)"
9700,2020-05-08,France,178,629,137779,"rgb(254, 136, 177)"
9701,2020-05-09,France,243,642,138421,"rgb(254, 136, 177)"
9702,2020-05-10,France,80,433,138854,"rgb(254, 136, 177)"
9703,2020-05-11,France,70,209,139063,"rgb(254, 136, 177)"
9704,2020-05-12,France,263,456,139519,"rgb(254, 136, 177)"
9705,2020-05-13,France,348,708,140227,"rgb(254, 136, 177)"
9706,2020-05-14,France,83,507,140734,"rgb(254, 136, 177)"
9707,2020-05-15,France,351,622,141356,"rgb(254, 136, 177)"
9708,2020-05-16,France,130,563,141919,"rgb(254, 136, 177)"
9709,2020-05-17,France,88,372,142291,"rgb(254, 136, 177)"
9710,2020-05-18,France,68,120,142411,"rgb(254, 136, 177)"
9711,2020-05-19,France,186,492,142903,"rgb(254, 136, 177)"
9712,2020-05-20,France,125,524,143427,"rgb(254, 136, 177)"
9713,2020-05-21,France,110,418,143845,"rgb(254, 136, 177)"
9714,2020-05-22,France,83,318,144163,"rgb(254, 136, 177)"
9715,2020-05-23,France,74,403,144566,"rgb(254, 136, 177)"
9716,2020-05-24,France,43,240,144806,"rgb(254, 136, 177)"
9717,2020-05-25,France,35,115,144921,"rgb(254, 136, 177)"
9718,2020-05-26,France,65,358,145279,"rgb(254, 136, 177)"
9719,2020-05-27,France,98,276,145555,"rgb(254, 136, 177)"
9720,2020-05-28,France,66,191,145746,"rgb(254, 136, 177)"
9721,2020-05-29,France,66,3325,149071,"rgb(254, 136, 177)"
9722,2020-05-30,France,52,597,149668,"rgb(254, 136, 177)"
9723,2020-05-31,France,57,1828,151496,"rgb(254, 136, 177)"
9724,2020-06-01,France,31,257,151753,"rgb(254, 136, 177)"
9725,2020-06-02,France,31,338,152091,"rgb(254, 136, 177)"
9726,2020-06-03,France,107,-766,151325,"rgb(254, 136, 177)"
9727,2020-06-04,France,81,352,151677,"rgb(254, 136, 177)"
9728,2020-06-05,France,44,767,152444,"rgb(254, 136, 177)"
9729,2020-06-06,France,46,611,153055,"rgb(254, 136, 177)"
9730,2020-06-07,France,31,579,153634,"rgb(254, 136, 177)"
9731,2020-06-08,France,13,343,153977,"rgb(254, 136, 177)"
9732,2020-06-09,France,54,211,154188,"rgb(254, 136, 177)"
9733,2020-06-10,France,87,403,154591,"rgb(254, 136, 177)"
9734,2020-06-11,France,23,545,155136,"rgb(254, 136, 177)"
9735,2020-06-12,France,27,425,155561,"rgb(254, 136, 177)"
9736,2020-06-13,France,28,726,156287,"rgb(254, 136, 177)"
9737,2020-06-14,France,24,526,156813,"rgb(254, 136, 177)"
9738,2020-06-15,France,9,407,157220,"rgb(254, 136, 177)"
9739,2020-06-16,France,29,152,157372,"rgb(254, 136, 177)"
9740,2020-06-17,France,111,344,157716,"rgb(254, 136, 177)"
9741,2020-06-18,France,28,458,158174,"rgb(254, 136, 177)"
9742,2020-06-19,France,28,467,158641,"rgb(254, 136, 177)"
9743,2020-06-20,France,14,811,159452,"rgb(254, 136, 177)"
9744,2020-06-21,France,16,641,160093,"rgb(254, 136, 177)"
9745,2020-06-22,France,7,284,160377,"rgb(254, 136, 177)"
9746,2020-06-23,France,23,373,160750,"rgb(254, 136, 177)"
9747,2020-06-24,France,57,517,161267,"rgb(254, 136, 177)"
9748,2020-06-25,France,11,81,161348,"rgb(254, 136, 177)"
9749,2020-06-26,France,21,0,161348,"rgb(254, 136, 177)"
9750,2020-06-27,France,26,1588,162936,"rgb(254, 136, 177)"
9751,2020-06-28,France,0,0,162936,"rgb(254, 136, 177)"
9752,2020-06-29,France,0,0,162936,"rgb(254, 136, 177)"
9753,2020-06-30,France,35,1324,164260,"rgb(254, 136, 177)"
9754,2020-07-01,France,30,541,164801,"rgb(254, 136, 177)"
9755,2020-07-02,France,18,918,165719,"rgb(254, 136, 177)"
9756,2020-07-03,France,14,659,166378,"rgb(254, 136, 177)"
9757,2020-07-04,France,18,582,166960,"rgb(254, 136, 177)"
9758,2020-07-05,France,0,0,166960,"rgb(254, 136, 177)"
9759,2020-07-06,France,0,0,166960,"rgb(254, 136, 177)"
9760,2020-07-07,France,27,1375,168335,"rgb(254, 136, 177)"
9761,2020-07-08,France,13,475,168810,"rgb(254, 136, 177)"
9762,2020-07-09,France,32,663,169473,"rgb(254, 136, 177)"
9763,2020-07-10,France,14,621,170094,"rgb(254, 136, 177)"
9764,2020-07-11,France,25,658,170752,"rgb(254, 136, 177)"
9765,2020-07-12,France,0,0,170752,"rgb(254, 136, 177)"
9766,2020-07-13,France,0,0,170752,"rgb(254, 136, 177)"
9767,2020-03-13,Gabon,0,1,1,"rgb(201, 219, 116)"
9768,2020-03-15,Gabon,0,0,1,"rgb(201, 219, 116)"
9769,2020-03-16,Gabon,0,0,1,"rgb(201, 219, 116)"
9770,2020-03-17,Gabon,0,0,1,"rgb(201, 219, 116)"
9771,2020-03-18,Gabon,0,0,1,"rgb(201, 219, 116)"
9772,2020-03-19,Gabon,0,2,3,"rgb(201, 219, 116)"
9773,2020-03-20,Gabon,0,0,3,"rgb(201, 219, 116)"
9774,2020-03-21,Gabon,1,0,3,"rgb(201, 219, 116)"
9775,2020-03-22,Gabon,0,0,3,"rgb(201, 219, 116)"
9776,2020-03-23,Gabon,0,3,6,"rgb(201, 219, 116)"
9777,2020-03-24,Gabon,0,0,6,"rgb(201, 219, 116)"
9778,2020-03-25,Gabon,0,0,6,"rgb(201, 219, 116)"
9779,2020-03-26,Gabon,0,0,6,"rgb(201, 219, 116)"
9780,2020-03-27,Gabon,0,1,7,"rgb(201, 219, 116)"
9781,2020-03-28,Gabon,0,0,7,"rgb(201, 219, 116)"
9782,2020-03-29,Gabon,0,0,7,"rgb(201, 219, 116)"
9783,2020-03-30,Gabon,0,0,7,"rgb(201, 219, 116)"
9784,2020-03-31,Gabon,0,0,7,"rgb(201, 219, 116)"
9785,2020-04-01,Gabon,0,9,16,"rgb(201, 219, 116)"
9786,2020-04-02,Gabon,0,2,18,"rgb(201, 219, 116)"
9787,2020-04-03,Gabon,0,0,18,"rgb(201, 219, 116)"
9788,2020-04-04,Gabon,0,3,21,"rgb(201, 219, 116)"
9789,2020-04-05,Gabon,0,0,21,"rgb(201, 219, 116)"
9790,2020-04-06,Gabon,0,0,21,"rgb(201, 219, 116)"
9791,2020-04-07,Gabon,0,0,21,"rgb(201, 219, 116)"
9792,2020-04-08,Gabon,0,9,30,"rgb(201, 219, 116)"
9793,2020-04-09,Gabon,0,3,33,"rgb(201, 219, 116)"
9794,2020-04-10,Gabon,0,11,44,"rgb(201, 219, 116)"
9795,2020-04-11,Gabon,0,2,46,"rgb(201, 219, 116)"
9796,2020-04-12,Gabon,0,3,49,"rgb(201, 219, 116)"
9797,2020-04-13,Gabon,0,8,57,"rgb(201, 219, 116)"
9798,2020-04-14,Gabon,0,0,57,"rgb(201, 219, 116)"
9799,2020-04-15,Gabon,0,18,75,"rgb(201, 219, 116)"
9800,2020-04-16,Gabon,0,12,87,"rgb(201, 219, 116)"
9801,2020-04-17,Gabon,0,8,95,"rgb(201, 219, 116)"
9802,2020-04-18,Gabon,0,13,108,"rgb(201, 219, 116)"
9803,2020-04-19,Gabon,0,1,109,"rgb(201, 219, 116)"
9804,2020-04-20,Gabon,0,0,109,"rgb(201, 219, 116)"
9805,2020-04-21,Gabon,0,11,120,"rgb(201, 219, 116)"
9806,2020-04-22,Gabon,0,36,156,"rgb(201, 219, 116)"
9807,2020-04-23,Gabon,0,10,166,"rgb(201, 219, 116)"
9808,2020-04-24,Gabon,1,1,167,"rgb(201, 219, 116)"
9809,2020-04-25,Gabon,1,5,172,"rgb(201, 219, 116)"
9810,2020-04-26,Gabon,0,4,176,"rgb(201, 219, 116)"
9811,2020-04-27,Gabon,0,0,176,"rgb(201, 219, 116)"
9812,2020-04-28,Gabon,0,35,211,"rgb(201, 219, 116)"
9813,2020-04-29,Gabon,0,27,238,"rgb(201, 219, 116)"
9814,2020-04-30,Gabon,0,38,276,"rgb(201, 219, 116)"
9815,2020-05-01,Gabon,0,0,276,"rgb(201, 219, 116)"
9816,2020-05-02,Gabon,1,32,308,"rgb(201, 219, 116)"
9817,2020-05-03,Gabon,1,27,335,"rgb(201, 219, 116)"
9818,2020-05-04,Gabon,0,0,335,"rgb(201, 219, 116)"
9819,2020-05-05,Gabon,1,32,367,"rgb(201, 219, 116)"
9820,2020-05-06,Gabon,0,30,397,"rgb(201, 219, 116)"
9821,2020-05-07,Gabon,2,42,439,"rgb(201, 219, 116)"
9822,2020-05-08,Gabon,0,65,504,"rgb(201, 219, 116)"
9823,2020-05-09,Gabon,0,116,620,"rgb(201, 219, 116)"
9824,2020-05-10,Gabon,0,41,661,"rgb(201, 219, 116)"
9825,2020-05-11,Gabon,0,0,661,"rgb(201, 219, 116)"
9826,2020-05-12,Gabon,1,141,802,"rgb(201, 219, 116)"
9827,2020-05-13,Gabon,0,61,863,"rgb(201, 219, 116)"
9828,2020-05-14,Gabon,0,141,1004,"rgb(201, 219, 116)"
9829,2020-05-15,Gabon,1,100,1104,"rgb(201, 219, 116)"
9830,2020-05-16,Gabon,0,105,1209,"rgb(201, 219, 116)"
9831,2020-05-17,Gabon,1,111,1320,"rgb(201, 219, 116)"
9832,2020-05-18,Gabon,0,0,1320,"rgb(201, 219, 116)"
9833,2020-05-19,Gabon,0,112,1432,"rgb(201, 219, 116)"
9834,2020-05-20,Gabon,1,70,1502,"rgb(201, 219, 116)"
9835,2020-05-21,Gabon,0,65,1567,"rgb(201, 219, 116)"
9836,2020-05-22,Gabon,0,0,1567,"rgb(201, 219, 116)"
9837,2020-05-23,Gabon,0,161,1728,"rgb(201, 219, 116)"
9838,2020-05-24,Gabon,0,206,1934,"rgb(201, 219, 116)"
9839,2020-05-25,Gabon,0,0,1934,"rgb(201, 219, 116)"
9840,2020-05-26,Gabon,2,201,2135,"rgb(201, 219, 116)"
9841,2020-05-27,Gabon,0,103,2238,"rgb(201, 219, 116)"
9842,2020-05-28,Gabon,0,81,2319,"rgb(201, 219, 116)"
9843,2020-05-29,Gabon,0,112,2431,"rgb(201, 219, 116)"
9844,2020-05-30,Gabon,1,182,2613,"rgb(201, 219, 116)"
9845,2020-05-31,Gabon,2,42,2655,"rgb(201, 219, 116)"
9846,2020-06-01,Gabon,0,0,2655,"rgb(201, 219, 116)"
9847,2020-06-02,Gabon,0,0,2655,"rgb(201, 219, 116)"
9848,2020-06-03,Gabon,3,148,2803,"rgb(201, 219, 116)"
9849,2020-06-04,Gabon,0,99,2902,"rgb(201, 219, 116)"
9850,2020-06-05,Gabon,1,53,2955,"rgb(201, 219, 116)"
9851,2020-06-06,Gabon,0,146,3101,"rgb(201, 219, 116)"
9852,2020-06-07,Gabon,0,0,3101,"rgb(201, 219, 116)"
9853,2020-06-08,Gabon,0,0,3101,"rgb(201, 219, 116)"
9854,2020-06-09,Gabon,0,146,3247,"rgb(201, 219, 116)"
9855,2020-06-10,Gabon,0,47,3294,"rgb(201, 219, 116)"
9856,2020-06-11,Gabon,1,81,3375,"rgb(201, 219, 116)"
9857,2020-06-12,Gabon,1,88,3463,"rgb(201, 219, 116)"
9858,2020-06-13,Gabon,0,0,3463,"rgb(201, 219, 116)"
9859,2020-06-14,Gabon,0,0,3463,"rgb(201, 219, 116)"
9860,2020-06-15,Gabon,0,0,3463,"rgb(201, 219, 116)"
9861,2020-06-16,Gabon,4,570,4033,"rgb(201, 219, 116)"
9862,2020-06-17,Gabon,2,81,4114,"rgb(201, 219, 116)"
9863,2020-06-18,Gabon,1,115,4229,"rgb(201, 219, 116)"
9864,2020-06-19,Gabon,2,111,4340,"rgb(201, 219, 116)"
9865,2020-06-20,Gabon,2,88,4428,"rgb(201, 219, 116)"
9866,2020-06-21,Gabon,0,0,4428,"rgb(201, 219, 116)"
9867,2020-06-22,Gabon,0,0,4428,"rgb(201, 219, 116)"
9868,2020-06-23,Gabon,5,311,4739,"rgb(201, 219, 116)"
9869,2020-06-24,Gabon,0,134,4873,"rgb(201, 219, 116)"
9870,2020-06-25,Gabon,0,83,4956,"rgb(201, 219, 116)"
9871,2020-06-26,Gabon,1,131,5087,"rgb(201, 219, 116)"
9872,2020-06-27,Gabon,0,122,5209,"rgb(201, 219, 116)"
9873,2020-06-28,Gabon,0,0,5209,"rgb(201, 219, 116)"
9874,2020-06-29,Gabon,0,0,5209,"rgb(201, 219, 116)"
9875,2020-06-30,Gabon,2,185,5394,"rgb(201, 219, 116)"
9876,2020-07-01,Gabon,0,0,5394,"rgb(201, 219, 116)"
9877,2020-07-02,Gabon,0,119,5513,"rgb(201, 219, 116)"
9878,2020-07-03,Gabon,0,0,5513,"rgb(201, 219, 116)"
9879,2020-07-04,Gabon,2,107,5620,"rgb(201, 219, 116)"
9880,2020-07-05,Gabon,0,0,5620,"rgb(201, 219, 116)"
9881,2020-07-06,Gabon,0,0,5620,"rgb(201, 219, 116)"
9882,2020-07-07,Gabon,2,123,5743,"rgb(201, 219, 116)"
9883,2020-07-08,Gabon,0,0,5743,"rgb(201, 219, 116)"
9884,2020-07-09,Gabon,0,128,5871,"rgb(201, 219, 116)"
9885,2020-07-10,Gabon,0,0,5871,"rgb(201, 219, 116)"
9886,2020-07-11,Gabon,0,71,5942,"rgb(201, 219, 116)"
9887,2020-07-12,Gabon,0,0,5942,"rgb(201, 219, 116)"
9888,2020-07-13,Gabon,0,0,5942,"rgb(201, 219, 116)"
9889,2020-03-23,Grenada,0,1,1,"rgb(139, 224, 164)"
9890,2020-03-24,Grenada,0,0,1,"rgb(139, 224, 164)"
9891,2020-03-25,Grenada,0,0,1,"rgb(139, 224, 164)"
9892,2020-03-26,Grenada,0,0,1,"rgb(139, 224, 164)"
9893,2020-03-27,Grenada,0,6,7,"rgb(139, 224, 164)"
9894,2020-03-28,Grenada,0,0,7,"rgb(139, 224, 164)"
9895,2020-03-29,Grenada,0,2,9,"rgb(139, 224, 164)"
9896,2020-03-30,Grenada,0,0,9,"rgb(139, 224, 164)"
9897,2020-03-31,Grenada,0,0,9,"rgb(139, 224, 164)"
9898,2020-04-01,Grenada,0,0,9,"rgb(139, 224, 164)"
9899,2020-04-02,Grenada,0,1,10,"rgb(139, 224, 164)"
9900,2020-04-03,Grenada,0,0,10,"rgb(139, 224, 164)"
9901,2020-04-04,Grenada,0,2,12,"rgb(139, 224, 164)"
9902,2020-04-05,Grenada,0,0,12,"rgb(139, 224, 164)"
9903,2020-04-06,Grenada,0,0,12,"rgb(139, 224, 164)"
9904,2020-04-07,Grenada,0,0,12,"rgb(139, 224, 164)"
9905,2020-04-08,Grenada,0,0,12,"rgb(139, 224, 164)"
9906,2020-04-09,Grenada,0,0,12,"rgb(139, 224, 164)"
9907,2020-04-10,Grenada,0,0,12,"rgb(139, 224, 164)"
9908,2020-04-11,Grenada,0,2,14,"rgb(139, 224, 164)"
9909,2020-04-12,Grenada,0,0,14,"rgb(139, 224, 164)"
9910,2020-04-13,Grenada,0,0,14,"rgb(139, 224, 164)"
9911,2020-04-14,Grenada,0,0,14,"rgb(139, 224, 164)"
9912,2020-04-15,Grenada,0,0,14,"rgb(139, 224, 164)"
9913,2020-04-16,Grenada,0,0,14,"rgb(139, 224, 164)"
9914,2020-04-17,Grenada,0,0,14,"rgb(139, 224, 164)"
9915,2020-04-18,Grenada,0,0,14,"rgb(139, 224, 164)"
9916,2020-04-19,Grenada,0,0,14,"rgb(139, 224, 164)"
9917,2020-04-20,Grenada,0,0,14,"rgb(139, 224, 164)"
9918,2020-04-21,Grenada,0,0,14,"rgb(139, 224, 164)"
9919,2020-04-22,Grenada,0,0,14,"rgb(139, 224, 164)"
9920,2020-04-23,Grenada,0,1,15,"rgb(139, 224, 164)"
9921,2020-04-24,Grenada,0,0,15,"rgb(139, 224, 164)"
9922,2020-04-25,Grenada,0,0,15,"rgb(139, 224, 164)"
9923,2020-04-26,Grenada,0,3,18,"rgb(139, 224, 164)"
9924,2020-04-27,Grenada,0,0,18,"rgb(139, 224, 164)"
9925,2020-04-28,Grenada,0,0,18,"rgb(139, 224, 164)"
9926,2020-04-29,Grenada,0,0,18,"rgb(139, 224, 164)"
9927,2020-04-30,Grenada,0,2,20,"rgb(139, 224, 164)"
9928,2020-05-01,Grenada,0,0,20,"rgb(139, 224, 164)"
9929,2020-05-02,Grenada,0,0,20,"rgb(139, 224, 164)"
9930,2020-05-03,Grenada,0,1,21,"rgb(139, 224, 164)"
9931,2020-05-04,Grenada,0,0,21,"rgb(139, 224, 164)"
9932,2020-05-05,Grenada,0,0,21,"rgb(139, 224, 164)"
9933,2020-05-06,Grenada,0,0,21,"rgb(139, 224, 164)"
9934,2020-05-07,Grenada,0,0,21,"rgb(139, 224, 164)"
9935,2020-05-08,Grenada,0,0,21,"rgb(139, 224, 164)"
9936,2020-05-09,Grenada,0,0,21,"rgb(139, 224, 164)"
9937,2020-05-10,Grenada,0,0,21,"rgb(139, 224, 164)"
9938,2020-05-11,Grenada,0,0,21,"rgb(139, 224, 164)"
9939,2020-05-12,Grenada,0,0,21,"rgb(139, 224, 164)"
9940,2020-05-13,Grenada,0,0,21,"rgb(139, 224, 164)"
9941,2020-05-14,Grenada,0,0,21,"rgb(139, 224, 164)"
9942,2020-05-15,Grenada,0,0,21,"rgb(139, 224, 164)"
9943,2020-05-16,Grenada,0,1,22,"rgb(139, 224, 164)"
9944,2020-05-17,Grenada,0,0,22,"rgb(139, 224, 164)"
9945,2020-05-18,Grenada,0,0,22,"rgb(139, 224, 164)"
9946,2020-05-19,Grenada,0,0,22,"rgb(139, 224, 164)"
9947,2020-05-20,Grenada,0,0,22,"rgb(139, 224, 164)"
9948,2020-05-21,Grenada,0,0,22,"rgb(139, 224, 164)"
9949,2020-05-22,Grenada,0,0,22,"rgb(139, 224, 164)"
9950,2020-05-23,Grenada,0,0,22,"rgb(139, 224, 164)"
9951,2020-05-24,Grenada,0,0,22,"rgb(139, 224, 164)"
9952,2020-05-25,Grenada,0,0,22,"rgb(139, 224, 164)"
9953,2020-05-26,Grenada,0,1,23,"rgb(139, 224, 164)"
9954,2020-05-27,Grenada,0,0,23,"rgb(139, 224, 164)"
9955,2020-05-28,Grenada,0,0,23,"rgb(139, 224, 164)"
9956,2020-05-29,Grenada,0,0,23,"rgb(139, 224, 164)"
9957,2020-05-30,Grenada,0,0,23,"rgb(139, 224, 164)"
9958,2020-05-31,Grenada,0,0,23,"rgb(139, 224, 164)"
9959,2020-06-01,Grenada,0,0,23,"rgb(139, 224, 164)"
9960,2020-06-02,Grenada,0,0,23,"rgb(139, 224, 164)"
9961,2020-06-03,Grenada,0,0,23,"rgb(139, 224, 164)"
9962,2020-06-04,Grenada,0,0,23,"rgb(139, 224, 164)"
9963,2020-06-05,Grenada,0,0,23,"rgb(139, 224, 164)"
9964,2020-06-06,Grenada,0,0,23,"rgb(139, 224, 164)"
9965,2020-06-07,Grenada,0,0,23,"rgb(139, 224, 164)"
9966,2020-06-08,Grenada,0,0,23,"rgb(139, 224, 164)"
9967,2020-06-09,Grenada,0,0,23,"rgb(139, 224, 164)"
9968,2020-06-10,Grenada,0,0,23,"rgb(139, 224, 164)"
9969,2020-06-11,Grenada,0,0,23,"rgb(139, 224, 164)"
9970,2020-06-12,Grenada,0,0,23,"rgb(139, 224, 164)"
9971,2020-06-13,Grenada,0,0,23,"rgb(139, 224, 164)"
9972,2020-06-14,Grenada,0,0,23,"rgb(139, 224, 164)"
9973,2020-06-15,Grenada,0,0,23,"rgb(139, 224, 164)"
9974,2020-06-16,Grenada,0,0,23,"rgb(139, 224, 164)"
9975,2020-06-17,Grenada,0,0,23,"rgb(139, 224, 164)"
9976,2020-06-18,Grenada,0,0,23,"rgb(139, 224, 164)"
9977,2020-06-19,Grenada,0,0,23,"rgb(139, 224, 164)"
9978,2020-06-20,Grenada,0,0,23,"rgb(139, 224, 164)"
9979,2020-06-21,Grenada,0,0,23,"rgb(139, 224, 164)"
9980,2020-06-22,Grenada,0,0,23,"rgb(139, 224, 164)"
9981,2020-06-23,Grenada,0,0,23,"rgb(139, 224, 164)"
9982,2020-06-24,Grenada,0,0,23,"rgb(139, 224, 164)"
9983,2020-06-25,Grenada,0,0,23,"rgb(139, 224, 164)"
9984,2020-06-26,Grenada,0,0,23,"rgb(139, 224, 164)"
9985,2020-06-27,Grenada,0,0,23,"rgb(139, 224, 164)"
9986,2020-06-28,Grenada,0,0,23,"rgb(139, 224, 164)"
9987,2020-06-29,Grenada,0,0,23,"rgb(139, 224, 164)"
9988,2020-06-30,Grenada,0,0,23,"rgb(139, 224, 164)"
9989,2020-07-01,Grenada,0,0,23,"rgb(139, 224, 164)"
9990,2020-07-02,Grenada,0,0,23,"rgb(139, 224, 164)"
9991,2020-07-03,Grenada,0,0,23,"rgb(139, 224, 164)"
9992,2020-07-04,Grenada,0,0,23,"rgb(139, 224, 164)"
9993,2020-07-05,Grenada,0,0,23,"rgb(139, 224, 164)"
9994,2020-07-06,Grenada,0,0,23,"rgb(139, 224, 164)"
9995,2020-07-07,Grenada,0,0,23,"rgb(139, 224, 164)"
9996,2020-07-08,Grenada,0,0,23,"rgb(139, 224, 164)"
9997,2020-07-09,Grenada,0,0,23,"rgb(139, 224, 164)"
9998,2020-07-10,Grenada,0,0,23,"rgb(139, 224, 164)"
9999,2020-07-11,Grenada,0,0,23,"rgb(139, 224, 164)"
10000,2020-07-12,Grenada,0,0,23,"rgb(139, 224, 164)"
10001,2020-07-13,Grenada,0,0,23,"rgb(139, 224, 164)"
10002,2019-12-31,Georgia,0,0,0,"rgb(180, 151, 231)"
10003,2020-01-01,Georgia,0,0,0,"rgb(180, 151, 231)"
10004,2020-01-02,Georgia,0,0,0,"rgb(180, 151, 231)"
10005,2020-01-03,Georgia,0,0,0,"rgb(180, 151, 231)"
10006,2020-01-04,Georgia,0,0,0,"rgb(180, 151, 231)"
10007,2020-01-05,Georgia,0,0,0,"rgb(180, 151, 231)"
10008,2020-01-06,Georgia,0,0,0,"rgb(180, 151, 231)"
10009,2020-01-07,Georgia,0,0,0,"rgb(180, 151, 231)"
10010,2020-01-08,Georgia,0,0,0,"rgb(180, 151, 231)"
10011,2020-01-09,Georgia,0,0,0,"rgb(180, 151, 231)"
10012,2020-01-10,Georgia,0,0,0,"rgb(180, 151, 231)"
10013,2020-01-11,Georgia,0,0,0,"rgb(180, 151, 231)"
10014,2020-01-12,Georgia,0,0,0,"rgb(180, 151, 231)"
10015,2020-01-13,Georgia,0,0,0,"rgb(180, 151, 231)"
10016,2020-01-14,Georgia,0,0,0,"rgb(180, 151, 231)"
10017,2020-01-15,Georgia,0,0,0,"rgb(180, 151, 231)"
10018,2020-01-16,Georgia,0,0,0,"rgb(180, 151, 231)"
10019,2020-01-17,Georgia,0,0,0,"rgb(180, 151, 231)"
10020,2020-01-18,Georgia,0,0,0,"rgb(180, 151, 231)"
10021,2020-01-19,Georgia,0,0,0,"rgb(180, 151, 231)"
10022,2020-01-20,Georgia,0,0,0,"rgb(180, 151, 231)"
10023,2020-01-21,Georgia,0,0,0,"rgb(180, 151, 231)"
10024,2020-01-22,Georgia,0,0,0,"rgb(180, 151, 231)"
10025,2020-01-23,Georgia,0,0,0,"rgb(180, 151, 231)"
10026,2020-01-24,Georgia,0,0,0,"rgb(180, 151, 231)"
10027,2020-01-25,Georgia,0,0,0,"rgb(180, 151, 231)"
10028,2020-01-26,Georgia,0,0,0,"rgb(180, 151, 231)"
10029,2020-01-27,Georgia,0,0,0,"rgb(180, 151, 231)"
10030,2020-01-28,Georgia,0,0,0,"rgb(180, 151, 231)"
10031,2020-01-29,Georgia,0,0,0,"rgb(180, 151, 231)"
10032,2020-01-30,Georgia,0,0,0,"rgb(180, 151, 231)"
10033,2020-01-31,Georgia,0,0,0,"rgb(180, 151, 231)"
10034,2020-02-01,Georgia,0,0,0,"rgb(180, 151, 231)"
10035,2020-02-02,Georgia,0,0,0,"rgb(180, 151, 231)"
10036,2020-02-03,Georgia,0,0,0,"rgb(180, 151, 231)"
10037,2020-02-04,Georgia,0,0,0,"rgb(180, 151, 231)"
10038,2020-02-05,Georgia,0,0,0,"rgb(180, 151, 231)"
10039,2020-02-06,Georgia,0,0,0,"rgb(180, 151, 231)"
10040,2020-02-07,Georgia,0,0,0,"rgb(180, 151, 231)"
10041,2020-02-08,Georgia,0,0,0,"rgb(180, 151, 231)"
10042,2020-02-09,Georgia,0,0,0,"rgb(180, 151, 231)"
10043,2020-02-10,Georgia,0,0,0,"rgb(180, 151, 231)"
10044,2020-02-11,Georgia,0,0,0,"rgb(180, 151, 231)"
10045,2020-02-12,Georgia,0,0,0,"rgb(180, 151, 231)"
10046,2020-02-13,Georgia,0,0,0,"rgb(180, 151, 231)"
10047,2020-02-14,Georgia,0,0,0,"rgb(180, 151, 231)"
10048,2020-02-15,Georgia,0,0,0,"rgb(180, 151, 231)"
10049,2020-02-16,Georgia,0,0,0,"rgb(180, 151, 231)"
10050,2020-02-17,Georgia,0,0,0,"rgb(180, 151, 231)"
10051,2020-02-18,Georgia,0,0,0,"rgb(180, 151, 231)"
10052,2020-02-19,Georgia,0,0,0,"rgb(180, 151, 231)"
10053,2020-02-20,Georgia,0,0,0,"rgb(180, 151, 231)"
10054,2020-02-21,Georgia,0,0,0,"rgb(180, 151, 231)"
10055,2020-02-22,Georgia,0,0,0,"rgb(180, 151, 231)"
10056,2020-02-23,Georgia,0,0,0,"rgb(180, 151, 231)"
10057,2020-02-24,Georgia,0,0,0,"rgb(180, 151, 231)"
10058,2020-02-25,Georgia,0,0,0,"rgb(180, 151, 231)"
10059,2020-02-26,Georgia,0,0,0,"rgb(180, 151, 231)"
10060,2020-02-27,Georgia,0,1,1,"rgb(180, 151, 231)"
10061,2020-02-28,Georgia,0,0,1,"rgb(180, 151, 231)"
10062,2020-02-29,Georgia,0,1,2,"rgb(180, 151, 231)"
10063,2020-03-01,Georgia,0,1,3,"rgb(180, 151, 231)"
10064,2020-03-02,Georgia,0,0,3,"rgb(180, 151, 231)"
10065,2020-03-05,Georgia,0,0,3,"rgb(180, 151, 231)"
10066,2020-03-06,Georgia,0,6,9,"rgb(180, 151, 231)"
10067,2020-03-08,Georgia,0,3,12,"rgb(180, 151, 231)"
10068,2020-03-09,Georgia,0,1,13,"rgb(180, 151, 231)"
10069,2020-03-10,Georgia,0,2,15,"rgb(180, 151, 231)"
10070,2020-03-11,Georgia,0,8,23,"rgb(180, 151, 231)"
10071,2020-03-12,Georgia,0,1,24,"rgb(180, 151, 231)"
10072,2020-03-13,Georgia,0,1,25,"rgb(180, 151, 231)"
10073,2020-03-14,Georgia,0,5,30,"rgb(180, 151, 231)"
10074,2020-03-15,Georgia,0,0,30,"rgb(180, 151, 231)"
10075,2020-03-16,Georgia,0,0,30,"rgb(180, 151, 231)"
10076,2020-03-17,Georgia,0,3,33,"rgb(180, 151, 231)"
10077,2020-03-18,Georgia,0,1,34,"rgb(180, 151, 231)"
10078,2020-03-19,Georgia,0,0,34,"rgb(180, 151, 231)"
10079,2020-03-20,Georgia,0,6,40,"rgb(180, 151, 231)"
10080,2020-03-21,Georgia,0,3,43,"rgb(180, 151, 231)"
10081,2020-03-22,Georgia,0,6,49,"rgb(180, 151, 231)"
10082,2020-03-23,Georgia,0,5,54,"rgb(180, 151, 231)"
10083,2020-03-24,Georgia,0,7,61,"rgb(180, 151, 231)"
10084,2020-03-25,Georgia,0,9,70,"rgb(180, 151, 231)"
10085,2020-03-26,Georgia,0,3,73,"rgb(180, 151, 231)"
10086,2020-03-27,Georgia,0,6,79,"rgb(180, 151, 231)"
10087,2020-03-28,Georgia,0,2,81,"rgb(180, 151, 231)"
10088,2020-03-29,Georgia,0,4,85,"rgb(180, 151, 231)"
10089,2020-03-30,Georgia,0,5,90,"rgb(180, 151, 231)"
10090,2020-03-31,Georgia,0,8,98,"rgb(180, 151, 231)"
10091,2020-04-01,Georgia,0,12,110,"rgb(180, 151, 231)"
10092,2020-04-02,Georgia,0,5,115,"rgb(180, 151, 231)"
10093,2020-04-03,Georgia,0,6,121,"rgb(180, 151, 231)"
10094,2020-04-04,Georgia,0,27,148,"rgb(180, 151, 231)"
10095,2020-04-05,Georgia,0,9,157,"rgb(180, 151, 231)"
10096,2020-04-06,Georgia,2,17,174,"rgb(180, 151, 231)"
10097,2020-04-07,Georgia,0,14,188,"rgb(180, 151, 231)"
10098,2020-04-08,Georgia,1,8,196,"rgb(180, 151, 231)"
10099,2020-04-09,Georgia,0,15,211,"rgb(180, 151, 231)"
10100,2020-04-10,Georgia,0,7,218,"rgb(180, 151, 231)"
10101,2020-04-11,Georgia,0,16,234,"rgb(180, 151, 231)"
10102,2020-04-12,Georgia,0,8,242,"rgb(180, 151, 231)"
10103,2020-04-13,Georgia,0,15,257,"rgb(180, 151, 231)"
10104,2020-04-14,Georgia,0,15,272,"rgb(180, 151, 231)"
10105,2020-04-15,Georgia,0,28,300,"rgb(180, 151, 231)"
10106,2020-04-16,Georgia,0,6,306,"rgb(180, 151, 231)"
10107,2020-04-17,Georgia,0,42,348,"rgb(180, 151, 231)"
10108,2020-04-18,Georgia,0,22,370,"rgb(180, 151, 231)"
10109,2020-04-19,Georgia,1,18,388,"rgb(180, 151, 231)"
10110,2020-04-20,Georgia,0,6,394,"rgb(180, 151, 231)"
10111,2020-04-21,Georgia,0,8,402,"rgb(180, 151, 231)"
10112,2020-04-22,Georgia,0,6,408,"rgb(180, 151, 231)"
10113,2020-04-23,Georgia,1,8,416,"rgb(180, 151, 231)"
10114,2020-04-24,Georgia,0,9,425,"rgb(180, 151, 231)"
10115,2020-04-25,Georgia,0,19,444,"rgb(180, 151, 231)"
10116,2020-04-26,Georgia,0,12,456,"rgb(180, 151, 231)"
10117,2020-04-27,Georgia,1,30,486,"rgb(180, 151, 231)"
10118,2020-04-28,Georgia,0,11,497,"rgb(180, 151, 231)"
10119,2020-04-29,Georgia,0,14,511,"rgb(180, 151, 231)"
10120,2020-04-30,Georgia,0,6,517,"rgb(180, 151, 231)"
10121,2020-05-01,Georgia,0,22,539,"rgb(180, 151, 231)"
10122,2020-05-02,Georgia,2,43,582,"rgb(180, 151, 231)"
10123,2020-05-03,Georgia,0,0,582,"rgb(180, 151, 231)"
10124,2020-05-04,Georgia,1,7,589,"rgb(180, 151, 231)"
10125,2020-05-05,Georgia,0,4,593,"rgb(180, 151, 231)"
10126,2020-05-06,Georgia,0,11,604,"rgb(180, 151, 231)"
10127,2020-05-07,Georgia,0,6,610,"rgb(180, 151, 231)"
10128,2020-05-08,Georgia,0,5,615,"rgb(180, 151, 231)"
10129,2020-05-09,Georgia,1,8,623,"rgb(180, 151, 231)"
10130,2020-05-10,Georgia,0,3,626,"rgb(180, 151, 231)"
10131,2020-05-11,Georgia,0,9,635,"rgb(180, 151, 231)"
10132,2020-05-12,Georgia,1,3,638,"rgb(180, 151, 231)"
10133,2020-05-13,Georgia,0,4,642,"rgb(180, 151, 231)"
10134,2020-05-14,Georgia,0,5,647,"rgb(180, 151, 231)"
10135,2020-05-15,Georgia,1,20,667,"rgb(180, 151, 231)"
10136,2020-05-16,Georgia,0,4,671,"rgb(180, 151, 231)"
10137,2020-05-17,Georgia,0,24,695,"rgb(180, 151, 231)"
10138,2020-05-18,Georgia,0,6,701,"rgb(180, 151, 231)"
10139,2020-05-19,Georgia,0,1,702,"rgb(180, 151, 231)"
10140,2020-05-20,Georgia,0,5,707,"rgb(180, 151, 231)"
10141,2020-05-21,Georgia,0,6,713,"rgb(180, 151, 231)"
10142,2020-05-22,Georgia,0,8,721,"rgb(180, 151, 231)"
10143,2020-05-23,Georgia,0,2,723,"rgb(180, 151, 231)"
10144,2020-05-24,Georgia,0,5,728,"rgb(180, 151, 231)"
10145,2020-05-25,Georgia,0,2,730,"rgb(180, 151, 231)"
10146,2020-05-26,Georgia,0,1,731,"rgb(180, 151, 231)"
10147,2020-05-27,Georgia,0,1,732,"rgb(180, 151, 231)"
10148,2020-05-28,Georgia,0,3,735,"rgb(180, 151, 231)"
10149,2020-05-29,Georgia,0,3,738,"rgb(180, 151, 231)"
10150,2020-05-30,Georgia,0,8,746,"rgb(180, 151, 231)"
10151,2020-05-31,Georgia,0,11,757,"rgb(180, 151, 231)"
10152,2020-06-01,Georgia,0,26,783,"rgb(180, 151, 231)"
10153,2020-06-02,Georgia,0,13,796,"rgb(180, 151, 231)"
10154,2020-06-03,Georgia,1,4,800,"rgb(180, 151, 231)"
10155,2020-06-04,Georgia,0,0,800,"rgb(180, 151, 231)"
10156,2020-06-05,Georgia,0,1,801,"rgb(180, 151, 231)"
10157,2020-06-06,Georgia,0,4,805,"rgb(180, 151, 231)"
10158,2020-06-07,Georgia,0,3,808,"rgb(180, 151, 231)"
10159,2020-06-08,Georgia,0,0,808,"rgb(180, 151, 231)"
10160,2020-06-09,Georgia,0,4,812,"rgb(180, 151, 231)"
10161,2020-06-10,Georgia,0,6,818,"rgb(180, 151, 231)"
10162,2020-06-11,Georgia,0,9,827,"rgb(180, 151, 231)"
10163,2020-06-12,Georgia,0,4,831,"rgb(180, 151, 231)"
10164,2020-06-13,Georgia,0,12,843,"rgb(180, 151, 231)"
10165,2020-06-14,Georgia,1,8,851,"rgb(180, 151, 231)"
10166,2020-06-15,Georgia,0,28,879,"rgb(180, 151, 231)"
10167,2020-06-16,Georgia,0,0,879,"rgb(180, 151, 231)"
10168,2020-06-17,Georgia,0,9,888,"rgb(180, 151, 231)"
10169,2020-06-18,Georgia,0,5,893,"rgb(180, 151, 231)"
10170,2020-06-19,Georgia,0,2,895,"rgb(180, 151, 231)"
10171,2020-06-20,Georgia,0,1,896,"rgb(180, 151, 231)"
10172,2020-06-21,Georgia,0,2,898,"rgb(180, 151, 231)"
10173,2020-06-22,Georgia,0,10,908,"rgb(180, 151, 231)"
10174,2020-06-23,Georgia,0,3,911,"rgb(180, 151, 231)"
10175,2020-06-24,Georgia,0,3,914,"rgb(180, 151, 231)"
10176,2020-06-25,Georgia,0,3,917,"rgb(180, 151, 231)"
10177,2020-06-26,Georgia,0,2,919,"rgb(180, 151, 231)"
10178,2020-06-27,Georgia,0,2,921,"rgb(180, 151, 231)"
10179,2020-06-28,Georgia,1,3,924,"rgb(180, 151, 231)"
10180,2020-06-29,Georgia,0,2,926,"rgb(180, 151, 231)"
10181,2020-06-30,Georgia,0,2,928,"rgb(180, 151, 231)"
10182,2020-07-01,Georgia,0,0,928,"rgb(180, 151, 231)"
10183,2020-07-02,Georgia,0,3,931,"rgb(180, 151, 231)"
10184,2020-07-03,Georgia,0,8,939,"rgb(180, 151, 231)"
10185,2020-07-04,Georgia,0,7,946,"rgb(180, 151, 231)"
10186,2020-07-05,Georgia,0,2,948,"rgb(180, 151, 231)"
10187,2020-07-06,Georgia,0,5,953,"rgb(180, 151, 231)"
10188,2020-07-07,Georgia,0,5,958,"rgb(180, 151, 231)"
10189,2020-07-08,Georgia,0,5,963,"rgb(180, 151, 231)"
10190,2020-07-09,Georgia,0,5,968,"rgb(180, 151, 231)"
10191,2020-07-10,Georgia,0,5,973,"rgb(180, 151, 231)"
10192,2020-07-11,Georgia,0,8,981,"rgb(180, 151, 231)"
10193,2020-07-12,Georgia,0,5,986,"rgb(180, 151, 231)"
10194,2020-07-13,Georgia,0,9,995,"rgb(180, 151, 231)"
10195,2020-03-20,Guernsey,0,1,1,"rgb(179, 179, 179)"
10196,2020-03-21,Guernsey,0,0,1,"rgb(179, 179, 179)"
10197,2020-03-22,Guernsey,0,0,1,"rgb(179, 179, 179)"
10198,2020-03-23,Guernsey,0,16,17,"rgb(179, 179, 179)"
10199,2020-03-24,Guernsey,0,3,20,"rgb(179, 179, 179)"
10200,2020-03-25,Guernsey,0,3,23,"rgb(179, 179, 179)"
10201,2020-03-26,Guernsey,0,7,30,"rgb(179, 179, 179)"
10202,2020-03-27,Guernsey,0,4,34,"rgb(179, 179, 179)"
10203,2020-03-28,Guernsey,0,2,36,"rgb(179, 179, 179)"
10204,2020-03-29,Guernsey,0,3,39,"rgb(179, 179, 179)"
10205,2020-03-30,Guernsey,0,6,45,"rgb(179, 179, 179)"
10206,2020-03-31,Guernsey,0,0,45,"rgb(179, 179, 179)"
10207,2020-04-01,Guernsey,0,15,60,"rgb(179, 179, 179)"
10208,2020-04-02,Guernsey,0,18,78,"rgb(179, 179, 179)"
10209,2020-04-03,Guernsey,0,13,91,"rgb(179, 179, 179)"
10210,2020-04-04,Guernsey,2,23,114,"rgb(179, 179, 179)"
10211,2020-04-05,Guernsey,0,22,136,"rgb(179, 179, 179)"
10212,2020-04-06,Guernsey,1,18,154,"rgb(179, 179, 179)"
10213,2020-04-07,Guernsey,1,11,165,"rgb(179, 179, 179)"
10214,2020-04-08,Guernsey,0,1,166,"rgb(179, 179, 179)"
10215,2020-04-09,Guernsey,1,15,181,"rgb(179, 179, 179)"
10216,2020-04-10,Guernsey,0,10,191,"rgb(179, 179, 179)"
10217,2020-04-11,Guernsey,1,9,200,"rgb(179, 179, 179)"
10218,2020-04-12,Guernsey,0,9,209,"rgb(179, 179, 179)"
10219,2020-04-13,Guernsey,0,9,218,"rgb(179, 179, 179)"
10220,2020-04-14,Guernsey,0,1,219,"rgb(179, 179, 179)"
10221,2020-04-15,Guernsey,1,4,223,"rgb(179, 179, 179)"
10222,2020-04-16,Guernsey,0,0,223,"rgb(179, 179, 179)"
10223,2020-04-17,Guernsey,2,11,234,"rgb(179, 179, 179)"
10224,2020-04-18,Guernsey,0,0,234,"rgb(179, 179, 179)"
10225,2020-04-19,Guernsey,0,5,239,"rgb(179, 179, 179)"
10226,2020-04-20,Guernsey,0,0,239,"rgb(179, 179, 179)"
10227,2020-04-21,Guernsey,1,0,239,"rgb(179, 179, 179)"
10228,2020-04-22,Guernsey,0,0,239,"rgb(179, 179, 179)"
10229,2020-04-23,Guernsey,0,4,243,"rgb(179, 179, 179)"
10230,2020-04-24,Guernsey,0,2,245,"rgb(179, 179, 179)"
10231,2020-04-25,Guernsey,1,0,245,"rgb(179, 179, 179)"
10232,2020-04-26,Guernsey,1,0,245,"rgb(179, 179, 179)"
10233,2020-04-27,Guernsey,1,2,247,"rgb(179, 179, 179)"
10234,2020-04-28,Guernsey,0,0,247,"rgb(179, 179, 179)"
10235,2020-04-29,Guernsey,0,0,247,"rgb(179, 179, 179)"
10236,2020-04-30,Guernsey,0,4,251,"rgb(179, 179, 179)"
10237,2020-05-01,Guernsey,0,0,251,"rgb(179, 179, 179)"
10238,2020-05-02,Guernsey,0,1,252,"rgb(179, 179, 179)"
10239,2020-05-03,Guernsey,0,0,252,"rgb(179, 179, 179)"
10240,2020-05-04,Guernsey,0,0,252,"rgb(179, 179, 179)"
10241,2020-05-05,Guernsey,0,0,252,"rgb(179, 179, 179)"
10242,2020-05-06,Guernsey,0,0,252,"rgb(179, 179, 179)"
10243,2020-05-07,Guernsey,0,0,252,"rgb(179, 179, 179)"
10244,2020-05-08,Guernsey,0,0,252,"rgb(179, 179, 179)"
10245,2020-05-09,Guernsey,0,0,252,"rgb(179, 179, 179)"
10246,2020-05-10,Guernsey,0,0,252,"rgb(179, 179, 179)"
10247,2020-05-11,Guernsey,0,0,252,"rgb(179, 179, 179)"
10248,2020-05-12,Guernsey,0,0,252,"rgb(179, 179, 179)"
10249,2020-05-13,Guernsey,0,0,252,"rgb(179, 179, 179)"
10250,2020-05-14,Guernsey,0,0,252,"rgb(179, 179, 179)"
10251,2020-05-15,Guernsey,0,0,252,"rgb(179, 179, 179)"
10252,2020-05-16,Guernsey,0,0,252,"rgb(179, 179, 179)"
10253,2020-05-17,Guernsey,0,0,252,"rgb(179, 179, 179)"
10254,2020-05-18,Guernsey,0,0,252,"rgb(179, 179, 179)"
10255,2020-05-19,Guernsey,0,0,252,"rgb(179, 179, 179)"
10256,2020-05-20,Guernsey,0,0,252,"rgb(179, 179, 179)"
10257,2020-05-21,Guernsey,0,0,252,"rgb(179, 179, 179)"
10258,2020-05-22,Guernsey,0,0,252,"rgb(179, 179, 179)"
10259,2020-05-23,Guernsey,0,0,252,"rgb(179, 179, 179)"
10260,2020-05-24,Guernsey,0,0,252,"rgb(179, 179, 179)"
10261,2020-05-25,Guernsey,0,0,252,"rgb(179, 179, 179)"
10262,2020-05-26,Guernsey,0,0,252,"rgb(179, 179, 179)"
10263,2020-05-27,Guernsey,0,0,252,"rgb(179, 179, 179)"
10264,2020-05-28,Guernsey,0,0,252,"rgb(179, 179, 179)"
10265,2020-05-29,Guernsey,0,0,252,"rgb(179, 179, 179)"
10266,2020-05-30,Guernsey,0,0,252,"rgb(179, 179, 179)"
10267,2020-05-31,Guernsey,0,0,252,"rgb(179, 179, 179)"
10268,2020-06-01,Guernsey,0,0,252,"rgb(179, 179, 179)"
10269,2020-06-02,Guernsey,0,0,252,"rgb(179, 179, 179)"
10270,2020-06-03,Guernsey,0,0,252,"rgb(179, 179, 179)"
10271,2020-06-04,Guernsey,0,0,252,"rgb(179, 179, 179)"
10272,2020-06-05,Guernsey,0,0,252,"rgb(179, 179, 179)"
10273,2020-06-06,Guernsey,0,0,252,"rgb(179, 179, 179)"
10274,2020-06-07,Guernsey,0,0,252,"rgb(179, 179, 179)"
10275,2020-06-08,Guernsey,0,0,252,"rgb(179, 179, 179)"
10276,2020-06-09,Guernsey,0,0,252,"rgb(179, 179, 179)"
10277,2020-06-10,Guernsey,0,0,252,"rgb(179, 179, 179)"
10278,2020-06-11,Guernsey,0,0,252,"rgb(179, 179, 179)"
10279,2020-06-12,Guernsey,0,0,252,"rgb(179, 179, 179)"
10280,2020-06-13,Guernsey,0,0,252,"rgb(179, 179, 179)"
10281,2020-06-14,Guernsey,0,0,252,"rgb(179, 179, 179)"
10282,2020-06-15,Guernsey,0,0,252,"rgb(179, 179, 179)"
10283,2020-06-16,Guernsey,0,0,252,"rgb(179, 179, 179)"
10284,2020-06-17,Guernsey,0,0,252,"rgb(179, 179, 179)"
10285,2020-06-18,Guernsey,0,0,252,"rgb(179, 179, 179)"
10286,2020-06-19,Guernsey,0,0,252,"rgb(179, 179, 179)"
10287,2020-06-20,Guernsey,0,0,252,"rgb(179, 179, 179)"
10288,2020-06-21,Guernsey,0,0,252,"rgb(179, 179, 179)"
10289,2020-06-22,Guernsey,0,0,252,"rgb(179, 179, 179)"
10290,2020-06-23,Guernsey,0,0,252,"rgb(179, 179, 179)"
10291,2020-06-24,Guernsey,0,0,252,"rgb(179, 179, 179)"
10292,2020-06-25,Guernsey,0,0,252,"rgb(179, 179, 179)"
10293,2020-06-26,Guernsey,0,0,252,"rgb(179, 179, 179)"
10294,2020-06-27,Guernsey,0,0,252,"rgb(179, 179, 179)"
10295,2020-06-28,Guernsey,0,0,252,"rgb(179, 179, 179)"
10296,2020-06-29,Guernsey,0,0,252,"rgb(179, 179, 179)"
10297,2020-06-30,Guernsey,0,0,252,"rgb(179, 179, 179)"
10298,2020-07-01,Guernsey,0,0,252,"rgb(179, 179, 179)"
10299,2020-07-02,Guernsey,0,0,252,"rgb(179, 179, 179)"
10300,2020-07-03,Guernsey,0,0,252,"rgb(179, 179, 179)"
10301,2020-07-04,Guernsey,0,0,252,"rgb(179, 179, 179)"
10302,2020-07-05,Guernsey,0,0,252,"rgb(179, 179, 179)"
10303,2020-07-06,Guernsey,0,0,252,"rgb(179, 179, 179)"
10304,2020-07-07,Guernsey,0,0,252,"rgb(179, 179, 179)"
10305,2020-07-08,Guernsey,0,0,252,"rgb(179, 179, 179)"
10306,2020-07-09,Guernsey,0,0,252,"rgb(179, 179, 179)"
10307,2020-07-10,Guernsey,0,0,252,"rgb(179, 179, 179)"
10308,2020-07-11,Guernsey,0,0,252,"rgb(179, 179, 179)"
10309,2020-07-12,Guernsey,0,0,252,"rgb(179, 179, 179)"
10310,2020-07-13,Guernsey,0,0,252,"rgb(179, 179, 179)"
10311,2020-03-13,Ghana,0,2,2,"rgb(229, 134, 6)"
10312,2020-03-15,Ghana,0,0,2,"rgb(229, 134, 6)"
10313,2020-03-16,Ghana,0,0,2,"rgb(229, 134, 6)"
10314,2020-03-17,Ghana,0,4,6,"rgb(229, 134, 6)"
10315,2020-03-18,Ghana,0,0,6,"rgb(229, 134, 6)"
10316,2020-03-19,Ghana,0,1,7,"rgb(229, 134, 6)"
10317,2020-03-20,Ghana,0,4,11,"rgb(229, 134, 6)"
10318,2020-03-21,Ghana,0,5,16,"rgb(229, 134, 6)"
10319,2020-03-22,Ghana,1,5,21,"rgb(229, 134, 6)"
10320,2020-03-23,Ghana,0,3,24,"rgb(229, 134, 6)"
10321,2020-03-24,Ghana,1,3,27,"rgb(229, 134, 6)"
10322,2020-03-25,Ghana,0,26,53,"rgb(229, 134, 6)"
10323,2020-03-26,Ghana,1,15,68,"rgb(229, 134, 6)"
10324,2020-03-27,Ghana,0,64,132,"rgb(229, 134, 6)"
10325,2020-03-28,Ghana,0,5,137,"rgb(229, 134, 6)"
10326,2020-03-29,Ghana,2,4,141,"rgb(229, 134, 6)"
10327,2020-03-30,Ghana,0,11,152,"rgb(229, 134, 6)"
10328,2020-03-31,Ghana,0,0,152,"rgb(229, 134, 6)"
10329,2020-04-01,Ghana,0,0,152,"rgb(229, 134, 6)"
10330,2020-04-02,Ghana,0,43,195,"rgb(229, 134, 6)"
10331,2020-04-03,Ghana,0,9,204,"rgb(229, 134, 6)"
10332,2020-04-04,Ghana,0,1,205,"rgb(229, 134, 6)"
10333,2020-04-05,Ghana,0,9,214,"rgb(229, 134, 6)"
10334,2020-04-06,Ghana,0,0,214,"rgb(229, 134, 6)"
10335,2020-04-07,Ghana,0,73,287,"rgb(229, 134, 6)"
10336,2020-04-08,Ghana,0,0,287,"rgb(229, 134, 6)"
10337,2020-04-09,Ghana,1,26,313,"rgb(229, 134, 6)"
10338,2020-04-10,Ghana,0,65,378,"rgb(229, 134, 6)"
10339,2020-04-11,Ghana,0,0,378,"rgb(229, 134, 6)"
10340,2020-04-12,Ghana,2,30,408,"rgb(229, 134, 6)"
10341,2020-04-13,Ghana,0,158,566,"rgb(229, 134, 6)"
10342,2020-04-14,Ghana,0,0,566,"rgb(229, 134, 6)"
10343,2020-04-15,Ghana,0,70,636,"rgb(229, 134, 6)"
10344,2020-04-16,Ghana,0,5,641,"rgb(229, 134, 6)"
10345,2020-04-17,Ghana,0,0,641,"rgb(229, 134, 6)"
10346,2020-04-18,Ghana,0,0,641,"rgb(229, 134, 6)"
10347,2020-04-19,Ghana,1,193,834,"rgb(229, 134, 6)"
10348,2020-04-20,Ghana,0,208,1042,"rgb(229, 134, 6)"
10349,2020-04-21,Ghana,0,0,1042,"rgb(229, 134, 6)"
10350,2020-04-22,Ghana,0,0,1042,"rgb(229, 134, 6)"
10351,2020-04-23,Ghana,0,112,1154,"rgb(229, 134, 6)"
10352,2020-04-24,Ghana,0,0,1154,"rgb(229, 134, 6)"
10353,2020-04-25,Ghana,1,125,1279,"rgb(229, 134, 6)"
10354,2020-04-26,Ghana,0,0,1279,"rgb(229, 134, 6)"
10355,2020-04-27,Ghana,1,271,1550,"rgb(229, 134, 6)"
10356,2020-04-28,Ghana,0,0,1550,"rgb(229, 134, 6)"
10357,2020-04-29,Ghana,5,121,1671,"rgb(229, 134, 6)"
10358,2020-04-30,Ghana,0,0,1671,"rgb(229, 134, 6)"
10359,2020-05-01,Ghana,1,403,2074,"rgb(229, 134, 6)"
10360,2020-05-02,Ghana,0,0,2074,"rgb(229, 134, 6)"
10361,2020-05-03,Ghana,1,95,2169,"rgb(229, 134, 6)"
10362,2020-05-04,Ghana,0,0,2169,"rgb(229, 134, 6)"
10363,2020-05-05,Ghana,0,550,2719,"rgb(229, 134, 6)"
10364,2020-05-06,Ghana,0,0,2719,"rgb(229, 134, 6)"
10365,2020-05-07,Ghana,0,372,3091,"rgb(229, 134, 6)"
10366,2020-05-08,Ghana,0,0,3091,"rgb(229, 134, 6)"
10367,2020-05-09,Ghana,0,921,4012,"rgb(229, 134, 6)"
10368,2020-05-10,Ghana,4,251,4263,"rgb(229, 134, 6)"
10369,2020-05-11,Ghana,0,0,4263,"rgb(229, 134, 6)"
10370,2020-05-12,Ghana,0,437,4700,"rgb(229, 134, 6)"
10371,2020-05-13,Ghana,0,427,5127,"rgb(229, 134, 6)"
10372,2020-05-14,Ghana,2,281,5408,"rgb(229, 134, 6)"
10373,2020-05-15,Ghana,0,122,5530,"rgb(229, 134, 6)"
10374,2020-05-16,Ghana,4,108,5638,"rgb(229, 134, 6)"
10375,2020-05-17,Ghana,1,97,5735,"rgb(229, 134, 6)"
10376,2020-05-18,Ghana,0,0,5735,"rgb(229, 134, 6)"
10377,2020-05-19,Ghana,0,0,5735,"rgb(229, 134, 6)"
10378,2020-05-20,Ghana,2,361,6096,"rgb(229, 134, 6)"
10379,2020-05-21,Ghana,0,173,6269,"rgb(229, 134, 6)"
10380,2020-05-22,Ghana,0,217,6486,"rgb(229, 134, 6)"
10381,2020-05-23,Ghana,0,131,6617,"rgb(229, 134, 6)"
10382,2020-05-24,Ghana,0,0,6617,"rgb(229, 134, 6)"
10383,2020-05-25,Ghana,1,66,6683,"rgb(229, 134, 6)"
10384,2020-05-26,Ghana,0,125,6808,"rgb(229, 134, 6)"
10385,2020-05-27,Ghana,2,309,7117,"rgb(229, 134, 6)"
10386,2020-05-28,Ghana,0,186,7303,"rgb(229, 134, 6)"
10387,2020-05-29,Ghana,0,0,7303,"rgb(229, 134, 6)"
10388,2020-05-30,Ghana,0,313,7616,"rgb(229, 134, 6)"
10389,2020-05-31,Ghana,1,152,7768,"rgb(229, 134, 6)"
10390,2020-06-01,Ghana,1,302,8070,"rgb(229, 134, 6)"
10391,2020-06-02,Ghana,0,0,8070,"rgb(229, 134, 6)"
10392,2020-06-03,Ghana,2,227,8297,"rgb(229, 134, 6)"
10393,2020-06-04,Ghana,0,251,8548,"rgb(229, 134, 6)"
10394,2020-06-05,Ghana,0,337,8885,"rgb(229, 134, 6)"
10395,2020-06-06,Ghana,4,283,9168,"rgb(229, 134, 6)"
10396,2020-06-07,Ghana,2,294,9462,"rgb(229, 134, 6)"
10397,2020-06-08,Ghana,0,176,9638,"rgb(229, 134, 6)"
10398,2020-06-09,Ghana,4,272,9910,"rgb(229, 134, 6)"
10399,2020-06-10,Ghana,0,291,10201,"rgb(229, 134, 6)"
10400,2020-06-11,Ghana,0,157,10358,"rgb(229, 134, 6)"
10401,2020-06-12,Ghana,0,0,10358,"rgb(229, 134, 6)"
10402,2020-06-13,Ghana,0,760,11118,"rgb(229, 134, 6)"
10403,2020-06-14,Ghana,3,304,11422,"rgb(229, 134, 6)"
10404,2020-06-15,Ghana,3,542,11964,"rgb(229, 134, 6)"
10405,2020-06-16,Ghana,0,0,11964,"rgb(229, 134, 6)"
10406,2020-06-17,Ghana,4,229,12193,"rgb(229, 134, 6)"
10407,2020-06-18,Ghana,8,397,12590,"rgb(229, 134, 6)"
10408,2020-06-19,Ghana,0,339,12929,"rgb(229, 134, 6)"
10409,2020-06-20,Ghana,4,274,13203,"rgb(229, 134, 6)"
10410,2020-06-21,Ghana,15,508,13711,"rgb(229, 134, 6)"
10411,2020-06-22,Ghana,0,443,14154,"rgb(229, 134, 6)"
10412,2020-06-23,Ghana,0,0,14154,"rgb(229, 134, 6)"
10413,2020-06-24,Ghana,10,414,14568,"rgb(229, 134, 6)"
10414,2020-06-25,Ghana,0,445,15013,"rgb(229, 134, 6)"
10415,2020-06-26,Ghana,0,460,15473,"rgb(229, 134, 6)"
10416,2020-06-27,Ghana,8,361,15834,"rgb(229, 134, 6)"
10417,2020-06-28,Ghana,0,597,16431,"rgb(229, 134, 6)"
10418,2020-06-29,Ghana,9,920,17351,"rgb(229, 134, 6)"
10419,2020-06-30,Ghana,0,0,17351,"rgb(229, 134, 6)"
10420,2020-07-01,Ghana,0,390,17741,"rgb(229, 134, 6)"
10421,2020-07-02,Ghana,5,393,18134,"rgb(229, 134, 6)"
10422,2020-07-03,Ghana,0,0,18134,"rgb(229, 134, 6)"
10423,2020-07-04,Ghana,0,1254,19388,"rgb(229, 134, 6)"
10424,2020-07-05,Ghana,0,0,19388,"rgb(229, 134, 6)"
10425,2020-07-06,Ghana,5,697,20085,"rgb(229, 134, 6)"
10426,2020-07-07,Ghana,7,992,21077,"rgb(229, 134, 6)"
10427,2020-07-08,Ghana,0,891,21968,"rgb(229, 134, 6)"
10428,2020-07-09,Ghana,0,854,22822,"rgb(229, 134, 6)"
10429,2020-07-10,Ghana,0,641,23463,"rgb(229, 134, 6)"
10430,2020-07-11,Ghana,6,371,23834,"rgb(229, 134, 6)"
10431,2020-07-12,Ghana,0,414,24248,"rgb(229, 134, 6)"
10432,2020-07-13,Ghana,4,270,24518,"rgb(229, 134, 6)"
10433,2020-03-20,Gibraltar,0,10,10,"rgb(93, 105, 177)"
10434,2020-03-21,Gibraltar,0,0,10,"rgb(93, 105, 177)"
10435,2020-03-22,Gibraltar,0,0,10,"rgb(93, 105, 177)"
10436,2020-03-23,Gibraltar,0,5,15,"rgb(93, 105, 177)"
10437,2020-03-24,Gibraltar,0,0,15,"rgb(93, 105, 177)"
10438,2020-03-25,Gibraltar,0,0,15,"rgb(93, 105, 177)"
10439,2020-03-26,Gibraltar,0,11,26,"rgb(93, 105, 177)"
10440,2020-03-27,Gibraltar,0,9,35,"rgb(93, 105, 177)"
10441,2020-03-28,Gibraltar,0,20,55,"rgb(93, 105, 177)"
10442,2020-03-29,Gibraltar,0,1,56,"rgb(93, 105, 177)"
10443,2020-03-30,Gibraltar,0,9,65,"rgb(93, 105, 177)"
10444,2020-03-31,Gibraltar,0,4,69,"rgb(93, 105, 177)"
10445,2020-04-01,Gibraltar,0,0,69,"rgb(93, 105, 177)"
10446,2020-04-02,Gibraltar,0,0,69,"rgb(93, 105, 177)"
10447,2020-04-03,Gibraltar,0,19,88,"rgb(93, 105, 177)"
10448,2020-04-04,Gibraltar,0,7,95,"rgb(93, 105, 177)"
10449,2020-04-05,Gibraltar,0,3,98,"rgb(93, 105, 177)"
10450,2020-04-06,Gibraltar,0,5,103,"rgb(93, 105, 177)"
10451,2020-04-07,Gibraltar,0,6,109,"rgb(93, 105, 177)"
10452,2020-04-08,Gibraltar,0,4,113,"rgb(93, 105, 177)"
10453,2020-04-09,Gibraltar,0,7,120,"rgb(93, 105, 177)"
10454,2020-04-10,Gibraltar,0,3,123,"rgb(93, 105, 177)"
10455,2020-04-11,Gibraltar,0,4,127,"rgb(93, 105, 177)"
10456,2020-04-12,Gibraltar,0,2,129,"rgb(93, 105, 177)"
10457,2020-04-13,Gibraltar,0,0,129,"rgb(93, 105, 177)"
10458,2020-04-14,Gibraltar,0,0,129,"rgb(93, 105, 177)"
10459,2020-04-15,Gibraltar,0,0,129,"rgb(93, 105, 177)"
10460,2020-04-16,Gibraltar,0,2,131,"rgb(93, 105, 177)"
10461,2020-04-17,Gibraltar,0,2,133,"rgb(93, 105, 177)"
10462,2020-04-18,Gibraltar,0,0,133,"rgb(93, 105, 177)"
10463,2020-04-19,Gibraltar,0,0,133,"rgb(93, 105, 177)"
10464,2020-04-20,Gibraltar,0,0,133,"rgb(93, 105, 177)"
10465,2020-04-21,Gibraltar,0,0,133,"rgb(93, 105, 177)"
10466,2020-04-22,Gibraltar,0,0,133,"rgb(93, 105, 177)"
10467,2020-04-23,Gibraltar,0,0,133,"rgb(93, 105, 177)"
10468,2020-04-24,Gibraltar,0,0,133,"rgb(93, 105, 177)"
10469,2020-04-25,Gibraltar,0,0,133,"rgb(93, 105, 177)"
10470,2020-04-26,Gibraltar,0,3,136,"rgb(93, 105, 177)"
10471,2020-04-27,Gibraltar,0,5,141,"rgb(93, 105, 177)"
10472,2020-04-28,Gibraltar,0,0,141,"rgb(93, 105, 177)"
10473,2020-04-29,Gibraltar,0,0,141,"rgb(93, 105, 177)"
10474,2020-04-30,Gibraltar,0,0,141,"rgb(93, 105, 177)"
10475,2020-05-01,Gibraltar,0,3,144,"rgb(93, 105, 177)"
10476,2020-05-02,Gibraltar,0,0,144,"rgb(93, 105, 177)"
10477,2020-05-03,Gibraltar,0,0,144,"rgb(93, 105, 177)"
10478,2020-05-04,Gibraltar,0,0,144,"rgb(93, 105, 177)"
10479,2020-05-05,Gibraltar,0,0,144,"rgb(93, 105, 177)"
10480,2020-05-06,Gibraltar,0,0,144,"rgb(93, 105, 177)"
10481,2020-05-07,Gibraltar,0,0,144,"rgb(93, 105, 177)"
10482,2020-05-08,Gibraltar,0,0,144,"rgb(93, 105, 177)"
10483,2020-05-09,Gibraltar,0,2,146,"rgb(93, 105, 177)"
10484,2020-05-10,Gibraltar,0,0,146,"rgb(93, 105, 177)"
10485,2020-05-11,Gibraltar,0,0,146,"rgb(93, 105, 177)"
10486,2020-05-12,Gibraltar,0,1,147,"rgb(93, 105, 177)"
10487,2020-05-13,Gibraltar,0,0,147,"rgb(93, 105, 177)"
10488,2020-05-14,Gibraltar,0,0,147,"rgb(93, 105, 177)"
10489,2020-05-15,Gibraltar,0,0,147,"rgb(93, 105, 177)"
10490,2020-05-16,Gibraltar,0,0,147,"rgb(93, 105, 177)"
10491,2020-05-17,Gibraltar,0,0,147,"rgb(93, 105, 177)"
10492,2020-05-18,Gibraltar,0,0,147,"rgb(93, 105, 177)"
10493,2020-05-19,Gibraltar,0,0,147,"rgb(93, 105, 177)"
10494,2020-05-20,Gibraltar,0,0,147,"rgb(93, 105, 177)"
10495,2020-05-21,Gibraltar,0,2,149,"rgb(93, 105, 177)"
10496,2020-05-22,Gibraltar,0,2,151,"rgb(93, 105, 177)"
10497,2020-05-23,Gibraltar,0,0,151,"rgb(93, 105, 177)"
10498,2020-05-24,Gibraltar,0,0,151,"rgb(93, 105, 177)"
10499,2020-05-25,Gibraltar,0,0,151,"rgb(93, 105, 177)"
10500,2020-05-26,Gibraltar,0,4,155,"rgb(93, 105, 177)"
10501,2020-05-27,Gibraltar,0,0,155,"rgb(93, 105, 177)"
10502,2020-05-28,Gibraltar,0,2,157,"rgb(93, 105, 177)"
10503,2020-05-29,Gibraltar,0,0,157,"rgb(93, 105, 177)"
10504,2020-05-30,Gibraltar,0,4,161,"rgb(93, 105, 177)"
10505,2020-05-31,Gibraltar,0,0,161,"rgb(93, 105, 177)"
10506,2020-06-01,Gibraltar,0,8,169,"rgb(93, 105, 177)"
10507,2020-06-02,Gibraltar,0,1,170,"rgb(93, 105, 177)"
10508,2020-06-03,Gibraltar,0,2,172,"rgb(93, 105, 177)"
10509,2020-06-04,Gibraltar,0,1,173,"rgb(93, 105, 177)"
10510,2020-06-05,Gibraltar,0,0,173,"rgb(93, 105, 177)"
10511,2020-06-06,Gibraltar,0,1,174,"rgb(93, 105, 177)"
10512,2020-06-07,Gibraltar,0,0,174,"rgb(93, 105, 177)"
10513,2020-06-08,Gibraltar,0,1,175,"rgb(93, 105, 177)"
10514,2020-06-09,Gibraltar,0,1,176,"rgb(93, 105, 177)"
10515,2020-06-10,Gibraltar,0,0,176,"rgb(93, 105, 177)"
10516,2020-06-11,Gibraltar,0,0,176,"rgb(93, 105, 177)"
10517,2020-06-12,Gibraltar,0,0,176,"rgb(93, 105, 177)"
10518,2020-06-13,Gibraltar,0,0,176,"rgb(93, 105, 177)"
10519,2020-06-14,Gibraltar,0,0,176,"rgb(93, 105, 177)"
10520,2020-06-15,Gibraltar,0,0,176,"rgb(93, 105, 177)"
10521,2020-06-16,Gibraltar,0,0,176,"rgb(93, 105, 177)"
10522,2020-06-17,Gibraltar,0,0,176,"rgb(93, 105, 177)"
10523,2020-06-18,Gibraltar,0,0,176,"rgb(93, 105, 177)"
10524,2020-06-19,Gibraltar,0,0,176,"rgb(93, 105, 177)"
10525,2020-06-20,Gibraltar,0,0,176,"rgb(93, 105, 177)"
10526,2020-06-21,Gibraltar,0,0,176,"rgb(93, 105, 177)"
10527,2020-06-22,Gibraltar,0,0,176,"rgb(93, 105, 177)"
10528,2020-06-23,Gibraltar,0,0,176,"rgb(93, 105, 177)"
10529,2020-06-24,Gibraltar,0,0,176,"rgb(93, 105, 177)"
10530,2020-06-25,Gibraltar,0,0,176,"rgb(93, 105, 177)"
10531,2020-06-26,Gibraltar,0,0,176,"rgb(93, 105, 177)"
10532,2020-06-27,Gibraltar,0,0,176,"rgb(93, 105, 177)"
10533,2020-06-28,Gibraltar,0,0,176,"rgb(93, 105, 177)"
10534,2020-06-29,Gibraltar,0,1,177,"rgb(93, 105, 177)"
10535,2020-06-30,Gibraltar,0,0,177,"rgb(93, 105, 177)"
10536,2020-07-01,Gibraltar,0,0,177,"rgb(93, 105, 177)"
10537,2020-07-02,Gibraltar,0,1,178,"rgb(93, 105, 177)"
10538,2020-07-03,Gibraltar,0,0,178,"rgb(93, 105, 177)"
10539,2020-07-04,Gibraltar,0,0,178,"rgb(93, 105, 177)"
10540,2020-07-05,Gibraltar,0,0,178,"rgb(93, 105, 177)"
10541,2020-07-06,Gibraltar,0,0,178,"rgb(93, 105, 177)"
10542,2020-07-07,Gibraltar,0,1,179,"rgb(93, 105, 177)"
10543,2020-07-08,Gibraltar,0,0,179,"rgb(93, 105, 177)"
10544,2020-07-09,Gibraltar,0,0,179,"rgb(93, 105, 177)"
10545,2020-07-10,Gibraltar,0,1,180,"rgb(93, 105, 177)"
10546,2020-07-11,Gibraltar,0,0,180,"rgb(93, 105, 177)"
10547,2020-07-12,Gibraltar,0,0,180,"rgb(93, 105, 177)"
10548,2020-07-13,Gibraltar,0,0,180,"rgb(93, 105, 177)"
10549,2020-03-20,Greenland,0,2,2,"rgb(82, 188, 163)"
10550,2020-03-21,Greenland,0,0,2,"rgb(82, 188, 163)"
10551,2020-03-22,Greenland,0,0,2,"rgb(82, 188, 163)"
10552,2020-03-23,Greenland,0,0,2,"rgb(82, 188, 163)"
10553,2020-03-24,Greenland,0,2,4,"rgb(82, 188, 163)"
10554,2020-03-25,Greenland,0,0,4,"rgb(82, 188, 163)"
10555,2020-03-26,Greenland,0,1,5,"rgb(82, 188, 163)"
10556,2020-03-27,Greenland,0,1,6,"rgb(82, 188, 163)"
10557,2020-03-28,Greenland,0,3,9,"rgb(82, 188, 163)"
10558,2020-03-29,Greenland,0,1,10,"rgb(82, 188, 163)"
10559,2020-03-30,Greenland,0,0,10,"rgb(82, 188, 163)"
10560,2020-03-31,Greenland,0,0,10,"rgb(82, 188, 163)"
10561,2020-04-01,Greenland,0,0,10,"rgb(82, 188, 163)"
10562,2020-04-02,Greenland,0,0,10,"rgb(82, 188, 163)"
10563,2020-04-03,Greenland,0,0,10,"rgb(82, 188, 163)"
10564,2020-04-04,Greenland,0,0,10,"rgb(82, 188, 163)"
10565,2020-04-05,Greenland,0,0,10,"rgb(82, 188, 163)"
10566,2020-04-06,Greenland,0,1,11,"rgb(82, 188, 163)"
10567,2020-04-07,Greenland,0,0,11,"rgb(82, 188, 163)"
10568,2020-04-08,Greenland,0,0,11,"rgb(82, 188, 163)"
10569,2020-04-09,Greenland,0,0,11,"rgb(82, 188, 163)"
10570,2020-04-10,Greenland,0,0,11,"rgb(82, 188, 163)"
10571,2020-04-11,Greenland,0,0,11,"rgb(82, 188, 163)"
10572,2020-04-12,Greenland,0,0,11,"rgb(82, 188, 163)"
10573,2020-04-13,Greenland,0,0,11,"rgb(82, 188, 163)"
10574,2020-04-14,Greenland,0,0,11,"rgb(82, 188, 163)"
10575,2020-04-15,Greenland,0,0,11,"rgb(82, 188, 163)"
10576,2020-04-16,Greenland,0,0,11,"rgb(82, 188, 163)"
10577,2020-04-17,Greenland,0,0,11,"rgb(82, 188, 163)"
10578,2020-04-18,Greenland,0,0,11,"rgb(82, 188, 163)"
10579,2020-04-19,Greenland,0,0,11,"rgb(82, 188, 163)"
10580,2020-04-20,Greenland,0,0,11,"rgb(82, 188, 163)"
10581,2020-04-21,Greenland,0,0,11,"rgb(82, 188, 163)"
10582,2020-04-22,Greenland,0,0,11,"rgb(82, 188, 163)"
10583,2020-04-23,Greenland,0,0,11,"rgb(82, 188, 163)"
10584,2020-04-24,Greenland,0,0,11,"rgb(82, 188, 163)"
10585,2020-04-25,Greenland,0,0,11,"rgb(82, 188, 163)"
10586,2020-04-26,Greenland,0,0,11,"rgb(82, 188, 163)"
10587,2020-04-27,Greenland,0,0,11,"rgb(82, 188, 163)"
10588,2020-04-28,Greenland,0,0,11,"rgb(82, 188, 163)"
10589,2020-04-29,Greenland,0,0,11,"rgb(82, 188, 163)"
10590,2020-04-30,Greenland,0,0,11,"rgb(82, 188, 163)"
10591,2020-05-01,Greenland,0,0,11,"rgb(82, 188, 163)"
10592,2020-05-02,Greenland,0,0,11,"rgb(82, 188, 163)"
10593,2020-05-03,Greenland,0,0,11,"rgb(82, 188, 163)"
10594,2020-05-04,Greenland,0,0,11,"rgb(82, 188, 163)"
10595,2020-05-05,Greenland,0,0,11,"rgb(82, 188, 163)"
10596,2020-05-06,Greenland,0,0,11,"rgb(82, 188, 163)"
10597,2020-05-07,Greenland,0,0,11,"rgb(82, 188, 163)"
10598,2020-05-08,Greenland,0,0,11,"rgb(82, 188, 163)"
10599,2020-05-09,Greenland,0,0,11,"rgb(82, 188, 163)"
10600,2020-05-10,Greenland,0,0,11,"rgb(82, 188, 163)"
10601,2020-05-11,Greenland,0,0,11,"rgb(82, 188, 163)"
10602,2020-05-12,Greenland,0,0,11,"rgb(82, 188, 163)"
10603,2020-05-13,Greenland,0,0,11,"rgb(82, 188, 163)"
10604,2020-05-14,Greenland,0,0,11,"rgb(82, 188, 163)"
10605,2020-05-15,Greenland,0,0,11,"rgb(82, 188, 163)"
10606,2020-05-16,Greenland,0,0,11,"rgb(82, 188, 163)"
10607,2020-05-17,Greenland,0,0,11,"rgb(82, 188, 163)"
10608,2020-05-18,Greenland,0,0,11,"rgb(82, 188, 163)"
10609,2020-05-19,Greenland,0,0,11,"rgb(82, 188, 163)"
10610,2020-05-20,Greenland,0,0,11,"rgb(82, 188, 163)"
10611,2020-05-21,Greenland,0,0,11,"rgb(82, 188, 163)"
10612,2020-05-22,Greenland,0,0,11,"rgb(82, 188, 163)"
10613,2020-05-23,Greenland,0,0,11,"rgb(82, 188, 163)"
10614,2020-05-24,Greenland,0,0,11,"rgb(82, 188, 163)"
10615,2020-05-25,Greenland,0,0,11,"rgb(82, 188, 163)"
10616,2020-05-26,Greenland,0,1,12,"rgb(82, 188, 163)"
10617,2020-05-27,Greenland,0,0,12,"rgb(82, 188, 163)"
10618,2020-05-28,Greenland,0,0,12,"rgb(82, 188, 163)"
10619,2020-05-29,Greenland,0,1,13,"rgb(82, 188, 163)"
10620,2020-05-30,Greenland,0,0,13,"rgb(82, 188, 163)"
10621,2020-05-31,Greenland,0,0,13,"rgb(82, 188, 163)"
10622,2020-06-01,Greenland,0,0,13,"rgb(82, 188, 163)"
10623,2020-06-02,Greenland,0,0,13,"rgb(82, 188, 163)"
10624,2020-06-03,Greenland,0,0,13,"rgb(82, 188, 163)"
10625,2020-06-04,Greenland,0,0,13,"rgb(82, 188, 163)"
10626,2020-06-05,Greenland,0,0,13,"rgb(82, 188, 163)"
10627,2020-06-06,Greenland,0,0,13,"rgb(82, 188, 163)"
10628,2020-06-07,Greenland,0,0,13,"rgb(82, 188, 163)"
10629,2020-06-08,Greenland,0,0,13,"rgb(82, 188, 163)"
10630,2020-06-09,Greenland,0,0,13,"rgb(82, 188, 163)"
10631,2020-06-10,Greenland,0,0,13,"rgb(82, 188, 163)"
10632,2020-06-11,Greenland,0,0,13,"rgb(82, 188, 163)"
10633,2020-06-12,Greenland,0,0,13,"rgb(82, 188, 163)"
10634,2020-06-13,Greenland,0,0,13,"rgb(82, 188, 163)"
10635,2020-06-14,Greenland,0,0,13,"rgb(82, 188, 163)"
10636,2020-06-15,Greenland,0,0,13,"rgb(82, 188, 163)"
10637,2020-06-16,Greenland,0,0,13,"rgb(82, 188, 163)"
10638,2020-06-17,Greenland,0,0,13,"rgb(82, 188, 163)"
10639,2020-06-18,Greenland,0,0,13,"rgb(82, 188, 163)"
10640,2020-06-19,Greenland,0,0,13,"rgb(82, 188, 163)"
10641,2020-06-20,Greenland,0,0,13,"rgb(82, 188, 163)"
10642,2020-06-21,Greenland,0,0,13,"rgb(82, 188, 163)"
10643,2020-06-22,Greenland,0,0,13,"rgb(82, 188, 163)"
10644,2020-06-23,Greenland,0,0,13,"rgb(82, 188, 163)"
10645,2020-06-24,Greenland,0,0,13,"rgb(82, 188, 163)"
10646,2020-06-25,Greenland,0,0,13,"rgb(82, 188, 163)"
10647,2020-06-26,Greenland,0,0,13,"rgb(82, 188, 163)"
10648,2020-06-27,Greenland,0,0,13,"rgb(82, 188, 163)"
10649,2020-06-28,Greenland,0,0,13,"rgb(82, 188, 163)"
10650,2020-06-29,Greenland,0,0,13,"rgb(82, 188, 163)"
10651,2020-06-30,Greenland,0,0,13,"rgb(82, 188, 163)"
10652,2020-07-01,Greenland,0,0,13,"rgb(82, 188, 163)"
10653,2020-07-02,Greenland,0,0,13,"rgb(82, 188, 163)"
10654,2020-07-03,Greenland,0,0,13,"rgb(82, 188, 163)"
10655,2020-07-04,Greenland,0,0,13,"rgb(82, 188, 163)"
10656,2020-07-05,Greenland,0,0,13,"rgb(82, 188, 163)"
10657,2020-07-06,Greenland,0,0,13,"rgb(82, 188, 163)"
10658,2020-07-07,Greenland,0,0,13,"rgb(82, 188, 163)"
10659,2020-07-08,Greenland,0,0,13,"rgb(82, 188, 163)"
10660,2020-07-09,Greenland,0,0,13,"rgb(82, 188, 163)"
10661,2020-07-10,Greenland,0,0,13,"rgb(82, 188, 163)"
10662,2020-07-11,Greenland,0,0,13,"rgb(82, 188, 163)"
10663,2020-07-12,Greenland,0,0,13,"rgb(82, 188, 163)"
10664,2020-07-13,Greenland,0,0,13,"rgb(82, 188, 163)"
10665,2020-03-18,Gambia,0,1,1,"rgb(153, 201, 69)"
10666,2020-03-19,Gambia,0,0,1,"rgb(153, 201, 69)"
10667,2020-03-20,Gambia,0,0,1,"rgb(153, 201, 69)"
10668,2020-03-21,Gambia,0,0,1,"rgb(153, 201, 69)"
10669,2020-03-22,Gambia,0,0,1,"rgb(153, 201, 69)"
10670,2020-03-23,Gambia,0,0,1,"rgb(153, 201, 69)"
10671,2020-03-24,Gambia,1,1,2,"rgb(153, 201, 69)"
10672,2020-03-25,Gambia,0,1,3,"rgb(153, 201, 69)"
10673,2020-03-26,Gambia,0,0,3,"rgb(153, 201, 69)"
10674,2020-03-27,Gambia,0,0,3,"rgb(153, 201, 69)"
10675,2020-03-28,Gambia,0,0,3,"rgb(153, 201, 69)"
10676,2020-03-29,Gambia,0,0,3,"rgb(153, 201, 69)"
10677,2020-03-30,Gambia,0,0,3,"rgb(153, 201, 69)"
10678,2020-03-31,Gambia,0,1,4,"rgb(153, 201, 69)"
10679,2020-04-01,Gambia,0,0,4,"rgb(153, 201, 69)"
10680,2020-04-02,Gambia,0,0,4,"rgb(153, 201, 69)"
10681,2020-04-03,Gambia,0,0,4,"rgb(153, 201, 69)"
10682,2020-04-04,Gambia,0,0,4,"rgb(153, 201, 69)"
10683,2020-04-05,Gambia,0,0,4,"rgb(153, 201, 69)"
10684,2020-04-06,Gambia,0,0,4,"rgb(153, 201, 69)"
10685,2020-04-07,Gambia,0,0,4,"rgb(153, 201, 69)"
10686,2020-04-08,Gambia,0,0,4,"rgb(153, 201, 69)"
10687,2020-04-09,Gambia,0,0,4,"rgb(153, 201, 69)"
10688,2020-04-10,Gambia,0,0,4,"rgb(153, 201, 69)"
10689,2020-04-11,Gambia,0,0,4,"rgb(153, 201, 69)"
10690,2020-04-12,Gambia,0,5,9,"rgb(153, 201, 69)"
10691,2020-04-13,Gambia,0,0,9,"rgb(153, 201, 69)"
10692,2020-04-14,Gambia,0,0,9,"rgb(153, 201, 69)"
10693,2020-04-15,Gambia,0,0,9,"rgb(153, 201, 69)"
10694,2020-04-16,Gambia,0,0,9,"rgb(153, 201, 69)"
10695,2020-04-17,Gambia,0,0,9,"rgb(153, 201, 69)"
10696,2020-04-18,Gambia,0,0,9,"rgb(153, 201, 69)"
10697,2020-04-19,Gambia,0,0,9,"rgb(153, 201, 69)"
10698,2020-04-20,Gambia,0,1,10,"rgb(153, 201, 69)"
10699,2020-04-21,Gambia,0,0,10,"rgb(153, 201, 69)"
10700,2020-04-22,Gambia,0,0,10,"rgb(153, 201, 69)"
10701,2020-04-23,Gambia,0,0,10,"rgb(153, 201, 69)"
10702,2020-04-24,Gambia,0,0,10,"rgb(153, 201, 69)"
10703,2020-04-25,Gambia,0,0,10,"rgb(153, 201, 69)"
10704,2020-04-26,Gambia,0,0,10,"rgb(153, 201, 69)"
10705,2020-04-27,Gambia,0,0,10,"rgb(153, 201, 69)"
10706,2020-04-28,Gambia,0,0,10,"rgb(153, 201, 69)"
10707,2020-04-29,Gambia,0,0,10,"rgb(153, 201, 69)"
10708,2020-04-30,Gambia,0,1,11,"rgb(153, 201, 69)"
10709,2020-05-01,Gambia,0,1,12,"rgb(153, 201, 69)"
10710,2020-05-02,Gambia,0,0,12,"rgb(153, 201, 69)"
10711,2020-05-03,Gambia,0,5,17,"rgb(153, 201, 69)"
10712,2020-05-04,Gambia,0,0,17,"rgb(153, 201, 69)"
10713,2020-05-05,Gambia,0,0,17,"rgb(153, 201, 69)"
10714,2020-05-06,Gambia,0,0,17,"rgb(153, 201, 69)"
10715,2020-05-07,Gambia,0,0,17,"rgb(153, 201, 69)"
10716,2020-05-08,Gambia,0,1,18,"rgb(153, 201, 69)"
10717,2020-05-09,Gambia,0,2,20,"rgb(153, 201, 69)"
10718,2020-05-10,Gambia,0,0,20,"rgb(153, 201, 69)"
10719,2020-05-11,Gambia,0,0,20,"rgb(153, 201, 69)"
10720,2020-05-12,Gambia,0,2,22,"rgb(153, 201, 69)"
10721,2020-05-13,Gambia,0,1,23,"rgb(153, 201, 69)"
10722,2020-05-14,Gambia,0,0,23,"rgb(153, 201, 69)"
10723,2020-05-15,Gambia,0,0,23,"rgb(153, 201, 69)"
10724,2020-05-16,Gambia,0,0,23,"rgb(153, 201, 69)"
10725,2020-05-17,Gambia,0,0,23,"rgb(153, 201, 69)"
10726,2020-05-18,Gambia,0,0,23,"rgb(153, 201, 69)"
10727,2020-05-19,Gambia,0,1,24,"rgb(153, 201, 69)"
10728,2020-05-20,Gambia,0,0,24,"rgb(153, 201, 69)"
10729,2020-05-21,Gambia,0,0,24,"rgb(153, 201, 69)"
10730,2020-05-22,Gambia,0,0,24,"rgb(153, 201, 69)"
10731,2020-05-23,Gambia,0,1,25,"rgb(153, 201, 69)"
10732,2020-05-24,Gambia,0,0,25,"rgb(153, 201, 69)"
10733,2020-05-25,Gambia,0,0,25,"rgb(153, 201, 69)"
10734,2020-05-26,Gambia,0,0,25,"rgb(153, 201, 69)"
10735,2020-05-27,Gambia,0,0,25,"rgb(153, 201, 69)"
10736,2020-05-28,Gambia,0,0,25,"rgb(153, 201, 69)"
10737,2020-05-29,Gambia,0,0,25,"rgb(153, 201, 69)"
10738,2020-05-30,Gambia,0,0,25,"rgb(153, 201, 69)"
10739,2020-05-31,Gambia,0,0,25,"rgb(153, 201, 69)"
10740,2020-06-01,Gambia,0,0,25,"rgb(153, 201, 69)"
10741,2020-06-02,Gambia,0,0,25,"rgb(153, 201, 69)"
10742,2020-06-03,Gambia,0,1,26,"rgb(153, 201, 69)"
10743,2020-06-04,Gambia,0,0,26,"rgb(153, 201, 69)"
10744,2020-06-05,Gambia,0,0,26,"rgb(153, 201, 69)"
10745,2020-06-06,Gambia,0,0,26,"rgb(153, 201, 69)"
10746,2020-06-07,Gambia,0,0,26,"rgb(153, 201, 69)"
10747,2020-06-08,Gambia,0,0,26,"rgb(153, 201, 69)"
10748,2020-06-09,Gambia,0,2,28,"rgb(153, 201, 69)"
10749,2020-06-10,Gambia,0,0,28,"rgb(153, 201, 69)"
10750,2020-06-11,Gambia,0,0,28,"rgb(153, 201, 69)"
10751,2020-06-12,Gambia,0,0,28,"rgb(153, 201, 69)"
10752,2020-06-13,Gambia,0,0,28,"rgb(153, 201, 69)"
10753,2020-06-14,Gambia,0,0,28,"rgb(153, 201, 69)"
10754,2020-06-15,Gambia,0,0,28,"rgb(153, 201, 69)"
10755,2020-06-16,Gambia,0,2,30,"rgb(153, 201, 69)"
10756,2020-06-17,Gambia,0,4,34,"rgb(153, 201, 69)"
10757,2020-06-18,Gambia,0,0,34,"rgb(153, 201, 69)"
10758,2020-06-19,Gambia,0,2,36,"rgb(153, 201, 69)"
10759,2020-06-20,Gambia,0,0,36,"rgb(153, 201, 69)"
10760,2020-06-21,Gambia,1,1,37,"rgb(153, 201, 69)"
10761,2020-06-22,Gambia,0,0,37,"rgb(153, 201, 69)"
10762,2020-06-23,Gambia,0,4,41,"rgb(153, 201, 69)"
10763,2020-06-24,Gambia,0,1,42,"rgb(153, 201, 69)"
10764,2020-06-25,Gambia,0,0,42,"rgb(153, 201, 69)"
10765,2020-06-26,Gambia,0,1,43,"rgb(153, 201, 69)"
10766,2020-06-27,Gambia,0,1,44,"rgb(153, 201, 69)"
10767,2020-06-28,Gambia,0,1,45,"rgb(153, 201, 69)"
10768,2020-06-29,Gambia,0,0,45,"rgb(153, 201, 69)"
10769,2020-06-30,Gambia,0,2,47,"rgb(153, 201, 69)"
10770,2020-07-01,Gambia,0,0,47,"rgb(153, 201, 69)"
10771,2020-07-02,Gambia,0,2,49,"rgb(153, 201, 69)"
10772,2020-07-03,Gambia,0,6,55,"rgb(153, 201, 69)"
10773,2020-07-04,Gambia,0,0,55,"rgb(153, 201, 69)"
10774,2020-07-05,Gambia,0,2,57,"rgb(153, 201, 69)"
10775,2020-07-06,Gambia,0,0,57,"rgb(153, 201, 69)"
10776,2020-07-07,Gambia,1,4,61,"rgb(153, 201, 69)"
10777,2020-07-08,Gambia,0,0,61,"rgb(153, 201, 69)"
10778,2020-07-09,Gambia,0,2,63,"rgb(153, 201, 69)"
10779,2020-07-10,Gambia,0,1,64,"rgb(153, 201, 69)"
10780,2020-07-11,Gambia,0,0,64,"rgb(153, 201, 69)"
10781,2020-07-12,Gambia,0,0,64,"rgb(153, 201, 69)"
10782,2020-07-13,Gambia,0,0,64,"rgb(153, 201, 69)"
10783,2020-03-14,Guinea,0,1,1,"rgb(204, 97, 176)"
10784,2020-03-15,Guinea,0,0,1,"rgb(204, 97, 176)"
10785,2020-03-17,Guinea,0,0,1,"rgb(204, 97, 176)"
10786,2020-03-18,Guinea,0,0,1,"rgb(204, 97, 176)"
10787,2020-03-19,Guinea,0,0,1,"rgb(204, 97, 176)"
10788,2020-03-20,Guinea,0,0,1,"rgb(204, 97, 176)"
10789,2020-03-21,Guinea,0,1,2,"rgb(204, 97, 176)"
10790,2020-03-22,Guinea,0,0,2,"rgb(204, 97, 176)"
10791,2020-03-23,Guinea,0,0,2,"rgb(204, 97, 176)"
10792,2020-03-24,Guinea,0,0,2,"rgb(204, 97, 176)"
10793,2020-03-25,Guinea,0,2,4,"rgb(204, 97, 176)"
10794,2020-03-26,Guinea,0,0,4,"rgb(204, 97, 176)"
10795,2020-03-27,Guinea,0,1,5,"rgb(204, 97, 176)"
10796,2020-03-28,Guinea,0,0,5,"rgb(204, 97, 176)"
10797,2020-03-29,Guinea,0,3,8,"rgb(204, 97, 176)"
10798,2020-03-30,Guinea,0,0,8,"rgb(204, 97, 176)"
10799,2020-03-31,Guinea,0,8,16,"rgb(204, 97, 176)"
10800,2020-04-01,Guinea,0,0,16,"rgb(204, 97, 176)"
10801,2020-04-02,Guinea,0,14,30,"rgb(204, 97, 176)"
10802,2020-04-03,Guinea,0,22,52,"rgb(204, 97, 176)"
10803,2020-04-04,Guinea,0,0,52,"rgb(204, 97, 176)"
10804,2020-04-05,Guinea,0,59,111,"rgb(204, 97, 176)"
10805,2020-04-06,Guinea,0,10,121,"rgb(204, 97, 176)"
10806,2020-04-07,Guinea,0,7,128,"rgb(204, 97, 176)"
10807,2020-04-08,Guinea,0,16,144,"rgb(204, 97, 176)"
10808,2020-04-09,Guinea,0,20,164,"rgb(204, 97, 176)"
10809,2020-04-10,Guinea,0,30,194,"rgb(204, 97, 176)"
10810,2020-04-11,Guinea,0,18,212,"rgb(204, 97, 176)"
10811,2020-04-12,Guinea,0,38,250,"rgb(204, 97, 176)"
10812,2020-04-13,Guinea,0,0,250,"rgb(204, 97, 176)"
10813,2020-04-14,Guinea,0,69,319,"rgb(204, 97, 176)"
10814,2020-04-15,Guinea,0,44,363,"rgb(204, 97, 176)"
10815,2020-04-16,Guinea,1,41,404,"rgb(204, 97, 176)"
10816,2020-04-17,Guinea,0,34,438,"rgb(204, 97, 176)"
10817,2020-04-18,Guinea,2,39,477,"rgb(204, 97, 176)"
10818,2020-04-19,Guinea,0,0,477,"rgb(204, 97, 176)"
10819,2020-04-20,Guinea,2,102,579,"rgb(204, 97, 176)"
10820,2020-04-21,Guinea,0,43,622,"rgb(204, 97, 176)"
10821,2020-04-22,Guinea,1,66,688,"rgb(204, 97, 176)"
10822,2020-04-23,Guinea,0,73,761,"rgb(204, 97, 176)"
10823,2020-04-24,Guinea,0,101,862,"rgb(204, 97, 176)"
10824,2020-04-25,Guinea,0,92,954,"rgb(204, 97, 176)"
10825,2020-04-26,Guinea,1,42,996,"rgb(204, 97, 176)"
10826,2020-04-27,Guinea,0,98,1094,"rgb(204, 97, 176)"
10827,2020-04-28,Guinea,0,69,1163,"rgb(204, 97, 176)"
10828,2020-04-29,Guinea,0,77,1240,"rgb(204, 97, 176)"
10829,2020-04-30,Guinea,0,111,1351,"rgb(204, 97, 176)"
10830,2020-05-01,Guinea,0,144,1495,"rgb(204, 97, 176)"
10831,2020-05-02,Guinea,0,42,1537,"rgb(204, 97, 176)"
10832,2020-05-03,Guinea,0,49,1586,"rgb(204, 97, 176)"
10833,2020-05-04,Guinea,0,0,1586,"rgb(204, 97, 176)"
10834,2020-05-05,Guinea,2,124,1710,"rgb(204, 97, 176)"
10835,2020-05-06,Guinea,1,101,1811,"rgb(204, 97, 176)"
10836,2020-05-07,Guinea,1,45,1856,"rgb(204, 97, 176)"
10837,2020-05-08,Guinea,0,71,1927,"rgb(204, 97, 176)"
10838,2020-05-09,Guinea,0,82,2009,"rgb(204, 97, 176)"
10839,2020-05-10,Guinea,0,33,2042,"rgb(204, 97, 176)"
10840,2020-05-11,Guinea,0,104,2146,"rgb(204, 97, 176)"
10841,2020-05-12,Guinea,0,67,2213,"rgb(204, 97, 176)"
10842,2020-05-13,Guinea,0,0,2213,"rgb(204, 97, 176)"
10843,2020-05-14,Guinea,3,161,2374,"rgb(204, 97, 176)"
10844,2020-05-15,Guinea,0,99,2473,"rgb(204, 97, 176)"
10845,2020-05-16,Guinea,1,58,2531,"rgb(204, 97, 176)"
10846,2020-05-17,Guinea,1,127,2658,"rgb(204, 97, 176)"
10847,2020-05-18,Guinea,0,0,2658,"rgb(204, 97, 176)"
10848,2020-05-19,Guinea,0,138,2796,"rgb(204, 97, 176)"
10849,2020-05-20,Guinea,2,67,2863,"rgb(204, 97, 176)"
10850,2020-05-21,Guinea,0,0,2863,"rgb(204, 97, 176)"
10851,2020-05-22,Guinea,1,204,3067,"rgb(204, 97, 176)"
10852,2020-05-23,Guinea,0,0,3067,"rgb(204, 97, 176)"
10853,2020-05-24,Guinea,1,109,3176,"rgb(204, 97, 176)"
10854,2020-05-25,Guinea,0,99,3275,"rgb(204, 97, 176)"
10855,2020-05-26,Guinea,0,0,3275,"rgb(204, 97, 176)"
10856,2020-05-27,Guinea,0,83,3358,"rgb(204, 97, 176)"
10857,2020-05-28,Guinea,1,88,3446,"rgb(204, 97, 176)"
10858,2020-05-29,Guinea,1,107,3553,"rgb(204, 97, 176)"
10859,2020-05-30,Guinea,0,103,3656,"rgb(204, 97, 176)"
10860,2020-05-31,Guinea,1,50,3706,"rgb(204, 97, 176)"
10861,2020-06-01,Guinea,0,65,3771,"rgb(204, 97, 176)"
10862,2020-06-02,Guinea,0,73,3844,"rgb(204, 97, 176)"
10863,2020-06-03,Guinea,0,0,3844,"rgb(204, 97, 176)"
10864,2020-06-04,Guinea,0,42,3886,"rgb(204, 97, 176)"
10865,2020-06-05,Guinea,0,105,3991,"rgb(204, 97, 176)"
10866,2020-06-06,Guinea,0,69,4060,"rgb(204, 97, 176)"
10867,2020-06-07,Guinea,0,57,4117,"rgb(204, 97, 176)"
10868,2020-06-08,Guinea,0,48,4165,"rgb(204, 97, 176)"
10869,2020-06-09,Guinea,0,51,4216,"rgb(204, 97, 176)"
10870,2020-06-10,Guinea,0,42,4258,"rgb(204, 97, 176)"
10871,2020-06-11,Guinea,0,0,4258,"rgb(204, 97, 176)"
10872,2020-06-12,Guinea,0,114,4372,"rgb(204, 97, 176)"
10873,2020-06-13,Guinea,1,54,4426,"rgb(204, 97, 176)"
10874,2020-06-14,Guinea,1,58,4484,"rgb(204, 97, 176)"
10875,2020-06-15,Guinea,0,48,4532,"rgb(204, 97, 176)"
10876,2020-06-16,Guinea,1,40,4572,"rgb(204, 97, 176)"
10877,2020-06-17,Guinea,0,67,4639,"rgb(204, 97, 176)"
10878,2020-06-18,Guinea,0,29,4668,"rgb(204, 97, 176)"
10879,2020-06-19,Guinea,0,173,4841,"rgb(204, 97, 176)"
10880,2020-06-20,Guinea,1,63,4904,"rgb(204, 97, 176)"
10881,2020-06-21,Guinea,0,56,4960,"rgb(204, 97, 176)"
10882,2020-06-22,Guinea,0,28,4988,"rgb(204, 97, 176)"
10883,2020-06-23,Guinea,0,0,4988,"rgb(204, 97, 176)"
10884,2020-06-24,Guinea,2,116,5104,"rgb(204, 97, 176)"
10885,2020-06-25,Guinea,0,70,5174,"rgb(204, 97, 176)"
10886,2020-06-26,Guinea,0,37,5211,"rgb(204, 97, 176)"
10887,2020-06-27,Guinea,0,49,5260,"rgb(204, 97, 176)"
10888,2020-06-28,Guinea,1,31,5291,"rgb(204, 97, 176)"
10889,2020-06-29,Guinea,1,51,5342,"rgb(204, 97, 176)"
10890,2020-06-30,Guinea,0,9,5351,"rgb(204, 97, 176)"
10891,2020-07-01,Guinea,2,40,5391,"rgb(204, 97, 176)"
10892,2020-07-02,Guinea,0,13,5404,"rgb(204, 97, 176)"
10893,2020-07-03,Guinea,0,46,5450,"rgb(204, 97, 176)"
10894,2020-07-04,Guinea,0,71,5521,"rgb(204, 97, 176)"
10895,2020-07-05,Guinea,1,49,5570,"rgb(204, 97, 176)"
10896,2020-07-06,Guinea,0,40,5610,"rgb(204, 97, 176)"
10897,2020-07-07,Guinea,0,26,5636,"rgb(204, 97, 176)"
10898,2020-07-08,Guinea,0,61,5697,"rgb(204, 97, 176)"
10899,2020-07-09,Guinea,0,0,5697,"rgb(204, 97, 176)"
10900,2020-07-10,Guinea,2,184,5881,"rgb(204, 97, 176)"
10901,2020-07-11,Guinea,1,88,5969,"rgb(204, 97, 176)"
10902,2020-07-12,Guinea,0,75,6044,"rgb(204, 97, 176)"
10903,2020-07-13,Guinea,0,97,6141,"rgb(204, 97, 176)"
10904,2020-03-15,Equatorial Guinea,0,1,1,"rgb(36, 121, 108)"
10905,2020-03-16,Equatorial Guinea,0,0,1,"rgb(36, 121, 108)"
10906,2020-03-17,Equatorial Guinea,0,0,1,"rgb(36, 121, 108)"
10907,2020-03-18,Equatorial Guinea,0,0,1,"rgb(36, 121, 108)"
10908,2020-03-19,Equatorial Guinea,0,2,3,"rgb(36, 121, 108)"
10909,2020-03-20,Equatorial Guinea,0,1,4,"rgb(36, 121, 108)"
10910,2020-03-21,Equatorial Guinea,0,0,4,"rgb(36, 121, 108)"
10911,2020-03-22,Equatorial Guinea,0,2,6,"rgb(36, 121, 108)"
10912,2020-03-23,Equatorial Guinea,0,0,6,"rgb(36, 121, 108)"
10913,2020-03-24,Equatorial Guinea,0,3,9,"rgb(36, 121, 108)"
10914,2020-03-25,Equatorial Guinea,0,0,9,"rgb(36, 121, 108)"
10915,2020-03-26,Equatorial Guinea,0,2,11,"rgb(36, 121, 108)"
10916,2020-03-27,Equatorial Guinea,0,1,12,"rgb(36, 121, 108)"
10917,2020-03-28,Equatorial Guinea,0,1,13,"rgb(36, 121, 108)"
10918,2020-03-29,Equatorial Guinea,0,0,13,"rgb(36, 121, 108)"
10919,2020-03-30,Equatorial Guinea,0,1,14,"rgb(36, 121, 108)"
10920,2020-03-31,Equatorial Guinea,0,0,14,"rgb(36, 121, 108)"
10921,2020-04-01,Equatorial Guinea,0,1,15,"rgb(36, 121, 108)"
10922,2020-04-02,Equatorial Guinea,0,0,15,"rgb(36, 121, 108)"
10923,2020-04-03,Equatorial Guinea,0,0,15,"rgb(36, 121, 108)"
10924,2020-04-04,Equatorial Guinea,0,1,16,"rgb(36, 121, 108)"
10925,2020-04-05,Equatorial Guinea,0,0,16,"rgb(36, 121, 108)"
10926,2020-04-06,Equatorial Guinea,0,0,16,"rgb(36, 121, 108)"
10927,2020-04-07,Equatorial Guinea,0,0,16,"rgb(36, 121, 108)"
10928,2020-04-08,Equatorial Guinea,0,0,16,"rgb(36, 121, 108)"
10929,2020-04-09,Equatorial Guinea,0,2,18,"rgb(36, 121, 108)"
10930,2020-04-10,Equatorial Guinea,0,0,18,"rgb(36, 121, 108)"
10931,2020-04-11,Equatorial Guinea,0,0,18,"rgb(36, 121, 108)"
10932,2020-04-12,Equatorial Guinea,0,0,18,"rgb(36, 121, 108)"
10933,2020-04-13,Equatorial Guinea,0,3,21,"rgb(36, 121, 108)"
10934,2020-04-14,Equatorial Guinea,0,0,21,"rgb(36, 121, 108)"
10935,2020-04-15,Equatorial Guinea,0,20,41,"rgb(36, 121, 108)"
10936,2020-04-16,Equatorial Guinea,0,10,51,"rgb(36, 121, 108)"
10937,2020-04-17,Equatorial Guinea,0,0,51,"rgb(36, 121, 108)"
10938,2020-04-18,Equatorial Guinea,0,28,79,"rgb(36, 121, 108)"
10939,2020-04-19,Equatorial Guinea,0,0,79,"rgb(36, 121, 108)"
10940,2020-04-20,Equatorial Guinea,0,0,79,"rgb(36, 121, 108)"
10941,2020-04-21,Equatorial Guinea,0,0,79,"rgb(36, 121, 108)"
10942,2020-04-22,Equatorial Guinea,0,0,79,"rgb(36, 121, 108)"
10943,2020-04-23,Equatorial Guinea,0,4,83,"rgb(36, 121, 108)"
10944,2020-04-24,Equatorial Guinea,1,1,84,"rgb(36, 121, 108)"
10945,2020-04-25,Equatorial Guinea,0,128,212,"rgb(36, 121, 108)"
10946,2020-04-26,Equatorial Guinea,0,2,214,"rgb(36, 121, 108)"
10947,2020-04-27,Equatorial Guinea,0,44,258,"rgb(36, 121, 108)"
10948,2020-04-28,Equatorial Guinea,0,0,258,"rgb(36, 121, 108)"
10949,2020-04-29,Equatorial Guinea,0,57,315,"rgb(36, 121, 108)"
10950,2020-04-30,Equatorial Guinea,0,0,315,"rgb(36, 121, 108)"
10951,2020-05-01,Equatorial Guinea,0,0,315,"rgb(36, 121, 108)"
10952,2020-05-02,Equatorial Guinea,0,0,315,"rgb(36, 121, 108)"
10953,2020-05-03,Equatorial Guinea,0,0,315,"rgb(36, 121, 108)"
10954,2020-05-04,Equatorial Guinea,0,0,315,"rgb(36, 121, 108)"
10955,2020-05-05,Equatorial Guinea,1,0,315,"rgb(36, 121, 108)"
10956,2020-05-06,Equatorial Guinea,2,124,439,"rgb(36, 121, 108)"
10957,2020-05-07,Equatorial Guinea,0,0,439,"rgb(36, 121, 108)"
10958,2020-05-08,Equatorial Guinea,0,0,439,"rgb(36, 121, 108)"
10959,2020-05-09,Equatorial Guinea,0,0,439,"rgb(36, 121, 108)"
10960,2020-05-10,Equatorial Guinea,0,0,439,"rgb(36, 121, 108)"
10961,2020-05-11,Equatorial Guinea,0,0,439,"rgb(36, 121, 108)"
10962,2020-05-12,Equatorial Guinea,0,0,439,"rgb(36, 121, 108)"
10963,2020-05-13,Equatorial Guinea,0,0,439,"rgb(36, 121, 108)"
10964,2020-05-14,Equatorial Guinea,2,83,522,"rgb(36, 121, 108)"
10965,2020-05-15,Equatorial Guinea,1,72,594,"rgb(36, 121, 108)"
10966,2020-05-16,Equatorial Guinea,0,0,594,"rgb(36, 121, 108)"
10967,2020-05-17,Equatorial Guinea,0,0,594,"rgb(36, 121, 108)"
10968,2020-05-18,Equatorial Guinea,0,0,594,"rgb(36, 121, 108)"
10969,2020-05-19,Equatorial Guinea,0,125,719,"rgb(36, 121, 108)"
10970,2020-05-20,Equatorial Guinea,0,171,890,"rgb(36, 121, 108)"
10971,2020-05-21,Equatorial Guinea,0,0,890,"rgb(36, 121, 108)"
10972,2020-05-22,Equatorial Guinea,3,13,903,"rgb(36, 121, 108)"
10973,2020-05-23,Equatorial Guinea,0,0,903,"rgb(36, 121, 108)"
10974,2020-05-24,Equatorial Guinea,2,140,1043,"rgb(36, 121, 108)"
10975,2020-05-25,Equatorial Guinea,0,0,1043,"rgb(36, 121, 108)"
10976,2020-05-26,Equatorial Guinea,0,0,1043,"rgb(36, 121, 108)"
10977,2020-05-27,Equatorial Guinea,0,0,1043,"rgb(36, 121, 108)"
10978,2020-05-28,Equatorial Guinea,0,0,1043,"rgb(36, 121, 108)"
10979,2020-05-29,Equatorial Guinea,0,0,1043,"rgb(36, 121, 108)"
10980,2020-05-30,Equatorial Guinea,0,0,1043,"rgb(36, 121, 108)"
10981,2020-05-31,Equatorial Guinea,0,263,1306,"rgb(36, 121, 108)"
10982,2020-06-01,Equatorial Guinea,0,0,1306,"rgb(36, 121, 108)"
10983,2020-06-02,Equatorial Guinea,0,0,1306,"rgb(36, 121, 108)"
10984,2020-06-03,Equatorial Guinea,0,0,1306,"rgb(36, 121, 108)"
10985,2020-06-04,Equatorial Guinea,0,0,1306,"rgb(36, 121, 108)"
10986,2020-06-05,Equatorial Guinea,0,0,1306,"rgb(36, 121, 108)"
10987,2020-06-06,Equatorial Guinea,0,0,1306,"rgb(36, 121, 108)"
10988,2020-06-07,Equatorial Guinea,0,0,1306,"rgb(36, 121, 108)"
10989,2020-06-08,Equatorial Guinea,0,0,1306,"rgb(36, 121, 108)"
10990,2020-06-09,Equatorial Guinea,0,0,1306,"rgb(36, 121, 108)"
10991,2020-06-10,Equatorial Guinea,0,0,1306,"rgb(36, 121, 108)"
10992,2020-06-11,Equatorial Guinea,0,0,1306,"rgb(36, 121, 108)"
10993,2020-06-12,Equatorial Guinea,0,0,1306,"rgb(36, 121, 108)"
10994,2020-06-13,Equatorial Guinea,0,0,1306,"rgb(36, 121, 108)"
10995,2020-06-14,Equatorial Guinea,0,0,1306,"rgb(36, 121, 108)"
10996,2020-06-15,Equatorial Guinea,0,0,1306,"rgb(36, 121, 108)"
10997,2020-06-16,Equatorial Guinea,0,0,1306,"rgb(36, 121, 108)"
10998,2020-06-17,Equatorial Guinea,0,0,1306,"rgb(36, 121, 108)"
10999,2020-06-18,Equatorial Guinea,0,0,1306,"rgb(36, 121, 108)"
11000,2020-06-19,Equatorial Guinea,0,0,1306,"rgb(36, 121, 108)"
11001,2020-06-20,Equatorial Guinea,20,358,1664,"rgb(36, 121, 108)"
11002,2020-06-21,Equatorial Guinea,0,0,1664,"rgb(36, 121, 108)"
11003,2020-06-22,Equatorial Guinea,0,0,1664,"rgb(36, 121, 108)"
11004,2020-06-23,Equatorial Guinea,0,337,2001,"rgb(36, 121, 108)"
11005,2020-06-24,Equatorial Guinea,0,0,2001,"rgb(36, 121, 108)"
11006,2020-06-25,Equatorial Guinea,0,0,2001,"rgb(36, 121, 108)"
11007,2020-06-26,Equatorial Guinea,0,0,2001,"rgb(36, 121, 108)"
11008,2020-06-27,Equatorial Guinea,0,0,2001,"rgb(36, 121, 108)"
11009,2020-06-28,Equatorial Guinea,0,0,2001,"rgb(36, 121, 108)"
11010,2020-06-29,Equatorial Guinea,0,0,2001,"rgb(36, 121, 108)"
11011,2020-06-30,Equatorial Guinea,0,0,2001,"rgb(36, 121, 108)"
11012,2020-07-01,Equatorial Guinea,0,0,2001,"rgb(36, 121, 108)"
11013,2020-07-02,Equatorial Guinea,0,0,2001,"rgb(36, 121, 108)"
11014,2020-07-03,Equatorial Guinea,19,1070,3071,"rgb(36, 121, 108)"
11015,2020-07-04,Equatorial Guinea,0,0,3071,"rgb(36, 121, 108)"
11016,2020-07-05,Equatorial Guinea,0,0,3071,"rgb(36, 121, 108)"
11017,2020-07-06,Equatorial Guinea,0,0,3071,"rgb(36, 121, 108)"
11018,2020-07-07,Equatorial Guinea,0,0,3071,"rgb(36, 121, 108)"
11019,2020-07-08,Equatorial Guinea,0,0,3071,"rgb(36, 121, 108)"
11020,2020-07-09,Equatorial Guinea,0,0,3071,"rgb(36, 121, 108)"
11021,2020-07-10,Equatorial Guinea,0,0,3071,"rgb(36, 121, 108)"
11022,2020-07-11,Equatorial Guinea,0,0,3071,"rgb(36, 121, 108)"
11023,2020-07-12,Equatorial Guinea,0,0,3071,"rgb(36, 121, 108)"
11024,2020-07-13,Equatorial Guinea,0,0,3071,"rgb(36, 121, 108)"
11025,2020-03-15,Guatemala,0,1,1,"rgb(218, 165, 27)"
11026,2020-03-16,Guatemala,1,0,1,"rgb(218, 165, 27)"
11027,2020-03-17,Guatemala,0,5,6,"rgb(218, 165, 27)"
11028,2020-03-18,Guatemala,0,0,6,"rgb(218, 165, 27)"
11029,2020-03-19,Guatemala,0,2,8,"rgb(218, 165, 27)"
11030,2020-03-20,Guatemala,0,1,9,"rgb(218, 165, 27)"
11031,2020-03-21,Guatemala,0,4,13,"rgb(218, 165, 27)"
11032,2020-03-22,Guatemala,0,4,17,"rgb(218, 165, 27)"
11033,2020-03-23,Guatemala,0,2,19,"rgb(218, 165, 27)"
11034,2020-03-24,Guatemala,0,1,20,"rgb(218, 165, 27)"
11035,2020-03-25,Guatemala,0,1,21,"rgb(218, 165, 27)"
11036,2020-03-26,Guatemala,0,3,24,"rgb(218, 165, 27)"
11037,2020-03-27,Guatemala,0,1,25,"rgb(218, 165, 27)"
11038,2020-03-28,Guatemala,0,7,32,"rgb(218, 165, 27)"
11039,2020-03-29,Guatemala,0,2,34,"rgb(218, 165, 27)"
11040,2020-03-30,Guatemala,0,2,36,"rgb(218, 165, 27)"
11041,2020-03-31,Guatemala,0,0,36,"rgb(218, 165, 27)"
11042,2020-04-01,Guatemala,0,2,38,"rgb(218, 165, 27)"
11043,2020-04-02,Guatemala,0,8,46,"rgb(218, 165, 27)"
11044,2020-04-03,Guatemala,0,1,47,"rgb(218, 165, 27)"
11045,2020-04-04,Guatemala,0,3,50,"rgb(218, 165, 27)"
11046,2020-04-05,Guatemala,1,11,61,"rgb(218, 165, 27)"
11047,2020-04-06,Guatemala,1,9,70,"rgb(218, 165, 27)"
11048,2020-04-07,Guatemala,0,4,74,"rgb(218, 165, 27)"
11049,2020-04-08,Guatemala,0,6,80,"rgb(218, 165, 27)"
11050,2020-04-09,Guatemala,0,7,87,"rgb(218, 165, 27)"
11051,2020-04-10,Guatemala,0,39,126,"rgb(218, 165, 27)"
11052,2020-04-11,Guatemala,0,11,137,"rgb(218, 165, 27)"
11053,2020-04-12,Guatemala,0,16,153,"rgb(218, 165, 27)"
11054,2020-04-13,Guatemala,2,3,156,"rgb(218, 165, 27)"
11055,2020-04-14,Guatemala,0,11,167,"rgb(218, 165, 27)"
11056,2020-04-15,Guatemala,0,13,180,"rgb(218, 165, 27)"
11057,2020-04-16,Guatemala,0,16,196,"rgb(218, 165, 27)"
11058,2020-04-17,Guatemala,2,18,214,"rgb(218, 165, 27)"
11059,2020-04-18,Guatemala,0,21,235,"rgb(218, 165, 27)"
11060,2020-04-19,Guatemala,0,22,257,"rgb(218, 165, 27)"
11061,2020-04-20,Guatemala,0,32,289,"rgb(218, 165, 27)"
11062,2020-04-21,Guatemala,0,5,294,"rgb(218, 165, 27)"
11063,2020-04-22,Guatemala,1,22,316,"rgb(218, 165, 27)"
11064,2020-04-23,Guatemala,2,26,342,"rgb(218, 165, 27)"
11065,2020-04-24,Guatemala,1,42,384,"rgb(218, 165, 27)"
11066,2020-04-25,Guatemala,0,46,430,"rgb(218, 165, 27)"
11067,2020-04-26,Guatemala,2,43,473,"rgb(218, 165, 27)"
11068,2020-04-27,Guatemala,2,27,500,"rgb(218, 165, 27)"
11069,2020-04-28,Guatemala,0,30,530,"rgb(218, 165, 27)"
11070,2020-04-29,Guatemala,1,27,557,"rgb(218, 165, 27)"
11071,2020-04-30,Guatemala,0,28,585,"rgb(218, 165, 27)"
11072,2020-05-01,Guatemala,0,14,599,"rgb(218, 165, 27)"
11073,2020-05-02,Guatemala,0,45,644,"rgb(218, 165, 27)"
11074,2020-05-03,Guatemala,1,44,688,"rgb(218, 165, 27)"
11075,2020-05-04,Guatemala,0,15,703,"rgb(218, 165, 27)"
11076,2020-05-05,Guatemala,2,27,730,"rgb(218, 165, 27)"
11077,2020-05-06,Guatemala,0,33,763,"rgb(218, 165, 27)"
11078,2020-05-07,Guatemala,2,35,798,"rgb(218, 165, 27)"
11079,2020-05-08,Guatemala,2,34,832,"rgb(218, 165, 27)"
11080,2020-05-09,Guatemala,1,68,900,"rgb(218, 165, 27)"
11081,2020-05-10,Guatemala,0,67,967,"rgb(218, 165, 27)"
11082,2020-05-11,Guatemala,2,85,1052,"rgb(218, 165, 27)"
11083,2020-05-12,Guatemala,0,62,1114,"rgb(218, 165, 27)"
11084,2020-05-13,Guatemala,1,85,1199,"rgb(218, 165, 27)"
11085,2020-05-14,Guatemala,2,143,1342,"rgb(218, 165, 27)"
11086,2020-05-15,Guatemala,0,176,1518,"rgb(218, 165, 27)"
11087,2020-05-16,Guatemala,1,125,1643,"rgb(218, 165, 27)"
11088,2020-05-17,Guatemala,3,120,1763,"rgb(218, 165, 27)"
11089,2020-05-18,Guatemala,2,149,1912,"rgb(218, 165, 27)"
11090,2020-05-19,Guatemala,3,89,2001,"rgb(218, 165, 27)"
11091,2020-05-20,Guatemala,5,132,2133,"rgb(218, 165, 27)"
11092,2020-05-21,Guatemala,2,132,2265,"rgb(218, 165, 27)"
11093,2020-05-22,Guatemala,3,247,2512,"rgb(218, 165, 27)"
11094,2020-05-23,Guatemala,3,231,2743,"rgb(218, 165, 27)"
11095,2020-05-24,Guatemala,4,311,3054,"rgb(218, 165, 27)"
11096,2020-05-25,Guatemala,3,370,3424,"rgb(218, 165, 27)"
11097,2020-05-26,Guatemala,1,336,3760,"rgb(218, 165, 27)"
11098,2020-05-27,Guatemala,4,194,3954,"rgb(218, 165, 27)"
11099,2020-05-28,Guatemala,5,191,4145,"rgb(218, 165, 27)"
11100,2020-05-29,Guatemala,12,203,4348,"rgb(218, 165, 27)"
11101,2020-05-30,Guatemala,10,259,4607,"rgb(218, 165, 27)"
11102,2020-05-31,Guatemala,12,132,4739,"rgb(218, 165, 27)"
11103,2020-06-01,Guatemala,6,348,5087,"rgb(218, 165, 27)"
11104,2020-06-02,Guatemala,8,249,5336,"rgb(218, 165, 27)"
11105,2020-06-03,Guatemala,7,250,5586,"rgb(218, 165, 27)"
11106,2020-06-04,Guatemala,20,174,5760,"rgb(218, 165, 27)"
11107,2020-06-05,Guatemala,15,394,6154,"rgb(218, 165, 27)"
11108,2020-06-06,Guatemala,58,331,6485,"rgb(218, 165, 27)"
11109,2020-06-07,Guatemala,14,307,6792,"rgb(218, 165, 27)"
11110,2020-06-08,Guatemala,22,263,7055,"rgb(218, 165, 27)"
11111,2020-06-09,Guatemala,15,447,7502,"rgb(218, 165, 27)"
11112,2020-06-10,Guatemala,22,364,7866,"rgb(218, 165, 27)"
11113,2020-06-11,Guatemala,27,355,8221,"rgb(218, 165, 27)"
11114,2020-06-12,Guatemala,18,340,8561,"rgb(218, 165, 27)"
11115,2020-06-13,Guatemala,17,421,8982,"rgb(218, 165, 27)"
11116,2020-06-14,Guatemala,16,509,9491,"rgb(218, 165, 27)"
11117,2020-06-15,Guatemala,17,354,9845,"rgb(218, 165, 27)"
11118,2020-06-16,Guatemala,15,427,10272,"rgb(218, 165, 27)"
11119,2020-06-17,Guatemala,19,434,10706,"rgb(218, 165, 27)"
11120,2020-06-18,Guatemala,14,545,11251,"rgb(218, 165, 27)"
11121,2020-06-19,Guatemala,17,617,11868,"rgb(218, 165, 27)"
11122,2020-06-20,Guatemala,34,641,12509,"rgb(218, 165, 27)"
11123,2020-06-21,Guatemala,31,246,12755,"rgb(218, 165, 27)"
11124,2020-06-22,Guatemala,17,390,13145,"rgb(218, 165, 27)"
11125,2020-06-23,Guatemala,16,624,13769,"rgb(218, 165, 27)"
11126,2020-06-24,Guatemala,35,771,14540,"rgb(218, 165, 27)"
11127,2020-06-25,Guatemala,19,279,14819,"rgb(218, 165, 27)"
11128,2020-06-26,Guatemala,22,800,15619,"rgb(218, 165, 27)"
11129,2020-06-27,Guatemala,49,209,15828,"rgb(218, 165, 27)"
11130,2020-06-28,Guatemala,34,569,16397,"rgb(218, 165, 27)"
11131,2020-06-29,Guatemala,21,533,16930,"rgb(218, 165, 27)"
11132,2020-06-30,Guatemala,19,479,17409,"rgb(218, 165, 27)"
11133,2020-07-01,Guatemala,27,687,18096,"rgb(218, 165, 27)"
11134,2020-07-02,Guatemala,44,915,19011,"rgb(218, 165, 27)"
11135,2020-07-03,Guatemala,26,1061,20072,"rgb(218, 165, 27)"
11136,2020-07-04,Guatemala,37,1221,21293,"rgb(218, 165, 27)"
11137,2020-07-05,Guatemala,40,1208,22501,"rgb(218, 165, 27)"
11138,2020-07-06,Guatemala,27,747,23248,"rgb(218, 165, 27)"
11139,2020-07-07,Guatemala,34,724,23972,"rgb(218, 165, 27)"
11140,2020-07-08,Guatemala,23,815,24787,"rgb(218, 165, 27)"
11141,2020-07-09,Guatemala,49,624,25411,"rgb(218, 165, 27)"
11142,2020-07-10,Guatemala,39,1247,26658,"rgb(218, 165, 27)"
11143,2020-07-11,Guatemala,47,961,27619,"rgb(218, 165, 27)"
11144,2020-07-12,Guatemala,33,979,28598,"rgb(218, 165, 27)"
11145,2020-07-13,Guatemala,47,757,29355,"rgb(218, 165, 27)"
11146,2020-03-19,Guam,0,3,3,"rgb(47, 138, 196)"
11147,2020-03-20,Guam,0,9,12,"rgb(47, 138, 196)"
11148,2020-03-21,Guam,0,2,14,"rgb(47, 138, 196)"
11149,2020-03-22,Guam,1,1,15,"rgb(47, 138, 196)"
11150,2020-03-23,Guam,0,12,27,"rgb(47, 138, 196)"
11151,2020-03-24,Guam,0,2,29,"rgb(47, 138, 196)"
11152,2020-03-25,Guam,0,3,32,"rgb(47, 138, 196)"
11153,2020-03-26,Guam,0,5,37,"rgb(47, 138, 196)"
11154,2020-03-27,Guam,0,12,49,"rgb(47, 138, 196)"
11155,2020-03-28,Guam,0,2,51,"rgb(47, 138, 196)"
11156,2020-03-29,Guam,0,4,55,"rgb(47, 138, 196)"
11157,2020-03-30,Guam,0,1,56,"rgb(47, 138, 196)"
11158,2020-03-31,Guam,0,4,60,"rgb(47, 138, 196)"
11159,2020-04-01,Guam,2,9,69,"rgb(47, 138, 196)"
11160,2020-04-02,Guam,0,8,77,"rgb(47, 138, 196)"
11161,2020-04-03,Guam,0,5,82,"rgb(47, 138, 196)"
11162,2020-04-04,Guam,1,5,87,"rgb(47, 138, 196)"
11163,2020-04-05,Guam,0,6,93,"rgb(47, 138, 196)"
11164,2020-04-06,Guam,0,17,110,"rgb(47, 138, 196)"
11165,2020-04-07,Guam,0,2,112,"rgb(47, 138, 196)"
11166,2020-04-08,Guam,0,9,121,"rgb(47, 138, 196)"
11167,2020-04-09,Guam,0,4,125,"rgb(47, 138, 196)"
11168,2020-04-10,Guam,0,3,128,"rgb(47, 138, 196)"
11169,2020-04-11,Guam,0,2,130,"rgb(47, 138, 196)"
11170,2020-04-12,Guam,1,3,133,"rgb(47, 138, 196)"
11171,2020-04-13,Guam,0,0,133,"rgb(47, 138, 196)"
11172,2020-04-14,Guam,0,1,134,"rgb(47, 138, 196)"
11173,2020-04-15,Guam,0,1,135,"rgb(47, 138, 196)"
11174,2020-04-16,Guam,0,0,135,"rgb(47, 138, 196)"
11175,2020-04-17,Guam,0,0,135,"rgb(47, 138, 196)"
11176,2020-04-18,Guam,0,1,136,"rgb(47, 138, 196)"
11177,2020-04-19,Guam,0,0,136,"rgb(47, 138, 196)"
11178,2020-04-20,Guam,0,0,136,"rgb(47, 138, 196)"
11179,2020-04-21,Guam,0,0,136,"rgb(47, 138, 196)"
11180,2020-04-22,Guam,0,0,136,"rgb(47, 138, 196)"
11181,2020-04-23,Guam,0,1,137,"rgb(47, 138, 196)"
11182,2020-04-24,Guam,0,3,140,"rgb(47, 138, 196)"
11183,2020-04-25,Guam,0,1,141,"rgb(47, 138, 196)"
11184,2020-04-26,Guam,0,0,141,"rgb(47, 138, 196)"
11185,2020-04-27,Guam,0,1,142,"rgb(47, 138, 196)"
11186,2020-04-28,Guam,0,2,144,"rgb(47, 138, 196)"
11187,2020-04-29,Guam,0,1,145,"rgb(47, 138, 196)"
11188,2020-04-30,Guam,0,0,145,"rgb(47, 138, 196)"
11189,2020-05-01,Guam,0,1,146,"rgb(47, 138, 196)"
11190,2020-05-02,Guam,0,0,146,"rgb(47, 138, 196)"
11191,2020-05-03,Guam,0,2,148,"rgb(47, 138, 196)"
11192,2020-05-04,Guam,0,1,149,"rgb(47, 138, 196)"
11193,2020-05-05,Guam,0,0,149,"rgb(47, 138, 196)"
11194,2020-05-06,Guam,0,0,149,"rgb(47, 138, 196)"
11195,2020-05-07,Guam,0,2,151,"rgb(47, 138, 196)"
11196,2020-05-08,Guam,0,0,151,"rgb(47, 138, 196)"
11197,2020-05-09,Guam,0,0,151,"rgb(47, 138, 196)"
11198,2020-05-10,Guam,0,0,151,"rgb(47, 138, 196)"
11199,2020-05-11,Guam,0,0,151,"rgb(47, 138, 196)"
11200,2020-05-12,Guam,0,1,152,"rgb(47, 138, 196)"
11201,2020-05-13,Guam,0,0,152,"rgb(47, 138, 196)"
11202,2020-05-14,Guam,0,0,152,"rgb(47, 138, 196)"
11203,2020-05-15,Guam,0,2,154,"rgb(47, 138, 196)"
11204,2020-05-16,Guam,0,0,154,"rgb(47, 138, 196)"
11205,2020-05-17,Guam,0,0,154,"rgb(47, 138, 196)"
11206,2020-05-18,Guam,0,0,154,"rgb(47, 138, 196)"
11207,2020-05-19,Guam,0,0,154,"rgb(47, 138, 196)"
11208,2020-05-20,Guam,0,0,154,"rgb(47, 138, 196)"
11209,2020-05-21,Guam,0,11,165,"rgb(47, 138, 196)"
11210,2020-05-22,Guam,0,0,165,"rgb(47, 138, 196)"
11211,2020-05-23,Guam,0,0,165,"rgb(47, 138, 196)"
11212,2020-05-24,Guam,0,1,166,"rgb(47, 138, 196)"
11213,2020-05-25,Guam,0,0,166,"rgb(47, 138, 196)"
11214,2020-05-26,Guam,0,0,166,"rgb(47, 138, 196)"
11215,2020-05-27,Guam,0,3,169,"rgb(47, 138, 196)"
11216,2020-05-28,Guam,0,2,171,"rgb(47, 138, 196)"
11217,2020-05-29,Guam,0,1,172,"rgb(47, 138, 196)"
11218,2020-05-30,Guam,0,0,172,"rgb(47, 138, 196)"
11219,2020-05-31,Guam,0,1,173,"rgb(47, 138, 196)"
11220,2020-06-01,Guam,0,2,175,"rgb(47, 138, 196)"
11221,2020-06-02,Guam,0,0,175,"rgb(47, 138, 196)"
11222,2020-06-03,Guam,0,2,177,"rgb(47, 138, 196)"
11223,2020-06-04,Guam,0,2,179,"rgb(47, 138, 196)"
11224,2020-06-05,Guam,0,0,179,"rgb(47, 138, 196)"
11225,2020-06-06,Guam,0,0,179,"rgb(47, 138, 196)"
11226,2020-06-07,Guam,0,0,179,"rgb(47, 138, 196)"
11227,2020-06-08,Guam,0,0,179,"rgb(47, 138, 196)"
11228,2020-06-09,Guam,0,1,180,"rgb(47, 138, 196)"
11229,2020-06-10,Guam,0,0,180,"rgb(47, 138, 196)"
11230,2020-06-11,Guam,0,2,182,"rgb(47, 138, 196)"
11231,2020-06-12,Guam,0,0,182,"rgb(47, 138, 196)"
11232,2020-06-13,Guam,0,3,185,"rgb(47, 138, 196)"
11233,2020-06-14,Guam,0,0,185,"rgb(47, 138, 196)"
11234,2020-06-15,Guam,0,0,185,"rgb(47, 138, 196)"
11235,2020-06-16,Guam,0,1,186,"rgb(47, 138, 196)"
11236,2020-06-17,Guam,0,2,188,"rgb(47, 138, 196)"
11237,2020-06-18,Guam,0,4,192,"rgb(47, 138, 196)"
11238,2020-06-19,Guam,0,8,200,"rgb(47, 138, 196)"
11239,2020-06-20,Guam,0,0,200,"rgb(47, 138, 196)"
11240,2020-06-21,Guam,0,22,222,"rgb(47, 138, 196)"
11241,2020-06-22,Guam,0,0,222,"rgb(47, 138, 196)"
11242,2020-06-23,Guam,0,3,225,"rgb(47, 138, 196)"
11243,2020-06-24,Guam,0,1,226,"rgb(47, 138, 196)"
11244,2020-06-25,Guam,0,5,231,"rgb(47, 138, 196)"
11245,2020-06-26,Guam,0,16,247,"rgb(47, 138, 196)"
11246,2020-06-27,Guam,0,1,248,"rgb(47, 138, 196)"
11247,2020-06-28,Guam,0,0,248,"rgb(47, 138, 196)"
11248,2020-06-29,Guam,0,5,253,"rgb(47, 138, 196)"
11249,2020-06-30,Guam,0,4,257,"rgb(47, 138, 196)"
11250,2020-07-01,Guam,0,10,267,"rgb(47, 138, 196)"
11251,2020-07-02,Guam,0,13,280,"rgb(47, 138, 196)"
11252,2020-07-03,Guam,0,6,286,"rgb(47, 138, 196)"
11253,2020-07-04,Guam,0,2,288,"rgb(47, 138, 196)"
11254,2020-07-05,Guam,0,0,288,"rgb(47, 138, 196)"
11255,2020-07-06,Guam,0,13,301,"rgb(47, 138, 196)"
11256,2020-07-07,Guam,0,2,303,"rgb(47, 138, 196)"
11257,2020-07-08,Guam,0,0,303,"rgb(47, 138, 196)"
11258,2020-07-09,Guam,0,6,309,"rgb(47, 138, 196)"
11259,2020-07-10,Guam,0,1,310,"rgb(47, 138, 196)"
11260,2020-07-11,Guam,0,2,312,"rgb(47, 138, 196)"
11261,2020-07-12,Guam,0,0,312,"rgb(47, 138, 196)"
11262,2020-07-13,Guam,0,0,312,"rgb(47, 138, 196)"
11263,2020-03-27,Guinea-Bissau,0,2,2,"rgb(118, 78, 159)"
11264,2020-03-28,Guinea-Bissau,0,0,2,"rgb(118, 78, 159)"
11265,2020-03-29,Guinea-Bissau,0,0,2,"rgb(118, 78, 159)"
11266,2020-03-30,Guinea-Bissau,0,0,2,"rgb(118, 78, 159)"
11267,2020-03-31,Guinea-Bissau,0,0,2,"rgb(118, 78, 159)"
11268,2020-04-01,Guinea-Bissau,0,6,8,"rgb(118, 78, 159)"
11269,2020-04-02,Guinea-Bissau,0,1,9,"rgb(118, 78, 159)"
11270,2020-04-03,Guinea-Bissau,0,0,9,"rgb(118, 78, 159)"
11271,2020-04-04,Guinea-Bissau,0,6,15,"rgb(118, 78, 159)"
11272,2020-04-05,Guinea-Bissau,0,3,18,"rgb(118, 78, 159)"
11273,2020-04-06,Guinea-Bissau,0,0,18,"rgb(118, 78, 159)"
11274,2020-04-07,Guinea-Bissau,0,15,33,"rgb(118, 78, 159)"
11275,2020-04-08,Guinea-Bissau,0,0,33,"rgb(118, 78, 159)"
11276,2020-04-09,Guinea-Bissau,0,0,33,"rgb(118, 78, 159)"
11277,2020-04-10,Guinea-Bissau,0,2,35,"rgb(118, 78, 159)"
11278,2020-04-11,Guinea-Bissau,0,0,35,"rgb(118, 78, 159)"
11279,2020-04-12,Guinea-Bissau,0,3,38,"rgb(118, 78, 159)"
11280,2020-04-13,Guinea-Bissau,0,1,39,"rgb(118, 78, 159)"
11281,2020-04-14,Guinea-Bissau,0,0,39,"rgb(118, 78, 159)"
11282,2020-04-15,Guinea-Bissau,0,1,40,"rgb(118, 78, 159)"
11283,2020-04-16,Guinea-Bissau,0,3,43,"rgb(118, 78, 159)"
11284,2020-04-17,Guinea-Bissau,0,3,46,"rgb(118, 78, 159)"
11285,2020-04-18,Guinea-Bissau,0,4,50,"rgb(118, 78, 159)"
11286,2020-04-19,Guinea-Bissau,0,0,50,"rgb(118, 78, 159)"
11287,2020-04-20,Guinea-Bissau,0,0,50,"rgb(118, 78, 159)"
11288,2020-04-21,Guinea-Bissau,0,0,50,"rgb(118, 78, 159)"
11289,2020-04-22,Guinea-Bissau,0,0,50,"rgb(118, 78, 159)"
11290,2020-04-23,Guinea-Bissau,0,0,50,"rgb(118, 78, 159)"
11291,2020-04-24,Guinea-Bissau,0,2,52,"rgb(118, 78, 159)"
11292,2020-04-25,Guinea-Bissau,0,0,52,"rgb(118, 78, 159)"
11293,2020-04-26,Guinea-Bissau,0,0,52,"rgb(118, 78, 159)"
11294,2020-04-27,Guinea-Bissau,1,1,53,"rgb(118, 78, 159)"
11295,2020-04-28,Guinea-Bissau,0,20,73,"rgb(118, 78, 159)"
11296,2020-04-29,Guinea-Bissau,0,0,73,"rgb(118, 78, 159)"
11297,2020-04-30,Guinea-Bissau,0,4,77,"rgb(118, 78, 159)"
11298,2020-05-01,Guinea-Bissau,0,128,205,"rgb(118, 78, 159)"
11299,2020-05-02,Guinea-Bissau,0,52,257,"rgb(118, 78, 159)"
11300,2020-05-03,Guinea-Bissau,0,0,257,"rgb(118, 78, 159)"
11301,2020-05-04,Guinea-Bissau,1,35,292,"rgb(118, 78, 159)"
11302,2020-05-05,Guinea-Bissau,0,121,413,"rgb(118, 78, 159)"
11303,2020-05-06,Guinea-Bissau,0,62,475,"rgb(118, 78, 159)"
11304,2020-05-07,Guinea-Bissau,0,0,475,"rgb(118, 78, 159)"
11305,2020-05-08,Guinea-Bissau,0,89,564,"rgb(118, 78, 159)"
11306,2020-05-09,Guinea-Bissau,0,30,594,"rgb(118, 78, 159)"
11307,2020-05-10,Guinea-Bissau,1,47,641,"rgb(118, 78, 159)"
11308,2020-05-11,Guinea-Bissau,0,85,726,"rgb(118, 78, 159)"
11309,2020-05-12,Guinea-Bissau,0,35,761,"rgb(118, 78, 159)"
11310,2020-05-13,Guinea-Bissau,0,59,820,"rgb(118, 78, 159)"
11311,2020-05-14,Guinea-Bissau,0,0,820,"rgb(118, 78, 159)"
11312,2020-05-15,Guinea-Bissau,0,93,913,"rgb(118, 78, 159)"
11313,2020-05-16,Guinea-Bissau,0,0,913,"rgb(118, 78, 159)"
11314,2020-05-17,Guinea-Bissau,0,0,913,"rgb(118, 78, 159)"
11315,2020-05-18,Guinea-Bissau,1,77,990,"rgb(118, 78, 159)"
11316,2020-05-19,Guinea-Bissau,0,0,990,"rgb(118, 78, 159)"
11317,2020-05-20,Guinea-Bissau,2,48,1038,"rgb(118, 78, 159)"
11318,2020-05-21,Guinea-Bissau,0,0,1038,"rgb(118, 78, 159)"
11319,2020-05-22,Guinea-Bissau,0,51,1089,"rgb(118, 78, 159)"
11320,2020-05-23,Guinea-Bissau,0,0,1089,"rgb(118, 78, 159)"
11321,2020-05-24,Guinea-Bissau,0,25,1114,"rgb(118, 78, 159)"
11322,2020-05-25,Guinea-Bissau,0,59,1173,"rgb(118, 78, 159)"
11323,2020-05-26,Guinea-Bissau,0,0,1173,"rgb(118, 78, 159)"
11324,2020-05-27,Guinea-Bissau,0,0,1173,"rgb(118, 78, 159)"
11325,2020-05-28,Guinea-Bissau,1,5,1178,"rgb(118, 78, 159)"
11326,2020-05-29,Guinea-Bissau,0,0,1178,"rgb(118, 78, 159)"
11327,2020-05-30,Guinea-Bissau,1,78,1256,"rgb(118, 78, 159)"
11328,2020-05-31,Guinea-Bissau,0,0,1256,"rgb(118, 78, 159)"
11329,2020-06-01,Guinea-Bissau,0,66,1322,"rgb(118, 78, 159)"
11330,2020-06-02,Guinea-Bissau,0,17,1339,"rgb(118, 78, 159)"
11331,2020-06-03,Guinea-Bissau,0,0,1339,"rgb(118, 78, 159)"
11332,2020-06-04,Guinea-Bissau,0,0,1339,"rgb(118, 78, 159)"
11333,2020-06-05,Guinea-Bissau,1,7,1346,"rgb(118, 78, 159)"
11334,2020-06-06,Guinea-Bissau,3,22,1368,"rgb(118, 78, 159)"
11335,2020-06-07,Guinea-Bissau,0,0,1368,"rgb(118, 78, 159)"
11336,2020-06-08,Guinea-Bissau,0,0,1368,"rgb(118, 78, 159)"
11337,2020-06-09,Guinea-Bissau,0,21,1389,"rgb(118, 78, 159)"
11338,2020-06-10,Guinea-Bissau,0,0,1389,"rgb(118, 78, 159)"
11339,2020-06-11,Guinea-Bissau,0,0,1389,"rgb(118, 78, 159)"
11340,2020-06-12,Guinea-Bissau,0,0,1389,"rgb(118, 78, 159)"
11341,2020-06-13,Guinea-Bissau,0,0,1389,"rgb(118, 78, 159)"
11342,2020-06-14,Guinea-Bissau,3,71,1460,"rgb(118, 78, 159)"
11343,2020-06-15,Guinea-Bissau,0,0,1460,"rgb(118, 78, 159)"
11344,2020-06-16,Guinea-Bissau,0,0,1460,"rgb(118, 78, 159)"
11345,2020-06-17,Guinea-Bissau,0,32,1492,"rgb(118, 78, 159)"
11346,2020-06-18,Guinea-Bissau,0,0,1492,"rgb(118, 78, 159)"
11347,2020-06-19,Guinea-Bissau,0,20,1512,"rgb(118, 78, 159)"
11348,2020-06-20,Guinea-Bissau,0,0,1512,"rgb(118, 78, 159)"
11349,2020-06-21,Guinea-Bissau,2,29,1541,"rgb(118, 78, 159)"
11350,2020-06-22,Guinea-Bissau,0,0,1541,"rgb(118, 78, 159)"
11351,2020-06-23,Guinea-Bissau,2,15,1556,"rgb(118, 78, 159)"
11352,2020-06-24,Guinea-Bissau,0,0,1556,"rgb(118, 78, 159)"
11353,2020-06-25,Guinea-Bissau,0,0,1556,"rgb(118, 78, 159)"
11354,2020-06-26,Guinea-Bissau,0,0,1556,"rgb(118, 78, 159)"
11355,2020-06-27,Guinea-Bissau,0,0,1556,"rgb(118, 78, 159)"
11356,2020-06-28,Guinea-Bissau,2,58,1614,"rgb(118, 78, 159)"
11357,2020-06-29,Guinea-Bissau,0,0,1614,"rgb(118, 78, 159)"
11358,2020-06-30,Guinea-Bissau,0,0,1614,"rgb(118, 78, 159)"
11359,2020-07-01,Guinea-Bissau,3,40,1654,"rgb(118, 78, 159)"
11360,2020-07-02,Guinea-Bissau,0,0,1654,"rgb(118, 78, 159)"
11361,2020-07-03,Guinea-Bissau,0,0,1654,"rgb(118, 78, 159)"
11362,2020-07-04,Guinea-Bissau,0,56,1710,"rgb(118, 78, 159)"
11363,2020-07-05,Guinea-Bissau,1,55,1765,"rgb(118, 78, 159)"
11364,2020-07-06,Guinea-Bissau,0,0,1765,"rgb(118, 78, 159)"
11365,2020-07-07,Guinea-Bissau,0,0,1765,"rgb(118, 78, 159)"
11366,2020-07-08,Guinea-Bissau,0,25,1790,"rgb(118, 78, 159)"
11367,2020-07-09,Guinea-Bissau,0,0,1790,"rgb(118, 78, 159)"
11368,2020-07-10,Guinea-Bissau,0,0,1790,"rgb(118, 78, 159)"
11369,2020-07-11,Guinea-Bissau,0,0,1790,"rgb(118, 78, 159)"
11370,2020-07-12,Guinea-Bissau,0,52,1842,"rgb(118, 78, 159)"
11371,2020-07-13,Guinea-Bissau,0,0,1842,"rgb(118, 78, 159)"
11372,2020-03-13,Guyana,1,1,1,"rgb(237, 100, 90)"
11373,2020-03-16,Guyana,0,3,4,"rgb(237, 100, 90)"
11374,2020-03-17,Guyana,0,0,4,"rgb(237, 100, 90)"
11375,2020-03-18,Guyana,0,0,4,"rgb(237, 100, 90)"
11376,2020-03-19,Guyana,0,1,5,"rgb(237, 100, 90)"
11377,2020-03-20,Guyana,0,0,5,"rgb(237, 100, 90)"
11378,2020-03-21,Guyana,0,0,5,"rgb(237, 100, 90)"
11379,2020-03-22,Guyana,0,0,5,"rgb(237, 100, 90)"
11380,2020-03-23,Guyana,0,0,5,"rgb(237, 100, 90)"
11381,2020-03-24,Guyana,0,0,5,"rgb(237, 100, 90)"
11382,2020-03-25,Guyana,0,0,5,"rgb(237, 100, 90)"
11383,2020-03-26,Guyana,0,0,5,"rgb(237, 100, 90)"
11384,2020-03-27,Guyana,0,0,5,"rgb(237, 100, 90)"
11385,2020-03-28,Guyana,0,0,5,"rgb(237, 100, 90)"
11386,2020-03-29,Guyana,0,3,8,"rgb(237, 100, 90)"
11387,2020-03-30,Guyana,0,0,8,"rgb(237, 100, 90)"
11388,2020-03-31,Guyana,0,0,8,"rgb(237, 100, 90)"
11389,2020-04-01,Guyana,1,4,12,"rgb(237, 100, 90)"
11390,2020-04-02,Guyana,2,7,19,"rgb(237, 100, 90)"
11391,2020-04-03,Guyana,0,0,19,"rgb(237, 100, 90)"
11392,2020-04-04,Guyana,0,4,23,"rgb(237, 100, 90)"
11393,2020-04-05,Guyana,0,1,24,"rgb(237, 100, 90)"
11394,2020-04-06,Guyana,0,5,29,"rgb(237, 100, 90)"
11395,2020-04-07,Guyana,1,2,31,"rgb(237, 100, 90)"
11396,2020-04-08,Guyana,0,2,33,"rgb(237, 100, 90)"
11397,2020-04-09,Guyana,1,4,37,"rgb(237, 100, 90)"
11398,2020-04-10,Guyana,0,0,37,"rgb(237, 100, 90)"
11399,2020-04-11,Guyana,0,3,40,"rgb(237, 100, 90)"
11400,2020-04-12,Guyana,0,5,45,"rgb(237, 100, 90)"
11401,2020-04-13,Guyana,0,0,45,"rgb(237, 100, 90)"
11402,2020-04-14,Guyana,0,2,47,"rgb(237, 100, 90)"
11403,2020-04-15,Guyana,0,1,48,"rgb(237, 100, 90)"
11404,2020-04-16,Guyana,0,7,55,"rgb(237, 100, 90)"
11405,2020-04-17,Guyana,0,2,57,"rgb(237, 100, 90)"
11406,2020-04-18,Guyana,0,6,63,"rgb(237, 100, 90)"
11407,2020-04-19,Guyana,1,0,63,"rgb(237, 100, 90)"
11408,2020-04-20,Guyana,0,2,65,"rgb(237, 100, 90)"
11409,2020-04-21,Guyana,0,1,66,"rgb(237, 100, 90)"
11410,2020-04-22,Guyana,0,1,67,"rgb(237, 100, 90)"
11411,2020-04-23,Guyana,0,0,67,"rgb(237, 100, 90)"
11412,2020-04-24,Guyana,0,3,70,"rgb(237, 100, 90)"
11413,2020-04-25,Guyana,1,3,73,"rgb(237, 100, 90)"
11414,2020-04-26,Guyana,0,1,74,"rgb(237, 100, 90)"
11415,2020-04-27,Guyana,0,0,74,"rgb(237, 100, 90)"
11416,2020-04-28,Guyana,0,0,74,"rgb(237, 100, 90)"
11417,2020-04-29,Guyana,0,1,75,"rgb(237, 100, 90)"
11418,2020-04-30,Guyana,0,3,78,"rgb(237, 100, 90)"
11419,2020-05-01,Guyana,1,4,82,"rgb(237, 100, 90)"
11420,2020-05-02,Guyana,0,0,82,"rgb(237, 100, 90)"
11421,2020-05-03,Guyana,0,0,82,"rgb(237, 100, 90)"
11422,2020-05-04,Guyana,0,0,82,"rgb(237, 100, 90)"
11423,2020-05-05,Guyana,0,10,92,"rgb(237, 100, 90)"
11424,2020-05-06,Guyana,1,1,93,"rgb(237, 100, 90)"
11425,2020-05-07,Guyana,0,0,93,"rgb(237, 100, 90)"
11426,2020-05-08,Guyana,0,0,93,"rgb(237, 100, 90)"
11427,2020-05-09,Guyana,0,1,94,"rgb(237, 100, 90)"
11428,2020-05-10,Guyana,0,3,97,"rgb(237, 100, 90)"
11429,2020-05-11,Guyana,0,7,104,"rgb(237, 100, 90)"
11430,2020-05-12,Guyana,0,5,109,"rgb(237, 100, 90)"
11431,2020-05-13,Guyana,0,4,113,"rgb(237, 100, 90)"
11432,2020-05-14,Guyana,0,0,113,"rgb(237, 100, 90)"
11433,2020-05-15,Guyana,0,0,113,"rgb(237, 100, 90)"
11434,2020-05-16,Guyana,0,3,116,"rgb(237, 100, 90)"
11435,2020-05-17,Guyana,0,1,117,"rgb(237, 100, 90)"
11436,2020-05-18,Guyana,0,0,117,"rgb(237, 100, 90)"
11437,2020-05-19,Guyana,0,7,124,"rgb(237, 100, 90)"
11438,2020-05-20,Guyana,0,1,125,"rgb(237, 100, 90)"
11439,2020-05-21,Guyana,0,0,125,"rgb(237, 100, 90)"
11440,2020-05-22,Guyana,0,2,127,"rgb(237, 100, 90)"
11441,2020-05-23,Guyana,0,0,127,"rgb(237, 100, 90)"
11442,2020-05-24,Guyana,0,0,127,"rgb(237, 100, 90)"
11443,2020-05-25,Guyana,0,8,135,"rgb(237, 100, 90)"
11444,2020-05-26,Guyana,1,2,137,"rgb(237, 100, 90)"
11445,2020-05-27,Guyana,0,2,139,"rgb(237, 100, 90)"
11446,2020-05-28,Guyana,0,0,139,"rgb(237, 100, 90)"
11447,2020-05-29,Guyana,0,11,150,"rgb(237, 100, 90)"
11448,2020-05-30,Guyana,0,0,150,"rgb(237, 100, 90)"
11449,2020-05-31,Guyana,1,2,152,"rgb(237, 100, 90)"
11450,2020-06-01,Guyana,0,1,153,"rgb(237, 100, 90)"
11451,2020-06-02,Guyana,0,0,153,"rgb(237, 100, 90)"
11452,2020-06-03,Guyana,0,0,153,"rgb(237, 100, 90)"
11453,2020-06-04,Guyana,0,0,153,"rgb(237, 100, 90)"
11454,2020-06-05,Guyana,0,0,153,"rgb(237, 100, 90)"
11455,2020-06-06,Guyana,0,0,153,"rgb(237, 100, 90)"
11456,2020-06-07,Guyana,0,1,154,"rgb(237, 100, 90)"
11457,2020-06-08,Guyana,0,0,154,"rgb(237, 100, 90)"
11458,2020-06-09,Guyana,0,0,154,"rgb(237, 100, 90)"
11459,2020-06-10,Guyana,0,2,156,"rgb(237, 100, 90)"
11460,2020-06-11,Guyana,0,0,156,"rgb(237, 100, 90)"
11461,2020-06-12,Guyana,0,2,158,"rgb(237, 100, 90)"
11462,2020-06-13,Guyana,0,1,159,"rgb(237, 100, 90)"
11463,2020-06-14,Guyana,0,0,159,"rgb(237, 100, 90)"
11464,2020-06-15,Guyana,0,0,159,"rgb(237, 100, 90)"
11465,2020-06-16,Guyana,0,0,159,"rgb(237, 100, 90)"
11466,2020-06-17,Guyana,0,12,171,"rgb(237, 100, 90)"
11467,2020-06-18,Guyana,0,0,171,"rgb(237, 100, 90)"
11468,2020-06-19,Guyana,0,12,183,"rgb(237, 100, 90)"
11469,2020-06-20,Guyana,0,0,183,"rgb(237, 100, 90)"
11470,2020-06-21,Guyana,0,0,183,"rgb(237, 100, 90)"
11471,2020-06-22,Guyana,0,1,184,"rgb(237, 100, 90)"
11472,2020-06-23,Guyana,0,21,205,"rgb(237, 100, 90)"
11473,2020-06-24,Guyana,0,1,206,"rgb(237, 100, 90)"
11474,2020-06-25,Guyana,0,3,209,"rgb(237, 100, 90)"
11475,2020-06-26,Guyana,0,6,215,"rgb(237, 100, 90)"
11476,2020-06-27,Guyana,0,15,230,"rgb(237, 100, 90)"
11477,2020-06-28,Guyana,0,0,230,"rgb(237, 100, 90)"
11478,2020-06-29,Guyana,0,0,230,"rgb(237, 100, 90)"
11479,2020-06-30,Guyana,0,5,235,"rgb(237, 100, 90)"
11480,2020-07-01,Guyana,0,10,245,"rgb(237, 100, 90)"
11481,2020-07-02,Guyana,1,3,248,"rgb(237, 100, 90)"
11482,2020-07-03,Guyana,1,2,250,"rgb(237, 100, 90)"
11483,2020-07-04,Guyana,0,6,256,"rgb(237, 100, 90)"
11484,2020-07-05,Guyana,0,16,272,"rgb(237, 100, 90)"
11485,2020-07-06,Guyana,1,1,273,"rgb(237, 100, 90)"
11486,2020-07-07,Guyana,1,5,278,"rgb(237, 100, 90)"
11487,2020-07-08,Guyana,0,7,285,"rgb(237, 100, 90)"
11488,2020-07-09,Guyana,0,0,285,"rgb(237, 100, 90)"
11489,2020-07-10,Guyana,0,1,286,"rgb(237, 100, 90)"
11490,2020-07-11,Guyana,0,4,290,"rgb(237, 100, 90)"
11491,2020-07-12,Guyana,1,1,291,"rgb(237, 100, 90)"
11492,2020-07-13,Guyana,0,6,297,"rgb(237, 100, 90)"
11493,2020-03-12,Honduras,0,2,2,"rgb(165, 170, 153)"
11494,2020-03-14,Honduras,0,1,3,"rgb(165, 170, 153)"
11495,2020-03-16,Honduras,0,3,6,"rgb(165, 170, 153)"
11496,2020-03-17,Honduras,0,2,8,"rgb(165, 170, 153)"
11497,2020-03-18,Honduras,0,1,9,"rgb(165, 170, 153)"
11498,2020-03-19,Honduras,0,3,12,"rgb(165, 170, 153)"
11499,2020-03-20,Honduras,0,12,24,"rgb(165, 170, 153)"
11500,2020-03-21,Honduras,0,0,24,"rgb(165, 170, 153)"
11501,2020-03-22,Honduras,0,2,26,"rgb(165, 170, 153)"
11502,2020-03-23,Honduras,0,1,27,"rgb(165, 170, 153)"
11503,2020-03-24,Honduras,0,3,30,"rgb(165, 170, 153)"
11504,2020-03-25,Honduras,0,6,36,"rgb(165, 170, 153)"
11505,2020-03-26,Honduras,0,16,52,"rgb(165, 170, 153)"
11506,2020-03-27,Honduras,1,15,67,"rgb(165, 170, 153)"
11507,2020-03-28,Honduras,0,28,95,"rgb(165, 170, 153)"
11508,2020-03-29,Honduras,1,15,110,"rgb(165, 170, 153)"
11509,2020-03-30,Honduras,1,29,139,"rgb(165, 170, 153)"
11510,2020-03-31,Honduras,4,2,141,"rgb(165, 170, 153)"
11511,2020-04-01,Honduras,3,31,172,"rgb(165, 170, 153)"
11512,2020-04-02,Honduras,4,47,219,"rgb(165, 170, 153)"
11513,2020-04-03,Honduras,1,3,222,"rgb(165, 170, 153)"
11514,2020-04-04,Honduras,0,42,264,"rgb(165, 170, 153)"
11515,2020-04-05,Honduras,7,4,268,"rgb(165, 170, 153)"
11516,2020-04-06,Honduras,0,30,298,"rgb(165, 170, 153)"
11517,2020-04-07,Honduras,0,7,305,"rgb(165, 170, 153)"
11518,2020-04-08,Honduras,0,7,312,"rgb(165, 170, 153)"
11519,2020-04-09,Honduras,1,31,343,"rgb(165, 170, 153)"
11520,2020-04-10,Honduras,0,39,382,"rgb(165, 170, 153)"
11521,2020-04-11,Honduras,1,10,392,"rgb(165, 170, 153)"
11522,2020-04-12,Honduras,1,1,393,"rgb(165, 170, 153)"
11523,2020-04-13,Honduras,0,4,397,"rgb(165, 170, 153)"
11524,2020-04-14,Honduras,1,10,407,"rgb(165, 170, 153)"
11525,2020-04-15,Honduras,5,12,419,"rgb(165, 170, 153)"
11526,2020-04-16,Honduras,4,7,426,"rgb(165, 170, 153)"
11527,2020-04-17,Honduras,6,16,442,"rgb(165, 170, 153)"
11528,2020-04-18,Honduras,5,15,457,"rgb(165, 170, 153)"
11529,2020-04-19,Honduras,0,15,472,"rgb(165, 170, 153)"
11530,2020-04-20,Honduras,0,5,477,"rgb(165, 170, 153)"
11531,2020-04-21,Honduras,0,17,494,"rgb(165, 170, 153)"
11532,2020-04-22,Honduras,0,16,510,"rgb(165, 170, 153)"
11533,2020-04-23,Honduras,1,9,519,"rgb(165, 170, 153)"
11534,2020-04-24,Honduras,0,0,519,"rgb(165, 170, 153)"
11535,2020-04-25,Honduras,0,72,591,"rgb(165, 170, 153)"
11536,2020-04-26,Honduras,12,36,627,"rgb(165, 170, 153)"
11537,2020-04-27,Honduras,2,34,661,"rgb(165, 170, 153)"
11538,2020-04-28,Honduras,0,32,693,"rgb(165, 170, 153)"
11539,2020-04-29,Honduras,5,45,738,"rgb(165, 170, 153)"
11540,2020-04-30,Honduras,5,33,771,"rgb(165, 170, 153)"
11541,2020-05-01,Honduras,4,33,804,"rgb(165, 170, 153)"
11542,2020-05-02,Honduras,0,95,899,"rgb(165, 170, 153)"
11543,2020-05-03,Honduras,1,111,1010,"rgb(165, 170, 153)"
11544,2020-05-04,Honduras,6,45,1055,"rgb(165, 170, 153)"
11545,2020-05-05,Honduras,0,123,1178,"rgb(165, 170, 153)"
11546,2020-05-06,Honduras,11,92,1270,"rgb(165, 170, 153)"
11547,2020-05-07,Honduras,6,191,1461,"rgb(165, 170, 153)"
11548,2020-05-08,Honduras,6,224,1685,"rgb(165, 170, 153)"
11549,2020-05-09,Honduras,2,86,1771,"rgb(165, 170, 153)"
11550,2020-05-10,Honduras,1,59,1830,"rgb(165, 170, 153)"
11551,2020-05-11,Honduras,0,142,1972,"rgb(165, 170, 153)"
11552,2020-05-12,Honduras,8,34,2006,"rgb(165, 170, 153)"
11553,2020-05-13,Honduras,5,74,2080,"rgb(165, 170, 153)"
11554,2020-05-14,Honduras,2,175,2255,"rgb(165, 170, 153)"
11555,2020-05-15,Honduras,10,63,2318,"rgb(165, 170, 153)"
11556,2020-05-16,Honduras,1,142,2460,"rgb(165, 170, 153)"
11557,2020-05-17,Honduras,4,105,2565,"rgb(165, 170, 153)"
11558,2020-05-18,Honduras,4,81,2646,"rgb(165, 170, 153)"
11559,2020-05-19,Honduras,4,152,2798,"rgb(165, 170, 153)"
11560,2020-05-20,Honduras,1,157,2955,"rgb(165, 170, 153)"
11561,2020-05-21,Honduras,4,145,3100,"rgb(165, 170, 153)"
11562,2020-05-22,Honduras,5,104,3204,"rgb(165, 170, 153)"
11563,2020-05-23,Honduras,11,273,3477,"rgb(165, 170, 153)"
11564,2020-05-24,Honduras,7,266,3743,"rgb(165, 170, 153)"
11565,2020-05-25,Honduras,6,207,3950,"rgb(165, 170, 153)"
11566,2020-05-26,Honduras,2,239,4189,"rgb(165, 170, 153)"
11567,2020-05-27,Honduras,6,212,4401,"rgb(165, 170, 153)"
11568,2020-05-28,Honduras,6,239,4640,"rgb(165, 170, 153)"
11569,2020-05-29,Honduras,2,112,4752,"rgb(165, 170, 153)"
11570,2020-05-30,Honduras,3,134,4886,"rgb(165, 170, 153)"
11571,2020-05-31,Honduras,2,208,5094,"rgb(165, 170, 153)"
11572,2020-06-01,Honduras,11,108,5202,"rgb(165, 170, 153)"
11573,2020-06-02,Honduras,5,160,5362,"rgb(165, 170, 153)"
11574,2020-06-03,Honduras,8,165,5527,"rgb(165, 170, 153)"
11575,2020-06-04,Honduras,9,163,5690,"rgb(165, 170, 153)"
11576,2020-06-05,Honduras,9,190,5880,"rgb(165, 170, 153)"
11577,2020-06-06,Honduras,5,91,5971,"rgb(165, 170, 153)"
11578,2020-06-07,Honduras,2,184,6155,"rgb(165, 170, 153)"
11579,2020-06-08,Honduras,8,172,6327,"rgb(165, 170, 153)"
11580,2020-06-09,Honduras,4,123,6450,"rgb(165, 170, 153)"
11581,2020-06-10,Honduras,9,485,6935,"rgb(165, 170, 153)"
11582,2020-06-11,Honduras,19,425,7360,"rgb(165, 170, 153)"
11583,2020-06-12,Honduras,4,309,7669,"rgb(165, 170, 153)"
11584,2020-06-13,Honduras,12,463,8132,"rgb(165, 170, 153)"
11585,2020-06-14,Honduras,4,323,8455,"rgb(165, 170, 153)"
11586,2020-06-15,Honduras,2,403,8858,"rgb(165, 170, 153)"
11587,2020-06-16,Honduras,10,320,9178,"rgb(165, 170, 153)"
11588,2020-06-17,Honduras,8,478,9656,"rgb(165, 170, 153)"
11589,2020-06-18,Honduras,6,643,10299,"rgb(165, 170, 153)"
11590,2020-06-19,Honduras,7,440,10739,"rgb(165, 170, 153)"
11591,2020-06-20,Honduras,6,519,11258,"rgb(165, 170, 153)"
11592,2020-06-21,Honduras,9,992,12250,"rgb(165, 170, 153)"
11593,2020-06-22,Honduras,5,519,12769,"rgb(165, 170, 153)"
11594,2020-06-23,Honduras,32,587,13356,"rgb(165, 170, 153)"
11595,2020-06-24,Honduras,10,587,13943,"rgb(165, 170, 153)"
11596,2020-06-25,Honduras,12,628,14571,"rgb(165, 170, 153)"
11597,2020-06-26,Honduras,9,795,15366,"rgb(165, 170, 153)"
11598,2020-06-27,Honduras,45,628,15994,"rgb(165, 170, 153)"
11599,2020-06-28,Honduras,8,1013,17007,"rgb(165, 170, 153)"
11600,2020-06-29,Honduras,0,1075,18082,"rgb(165, 170, 153)"
11601,2020-06-30,Honduras,6,736,18818,"rgb(165, 170, 153)"
11602,2020-07-01,Honduras,12,740,19558,"rgb(165, 170, 153)"
11603,2020-07-02,Honduras,45,704,20262,"rgb(165, 170, 153)"
11604,2020-07-03,Honduras,49,858,21120,"rgb(165, 170, 153)"
11605,2020-07-04,Honduras,14,996,22116,"rgb(165, 170, 153)"
11606,2020-07-05,Honduras,24,805,22921,"rgb(165, 170, 153)"
11607,2020-07-06,Honduras,10,1022,23943,"rgb(165, 170, 153)"
11608,2020-07-07,Honduras,17,722,24665,"rgb(165, 170, 153)"
11609,2020-07-08,Honduras,21,763,25428,"rgb(165, 170, 153)"
11610,2020-07-09,Honduras,17,550,25978,"rgb(165, 170, 153)"
11611,2020-07-10,Honduras,10,406,26384,"rgb(165, 170, 153)"
11612,2020-07-11,Honduras,46,669,27053,"rgb(165, 170, 153)"
11613,2020-07-12,Honduras,21,530,27583,"rgb(165, 170, 153)"
11614,2020-07-13,Honduras,3,507,28090,"rgb(165, 170, 153)"
11615,2019-12-31,Croatia,0,0,0,"rgb(27,158,119)"
11616,2020-01-01,Croatia,0,0,0,"rgb(27,158,119)"
11617,2020-01-02,Croatia,0,0,0,"rgb(27,158,119)"
11618,2020-01-03,Croatia,0,0,0,"rgb(27,158,119)"
11619,2020-01-04,Croatia,0,0,0,"rgb(27,158,119)"
11620,2020-01-05,Croatia,0,0,0,"rgb(27,158,119)"
11621,2020-01-06,Croatia,0,0,0,"rgb(27,158,119)"
11622,2020-01-07,Croatia,0,0,0,"rgb(27,158,119)"
11623,2020-01-08,Croatia,0,0,0,"rgb(27,158,119)"
11624,2020-01-09,Croatia,0,0,0,"rgb(27,158,119)"
11625,2020-01-10,Croatia,0,0,0,"rgb(27,158,119)"
11626,2020-01-11,Croatia,0,0,0,"rgb(27,158,119)"
11627,2020-01-12,Croatia,0,0,0,"rgb(27,158,119)"
11628,2020-01-13,Croatia,0,0,0,"rgb(27,158,119)"
11629,2020-01-14,Croatia,0,0,0,"rgb(27,158,119)"
11630,2020-01-15,Croatia,0,0,0,"rgb(27,158,119)"
11631,2020-01-16,Croatia,0,0,0,"rgb(27,158,119)"
11632,2020-01-17,Croatia,0,0,0,"rgb(27,158,119)"
11633,2020-01-18,Croatia,0,0,0,"rgb(27,158,119)"
11634,2020-01-19,Croatia,0,0,0,"rgb(27,158,119)"
11635,2020-01-20,Croatia,0,0,0,"rgb(27,158,119)"
11636,2020-01-21,Croatia,0,0,0,"rgb(27,158,119)"
11637,2020-01-22,Croatia,0,0,0,"rgb(27,158,119)"
11638,2020-01-23,Croatia,0,0,0,"rgb(27,158,119)"
11639,2020-01-24,Croatia,0,0,0,"rgb(27,158,119)"
11640,2020-01-25,Croatia,0,0,0,"rgb(27,158,119)"
11641,2020-01-26,Croatia,0,0,0,"rgb(27,158,119)"
11642,2020-01-27,Croatia,0,0,0,"rgb(27,158,119)"
11643,2020-01-28,Croatia,0,0,0,"rgb(27,158,119)"
11644,2020-01-29,Croatia,0,0,0,"rgb(27,158,119)"
11645,2020-01-30,Croatia,0,0,0,"rgb(27,158,119)"
11646,2020-01-31,Croatia,0,0,0,"rgb(27,158,119)"
11647,2020-02-01,Croatia,0,0,0,"rgb(27,158,119)"
11648,2020-02-02,Croatia,0,0,0,"rgb(27,158,119)"
11649,2020-02-03,Croatia,0,0,0,"rgb(27,158,119)"
11650,2020-02-04,Croatia,0,0,0,"rgb(27,158,119)"
11651,2020-02-05,Croatia,0,0,0,"rgb(27,158,119)"
11652,2020-02-06,Croatia,0,0,0,"rgb(27,158,119)"
11653,2020-02-07,Croatia,0,0,0,"rgb(27,158,119)"
11654,2020-02-08,Croatia,0,0,0,"rgb(27,158,119)"
11655,2020-02-09,Croatia,0,0,0,"rgb(27,158,119)"
11656,2020-02-10,Croatia,0,0,0,"rgb(27,158,119)"
11657,2020-02-11,Croatia,0,0,0,"rgb(27,158,119)"
11658,2020-02-12,Croatia,0,0,0,"rgb(27,158,119)"
11659,2020-02-13,Croatia,0,0,0,"rgb(27,158,119)"
11660,2020-02-14,Croatia,0,0,0,"rgb(27,158,119)"
11661,2020-02-15,Croatia,0,0,0,"rgb(27,158,119)"
11662,2020-02-16,Croatia,0,0,0,"rgb(27,158,119)"
11663,2020-02-17,Croatia,0,0,0,"rgb(27,158,119)"
11664,2020-02-18,Croatia,0,0,0,"rgb(27,158,119)"
11665,2020-02-19,Croatia,0,0,0,"rgb(27,158,119)"
11666,2020-02-20,Croatia,0,0,0,"rgb(27,158,119)"
11667,2020-02-21,Croatia,0,0,0,"rgb(27,158,119)"
11668,2020-02-22,Croatia,0,0,0,"rgb(27,158,119)"
11669,2020-02-23,Croatia,0,0,0,"rgb(27,158,119)"
11670,2020-02-24,Croatia,0,0,0,"rgb(27,158,119)"
11671,2020-02-25,Croatia,0,0,0,"rgb(27,158,119)"
11672,2020-02-26,Croatia,0,1,1,"rgb(27,158,119)"
11673,2020-02-27,Croatia,0,1,2,"rgb(27,158,119)"
11674,2020-02-28,Croatia,0,1,3,"rgb(27,158,119)"
11675,2020-02-29,Croatia,0,2,5,"rgb(27,158,119)"
11676,2020-03-01,Croatia,0,0,5,"rgb(27,158,119)"
11677,2020-03-02,Croatia,0,2,7,"rgb(27,158,119)"
11678,2020-03-03,Croatia,0,1,8,"rgb(27,158,119)"
11679,2020-03-04,Croatia,0,1,9,"rgb(27,158,119)"
11680,2020-03-06,Croatia,0,1,10,"rgb(27,158,119)"
11681,2020-03-07,Croatia,0,1,11,"rgb(27,158,119)"
11682,2020-03-08,Croatia,0,1,12,"rgb(27,158,119)"
11683,2020-03-11,Croatia,0,1,13,"rgb(27,158,119)"
11684,2020-03-12,Croatia,0,3,16,"rgb(27,158,119)"
11685,2020-03-13,Croatia,0,9,25,"rgb(27,158,119)"
11686,2020-03-14,Croatia,0,6,31,"rgb(27,158,119)"
11687,2020-03-15,Croatia,0,6,37,"rgb(27,158,119)"
11688,2020-03-16,Croatia,0,11,48,"rgb(27,158,119)"
11689,2020-03-17,Croatia,0,8,56,"rgb(27,158,119)"
11690,2020-03-18,Croatia,0,13,69,"rgb(27,158,119)"
11691,2020-03-19,Croatia,0,12,81,"rgb(27,158,119)"
11692,2020-03-20,Croatia,0,23,104,"rgb(27,158,119)"
11693,2020-03-21,Croatia,0,22,126,"rgb(27,158,119)"
11694,2020-03-22,Croatia,0,80,206,"rgb(27,158,119)"
11695,2020-03-23,Croatia,0,29,235,"rgb(27,158,119)"
11696,2020-03-24,Croatia,0,71,306,"rgb(27,158,119)"
11697,2020-03-25,Croatia,1,76,382,"rgb(27,158,119)"
11698,2020-03-26,Croatia,0,36,418,"rgb(27,158,119)"
11699,2020-03-27,Croatia,1,77,495,"rgb(27,158,119)"
11700,2020-03-28,Croatia,1,91,586,"rgb(27,158,119)"
11701,2020-03-29,Croatia,2,71,657,"rgb(27,158,119)"
11702,2020-03-30,Croatia,1,56,713,"rgb(27,158,119)"
11703,2020-03-31,Croatia,0,77,790,"rgb(27,158,119)"
11704,2020-04-01,Croatia,0,77,867,"rgb(27,158,119)"
11705,2020-04-02,Croatia,0,96,963,"rgb(27,158,119)"
11706,2020-04-03,Croatia,1,48,1011,"rgb(27,158,119)"
11707,2020-04-04,Croatia,1,68,1079,"rgb(27,158,119)"
11708,2020-04-05,Croatia,4,47,1126,"rgb(27,158,119)"
11709,2020-04-06,Croatia,3,56,1182,"rgb(27,158,119)"
11710,2020-04-07,Croatia,1,40,1222,"rgb(27,158,119)"
11711,2020-04-08,Croatia,2,60,1282,"rgb(27,158,119)"
11712,2020-04-09,Croatia,1,61,1343,"rgb(27,158,119)"
11713,2020-04-10,Croatia,1,64,1407,"rgb(27,158,119)"
11714,2020-04-11,Croatia,1,88,1495,"rgb(27,158,119)"
11715,2020-04-12,Croatia,0,39,1534,"rgb(27,158,119)"
11716,2020-04-13,Croatia,2,66,1600,"rgb(27,158,119)"
11717,2020-04-14,Croatia,2,50,1650,"rgb(27,158,119)"
11718,2020-04-15,Croatia,6,54,1704,"rgb(27,158,119)"
11719,2020-04-16,Croatia,3,37,1741,"rgb(27,158,119)"
11720,2020-04-17,Croatia,1,50,1791,"rgb(27,158,119)"
11721,2020-04-18,Croatia,1,23,1814,"rgb(27,158,119)"
11722,2020-04-19,Croatia,3,18,1832,"rgb(27,158,119)"
11723,2020-04-20,Croatia,8,39,1871,"rgb(27,158,119)"
11724,2020-04-21,Croatia,0,10,1881,"rgb(27,158,119)"
11725,2020-04-22,Croatia,1,27,1908,"rgb(27,158,119)"
11726,2020-04-23,Croatia,0,42,1950,"rgb(27,158,119)"
11727,2020-04-24,Croatia,2,31,1981,"rgb(27,158,119)"
11728,2020-04-25,Croatia,1,28,2009,"rgb(27,158,119)"
11729,2020-04-26,Croatia,3,7,2016,"rgb(27,158,119)"
11730,2020-04-27,Croatia,1,14,2030,"rgb(27,158,119)"
11731,2020-04-28,Croatia,4,9,2039,"rgb(27,158,119)"
11732,2020-04-29,Croatia,4,8,2047,"rgb(27,158,119)"
11733,2020-04-30,Croatia,4,15,2062,"rgb(27,158,119)"
11734,2020-05-01,Croatia,2,14,2076,"rgb(27,158,119)"
11735,2020-05-02,Croatia,6,9,2085,"rgb(27,158,119)"
11736,2020-05-03,Croatia,2,3,2088,"rgb(27,158,119)"
11737,2020-05-04,Croatia,2,8,2096,"rgb(27,158,119)"
11738,2020-05-05,Croatia,1,5,2101,"rgb(27,158,119)"
11739,2020-05-06,Croatia,3,11,2112,"rgb(27,158,119)"
11740,2020-05-07,Croatia,2,7,2119,"rgb(27,158,119)"
11741,2020-05-08,Croatia,1,6,2125,"rgb(27,158,119)"
11742,2020-05-09,Croatia,0,36,2161,"rgb(27,158,119)"
11743,2020-05-10,Croatia,1,15,2176,"rgb(27,158,119)"
11744,2020-05-11,Croatia,3,11,2187,"rgb(27,158,119)"
11745,2020-05-12,Croatia,1,9,2196,"rgb(27,158,119)"
11746,2020-05-13,Croatia,0,11,2207,"rgb(27,158,119)"
11747,2020-05-14,Croatia,3,6,2213,"rgb(27,158,119)"
11748,2020-05-15,Croatia,0,8,2221,"rgb(27,158,119)"
11749,2020-05-16,Croatia,1,1,2222,"rgb(27,158,119)"
11750,2020-05-17,Croatia,0,2,2224,"rgb(27,158,119)"
11751,2020-05-18,Croatia,0,2,2226,"rgb(27,158,119)"
11752,2020-05-19,Croatia,0,2,2228,"rgb(27,158,119)"
11753,2020-05-20,Croatia,1,4,2232,"rgb(27,158,119)"
11754,2020-05-21,Croatia,0,2,2234,"rgb(27,158,119)"
11755,2020-05-22,Croatia,1,3,2237,"rgb(27,158,119)"
11756,2020-05-23,Croatia,2,6,2243,"rgb(27,158,119)"
11757,2020-05-24,Croatia,0,0,2243,"rgb(27,158,119)"
11758,2020-05-25,Croatia,0,1,2244,"rgb(27,158,119)"
11759,2020-05-26,Croatia,1,0,2244,"rgb(27,158,119)"
11760,2020-05-27,Croatia,1,0,2244,"rgb(27,158,119)"
11761,2020-05-28,Croatia,0,0,2244,"rgb(27,158,119)"
11762,2020-05-29,Croatia,1,1,2245,"rgb(27,158,119)"
11763,2020-05-30,Croatia,1,0,2245,"rgb(27,158,119)"
11764,2020-05-31,Croatia,0,1,2246,"rgb(27,158,119)"
11765,2020-06-01,Croatia,0,0,2246,"rgb(27,158,119)"
11766,2020-06-02,Croatia,0,0,2246,"rgb(27,158,119)"
11767,2020-06-03,Croatia,0,0,2246,"rgb(27,158,119)"
11768,2020-06-04,Croatia,0,0,2246,"rgb(27,158,119)"
11769,2020-06-05,Croatia,0,1,2247,"rgb(27,158,119)"
11770,2020-06-06,Croatia,0,0,2247,"rgb(27,158,119)"
11771,2020-06-07,Croatia,1,0,2247,"rgb(27,158,119)"
11772,2020-06-08,Croatia,0,0,2247,"rgb(27,158,119)"
11773,2020-06-09,Croatia,0,0,2247,"rgb(27,158,119)"
11774,2020-06-10,Croatia,2,0,2247,"rgb(27,158,119)"
11775,2020-06-11,Croatia,0,2,2249,"rgb(27,158,119)"
11776,2020-06-12,Croatia,0,0,2249,"rgb(27,158,119)"
11777,2020-06-13,Croatia,1,0,2249,"rgb(27,158,119)"
11778,2020-06-14,Croatia,0,2,2251,"rgb(27,158,119)"
11779,2020-06-15,Croatia,0,1,2252,"rgb(27,158,119)"
11780,2020-06-16,Croatia,0,2,2254,"rgb(27,158,119)"
11781,2020-06-17,Croatia,0,1,2255,"rgb(27,158,119)"
11782,2020-06-18,Croatia,0,3,2258,"rgb(27,158,119)"
11783,2020-06-19,Croatia,0,11,2269,"rgb(27,158,119)"
11784,2020-06-20,Croatia,0,11,2280,"rgb(27,158,119)"
11785,2020-06-21,Croatia,0,19,2299,"rgb(27,158,119)"
11786,2020-06-22,Croatia,0,18,2317,"rgb(27,158,119)"
11787,2020-06-23,Croatia,0,19,2336,"rgb(27,158,119)"
11788,2020-06-24,Croatia,0,30,2366,"rgb(27,158,119)"
11789,2020-06-25,Croatia,0,22,2388,"rgb(27,158,119)"
11790,2020-06-26,Croatia,0,95,2483,"rgb(27,158,119)"
11791,2020-06-27,Croatia,0,56,2539,"rgb(27,158,119)"
11792,2020-06-28,Croatia,0,85,2624,"rgb(27,158,119)"
11793,2020-06-29,Croatia,0,67,2691,"rgb(27,158,119)"
11794,2020-06-30,Croatia,0,34,2725,"rgb(27,158,119)"
11795,2020-07-01,Croatia,0,52,2777,"rgb(27,158,119)"
11796,2020-07-02,Croatia,1,54,2831,"rgb(27,158,119)"
11797,2020-07-03,Croatia,2,81,2912,"rgb(27,158,119)"
11798,2020-07-04,Croatia,2,96,3008,"rgb(27,158,119)"
11799,2020-07-05,Croatia,1,86,3094,"rgb(27,158,119)"
11800,2020-07-06,Croatia,0,57,3151,"rgb(27,158,119)"
11801,2020-07-07,Croatia,0,69,3220,"rgb(27,158,119)"
11802,2020-07-08,Croatia,0,52,3272,"rgb(27,158,119)"
11803,2020-07-09,Croatia,1,53,3325,"rgb(27,158,119)"
11804,2020-07-10,Croatia,1,91,3416,"rgb(27,158,119)"
11805,2020-07-11,Croatia,2,116,3532,"rgb(27,158,119)"
11806,2020-07-12,Croatia,1,140,3672,"rgb(27,158,119)"
11807,2020-07-13,Croatia,1,50,3722,"rgb(27,158,119)"
11808,2020-03-20,Haiti,0,2,2,"rgb(217,95,2)"
11809,2020-03-21,Haiti,0,0,2,"rgb(217,95,2)"
11810,2020-03-22,Haiti,0,0,2,"rgb(217,95,2)"
11811,2020-03-23,Haiti,0,0,2,"rgb(217,95,2)"
11812,2020-03-24,Haiti,0,3,5,"rgb(217,95,2)"
11813,2020-03-25,Haiti,0,2,7,"rgb(217,95,2)"
11814,2020-03-26,Haiti,0,1,8,"rgb(217,95,2)"
11815,2020-03-27,Haiti,0,0,8,"rgb(217,95,2)"
11816,2020-03-28,Haiti,0,0,8,"rgb(217,95,2)"
11817,2020-03-29,Haiti,0,0,8,"rgb(217,95,2)"
11818,2020-03-30,Haiti,0,7,15,"rgb(217,95,2)"
11819,2020-03-31,Haiti,0,0,15,"rgb(217,95,2)"
11820,2020-04-01,Haiti,0,0,15,"rgb(217,95,2)"
11821,2020-04-02,Haiti,0,1,16,"rgb(217,95,2)"
11822,2020-04-03,Haiti,0,2,18,"rgb(217,95,2)"
11823,2020-04-04,Haiti,0,0,18,"rgb(217,95,2)"
11824,2020-04-05,Haiti,0,3,21,"rgb(217,95,2)"
11825,2020-04-06,Haiti,0,0,21,"rgb(217,95,2)"
11826,2020-04-07,Haiti,1,3,24,"rgb(217,95,2)"
11827,2020-04-08,Haiti,0,1,25,"rgb(217,95,2)"
11828,2020-04-09,Haiti,0,2,27,"rgb(217,95,2)"
11829,2020-04-10,Haiti,1,3,30,"rgb(217,95,2)"
11830,2020-04-11,Haiti,0,1,31,"rgb(217,95,2)"
11831,2020-04-12,Haiti,0,2,33,"rgb(217,95,2)"
11832,2020-04-13,Haiti,1,0,33,"rgb(217,95,2)"
11833,2020-04-14,Haiti,0,7,40,"rgb(217,95,2)"
11834,2020-04-15,Haiti,0,0,40,"rgb(217,95,2)"
11835,2020-04-16,Haiti,0,1,41,"rgb(217,95,2)"
11836,2020-04-17,Haiti,0,2,43,"rgb(217,95,2)"
11837,2020-04-18,Haiti,0,1,44,"rgb(217,95,2)"
11838,2020-04-19,Haiti,0,0,44,"rgb(217,95,2)"
11839,2020-04-20,Haiti,0,3,47,"rgb(217,95,2)"
11840,2020-04-21,Haiti,0,10,57,"rgb(217,95,2)"
11841,2020-04-22,Haiti,1,1,58,"rgb(217,95,2)"
11842,2020-04-23,Haiti,0,4,62,"rgb(217,95,2)"
11843,2020-04-24,Haiti,1,10,72,"rgb(217,95,2)"
11844,2020-04-25,Haiti,0,0,72,"rgb(217,95,2)"
11845,2020-04-26,Haiti,1,0,72,"rgb(217,95,2)"
11846,2020-04-27,Haiti,0,0,72,"rgb(217,95,2)"
11847,2020-04-28,Haiti,0,4,76,"rgb(217,95,2)"
11848,2020-04-29,Haiti,0,0,76,"rgb(217,95,2)"
11849,2020-04-30,Haiti,0,0,76,"rgb(217,95,2)"
11850,2020-05-01,Haiti,2,5,81,"rgb(217,95,2)"
11851,2020-05-02,Haiti,0,4,85,"rgb(217,95,2)"
11852,2020-05-03,Haiti,0,0,85,"rgb(217,95,2)"
11853,2020-05-04,Haiti,0,0,85,"rgb(217,95,2)"
11854,2020-05-05,Haiti,3,15,100,"rgb(217,95,2)"
11855,2020-05-06,Haiti,1,1,101,"rgb(217,95,2)"
11856,2020-05-07,Haiti,0,7,108,"rgb(217,95,2)"
11857,2020-05-08,Haiti,0,21,129,"rgb(217,95,2)"
11858,2020-05-09,Haiti,0,17,146,"rgb(217,95,2)"
11859,2020-05-10,Haiti,0,5,151,"rgb(217,95,2)"
11860,2020-05-11,Haiti,3,31,182,"rgb(217,95,2)"
11861,2020-05-12,Haiti,1,27,209,"rgb(217,95,2)"
11862,2020-05-13,Haiti,2,10,219,"rgb(217,95,2)"
11863,2020-05-14,Haiti,0,15,234,"rgb(217,95,2)"
11864,2020-05-15,Haiti,2,39,273,"rgb(217,95,2)"
11865,2020-05-16,Haiti,0,37,310,"rgb(217,95,2)"
11866,2020-05-17,Haiti,0,48,358,"rgb(217,95,2)"
11867,2020-05-18,Haiti,0,98,456,"rgb(217,95,2)"
11868,2020-05-19,Haiti,1,77,533,"rgb(217,95,2)"
11869,2020-05-20,Haiti,1,63,596,"rgb(217,95,2)"
11870,2020-05-21,Haiti,0,0,596,"rgb(217,95,2)"
11871,2020-05-22,Haiti,3,138,734,"rgb(217,95,2)"
11872,2020-05-23,Haiti,0,78,812,"rgb(217,95,2)"
11873,2020-05-24,Haiti,1,53,865,"rgb(217,95,2)"
11874,2020-05-25,Haiti,1,93,958,"rgb(217,95,2)"
11875,2020-05-26,Haiti,4,105,1063,"rgb(217,95,2)"
11876,2020-05-27,Haiti,2,111,1174,"rgb(217,95,2)"
11877,2020-05-28,Haiti,1,146,1320,"rgb(217,95,2)"
11878,2020-05-29,Haiti,1,123,1443,"rgb(217,95,2)"
11879,2020-05-30,Haiti,0,141,1584,"rgb(217,95,2)"
11880,2020-05-31,Haiti,6,281,1865,"rgb(217,95,2)"
11881,2020-06-01,Haiti,3,259,2124,"rgb(217,95,2)"
11882,2020-06-02,Haiti,1,102,2226,"rgb(217,95,2)"
11883,2020-06-03,Haiti,3,281,2507,"rgb(217,95,2)"
11884,2020-06-04,Haiti,2,133,2640,"rgb(217,95,2)"
11885,2020-06-05,Haiti,0,0,2640,"rgb(217,95,2)"
11886,2020-06-06,Haiti,0,284,2924,"rgb(217,95,2)"
11887,2020-06-07,Haiti,0,148,3072,"rgb(217,95,2)"
11888,2020-06-08,Haiti,1,262,3334,"rgb(217,95,2)"
11889,2020-06-09,Haiti,3,204,3538,"rgb(217,95,2)"
11890,2020-06-10,Haiti,2,124,3662,"rgb(217,95,2)"
11891,2020-06-11,Haiti,2,134,3796,"rgb(217,95,2)"
11892,2020-06-12,Haiti,6,145,3941,"rgb(217,95,2)"
11893,2020-06-13,Haiti,0,0,3941,"rgb(217,95,2)"
11894,2020-06-14,Haiti,6,224,4165,"rgb(217,95,2)"
11895,2020-06-15,Haiti,3,144,4309,"rgb(217,95,2)"
11896,2020-06-16,Haiti,3,132,4441,"rgb(217,95,2)"
11897,2020-06-17,Haiti,4,106,4547,"rgb(217,95,2)"
11898,2020-06-18,Haiti,2,141,4688,"rgb(217,95,2)"
11899,2020-06-19,Haiti,2,228,4916,"rgb(217,95,2)"
11900,2020-06-20,Haiti,3,64,4980,"rgb(217,95,2)"
11901,2020-06-21,Haiti,1,97,5077,"rgb(217,95,2)"
11902,2020-06-22,Haiti,0,134,5211,"rgb(217,95,2)"
11903,2020-06-23,Haiti,0,0,5211,"rgb(217,95,2)"
11904,2020-06-24,Haiti,1,113,5324,"rgb(217,95,2)"
11905,2020-06-25,Haiti,3,105,5429,"rgb(217,95,2)"
11906,2020-06-26,Haiti,4,114,5543,"rgb(217,95,2)"
11907,2020-06-27,Haiti,2,179,5722,"rgb(217,95,2)"
11908,2020-06-28,Haiti,2,55,5777,"rgb(217,95,2)"
11909,2020-06-29,Haiti,4,70,5847,"rgb(217,95,2)"
11910,2020-06-30,Haiti,1,86,5933,"rgb(217,95,2)"
11911,2020-07-01,Haiti,0,42,5975,"rgb(217,95,2)"
11912,2020-07-02,Haiti,2,65,6040,"rgb(217,95,2)"
11913,2020-07-03,Haiti,3,61,6101,"rgb(217,95,2)"
11914,2020-07-04,Haiti,0,129,6230,"rgb(217,95,2)"
11915,2020-07-05,Haiti,3,64,6294,"rgb(217,95,2)"
11916,2020-07-06,Haiti,0,39,6333,"rgb(217,95,2)"
11917,2020-07-07,Haiti,0,38,6371,"rgb(217,95,2)"
11918,2020-07-08,Haiti,4,61,6432,"rgb(217,95,2)"
11919,2020-07-09,Haiti,6,54,6486,"rgb(217,95,2)"
11920,2020-07-10,Haiti,0,0,6486,"rgb(217,95,2)"
11921,2020-07-11,Haiti,12,131,6617,"rgb(217,95,2)"
11922,2020-07-12,Haiti,4,73,6690,"rgb(217,95,2)"
11923,2020-07-13,Haiti,0,37,6727,"rgb(217,95,2)"
11924,2020-03-05,Hungary,0,2,2,"rgb(117,112,179)"
11925,2020-03-07,Hungary,0,2,4,"rgb(117,112,179)"
11926,2020-03-08,Hungary,0,3,7,"rgb(117,112,179)"
11927,2020-03-09,Hungary,0,1,8,"rgb(117,112,179)"
11928,2020-03-10,Hungary,0,1,9,"rgb(117,112,179)"
11929,2020-03-11,Hungary,0,3,12,"rgb(117,112,179)"
11930,2020-03-12,Hungary,0,1,13,"rgb(117,112,179)"
11931,2020-03-13,Hungary,0,3,16,"rgb(117,112,179)"
11932,2020-03-14,Hungary,0,9,25,"rgb(117,112,179)"
11933,2020-03-15,Hungary,0,6,31,"rgb(117,112,179)"
11934,2020-03-16,Hungary,1,8,39,"rgb(117,112,179)"
11935,2020-03-17,Hungary,0,11,50,"rgb(117,112,179)"
11936,2020-03-18,Hungary,0,0,50,"rgb(117,112,179)"
11937,2020-03-19,Hungary,0,23,73,"rgb(117,112,179)"
11938,2020-03-20,Hungary,0,12,85,"rgb(117,112,179)"
11939,2020-03-21,Hungary,3,18,103,"rgb(117,112,179)"
11940,2020-03-22,Hungary,0,28,131,"rgb(117,112,179)"
11941,2020-03-23,Hungary,3,36,167,"rgb(117,112,179)"
11942,2020-03-24,Hungary,1,20,187,"rgb(117,112,179)"
11943,2020-03-25,Hungary,2,39,226,"rgb(117,112,179)"
11944,2020-03-26,Hungary,0,35,261,"rgb(117,112,179)"
11945,2020-03-27,Hungary,0,39,300,"rgb(117,112,179)"
11946,2020-03-28,Hungary,1,43,343,"rgb(117,112,179)"
11947,2020-03-29,Hungary,2,65,408,"rgb(117,112,179)"
11948,2020-03-30,Hungary,2,39,447,"rgb(117,112,179)"
11949,2020-03-31,Hungary,1,45,492,"rgb(117,112,179)"
11950,2020-04-01,Hungary,4,33,525,"rgb(117,112,179)"
11951,2020-04-02,Hungary,1,60,585,"rgb(117,112,179)"
11952,2020-04-03,Hungary,5,38,623,"rgb(117,112,179)"
11953,2020-04-04,Hungary,6,55,678,"rgb(117,112,179)"
11954,2020-04-05,Hungary,2,55,733,"rgb(117,112,179)"
11955,2020-04-06,Hungary,4,11,744,"rgb(117,112,179)"
11956,2020-04-07,Hungary,9,73,817,"rgb(117,112,179)"
11957,2020-04-08,Hungary,11,78,895,"rgb(117,112,179)"
11958,2020-04-09,Hungary,8,85,980,"rgb(117,112,179)"
11959,2020-04-10,Hungary,11,210,1190,"rgb(117,112,179)"
11960,2020-04-11,Hungary,8,120,1310,"rgb(117,112,179)"
11961,2020-04-12,Hungary,14,100,1410,"rgb(117,112,179)"
11962,2020-04-13,Hungary,10,48,1458,"rgb(117,112,179)"
11963,2020-04-14,Hungary,13,54,1512,"rgb(117,112,179)"
11964,2020-04-15,Hungary,12,67,1579,"rgb(117,112,179)"
11965,2020-04-16,Hungary,8,73,1652,"rgb(117,112,179)"
11966,2020-04-17,Hungary,14,111,1763,"rgb(117,112,179)"
11967,2020-04-18,Hungary,16,71,1834,"rgb(117,112,179)"
11968,2020-04-19,Hungary,17,82,1916,"rgb(117,112,179)"
11969,2020-04-20,Hungary,10,68,1984,"rgb(117,112,179)"
11970,2020-04-21,Hungary,14,114,2098,"rgb(117,112,179)"
11971,2020-04-22,Hungary,12,70,2168,"rgb(117,112,179)"
11972,2020-04-23,Hungary,0,116,2284,"rgb(117,112,179)"
11973,2020-04-24,Hungary,25,99,2383,"rgb(117,112,179)"
11974,2020-04-25,Hungary,12,60,2443,"rgb(117,112,179)"
11975,2020-04-26,Hungary,10,57,2500,"rgb(117,112,179)"
11976,2020-04-27,Hungary,8,83,2583,"rgb(117,112,179)"
11977,2020-04-28,Hungary,11,66,2649,"rgb(117,112,179)"
11978,2020-04-29,Hungary,9,78,2727,"rgb(117,112,179)"
11979,2020-04-30,Hungary,12,48,2775,"rgb(117,112,179)"
11980,2020-05-01,Hungary,11,88,2863,"rgb(117,112,179)"
11981,2020-05-02,Hungary,12,79,2942,"rgb(117,112,179)"
11982,2020-05-03,Hungary,5,56,2998,"rgb(117,112,179)"
11983,2020-05-04,Hungary,11,37,3035,"rgb(117,112,179)"
11984,2020-05-05,Hungary,12,30,3065,"rgb(117,112,179)"
11985,2020-05-06,Hungary,10,46,3111,"rgb(117,112,179)"
11986,2020-05-07,Hungary,10,39,3150,"rgb(117,112,179)"
11987,2020-05-08,Hungary,9,28,3178,"rgb(117,112,179)"
11988,2020-05-09,Hungary,13,35,3213,"rgb(117,112,179)"
11989,2020-05-10,Hungary,8,50,3263,"rgb(117,112,179)"
11990,2020-05-11,Hungary,8,21,3284,"rgb(117,112,179)"
11991,2020-05-12,Hungary,4,29,3313,"rgb(117,112,179)"
11992,2020-05-13,Hungary,5,28,3341,"rgb(117,112,179)"
11993,2020-05-14,Hungary,6,39,3380,"rgb(117,112,179)"
11994,2020-05-15,Hungary,6,37,3417,"rgb(117,112,179)"
11995,2020-05-16,Hungary,6,56,3473,"rgb(117,112,179)"
11996,2020-05-17,Hungary,3,36,3509,"rgb(117,112,179)"
11997,2020-05-18,Hungary,11,26,3535,"rgb(117,112,179)"
11998,2020-05-19,Hungary,5,21,3556,"rgb(117,112,179)"
11999,2020-05-20,Hungary,3,42,3598,"rgb(117,112,179)"
12000,2020-05-21,Hungary,3,43,3641,"rgb(117,112,179)"
12001,2020-05-22,Hungary,3,37,3678,"rgb(117,112,179)"
12002,2020-05-23,Hungary,6,35,3713,"rgb(117,112,179)"
12003,2020-05-24,Hungary,4,28,3741,"rgb(117,112,179)"
12004,2020-05-25,Hungary,5,15,3756,"rgb(117,112,179)"
12005,2020-05-26,Hungary,8,15,3771,"rgb(117,112,179)"
12006,2020-05-27,Hungary,6,22,3793,"rgb(117,112,179)"
12007,2020-05-28,Hungary,4,23,3816,"rgb(117,112,179)"
12008,2020-05-29,Hungary,8,25,3841,"rgb(117,112,179)"
12009,2020-05-30,Hungary,0,0,3841,"rgb(117,112,179)"
12010,2020-05-31,Hungary,7,26,3867,"rgb(117,112,179)"
12011,2020-06-01,Hungary,2,9,3876,"rgb(117,112,179)"
12012,2020-06-02,Hungary,6,45,3921,"rgb(117,112,179)"
12013,2020-06-03,Hungary,2,10,3931,"rgb(117,112,179)"
12014,2020-06-04,Hungary,0,0,3931,"rgb(117,112,179)"
12015,2020-06-05,Hungary,5,23,3954,"rgb(117,112,179)"
12016,2020-06-06,Hungary,3,16,3970,"rgb(117,112,179)"
12017,2020-06-07,Hungary,0,0,3970,"rgb(117,112,179)"
12018,2020-06-08,Hungary,0,0,3970,"rgb(117,112,179)"
12019,2020-06-09,Hungary,6,44,4014,"rgb(117,112,179)"
12020,2020-06-10,Hungary,2,3,4017,"rgb(117,112,179)"
12021,2020-06-11,Hungary,1,10,4027,"rgb(117,112,179)"
12022,2020-06-12,Hungary,2,12,4039,"rgb(117,112,179)"
12023,2020-06-13,Hungary,2,14,4053,"rgb(117,112,179)"
12024,2020-06-14,Hungary,4,11,4064,"rgb(117,112,179)"
12025,2020-06-15,Hungary,4,12,4076,"rgb(117,112,179)"
12026,2020-06-16,Hungary,2,1,4077,"rgb(117,112,179)"
12027,2020-06-17,Hungary,2,1,4078,"rgb(117,112,179)"
12028,2020-06-18,Hungary,1,1,4079,"rgb(117,112,179)"
12029,2020-06-19,Hungary,0,2,4081,"rgb(117,112,179)"
12030,2020-06-20,Hungary,2,5,4086,"rgb(117,112,179)"
12031,2020-06-21,Hungary,0,8,4094,"rgb(117,112,179)"
12032,2020-06-22,Hungary,2,8,4102,"rgb(117,112,179)"
12033,2020-06-23,Hungary,1,5,4107,"rgb(117,112,179)"
12034,2020-06-24,Hungary,0,0,4107,"rgb(117,112,179)"
12035,2020-06-25,Hungary,3,7,4114,"rgb(117,112,179)"
12036,2020-06-26,Hungary,1,9,4123,"rgb(117,112,179)"
12037,2020-06-27,Hungary,1,4,4127,"rgb(117,112,179)"
12038,2020-06-28,Hungary,0,11,4138,"rgb(117,112,179)"
12039,2020-06-29,Hungary,3,4,4142,"rgb(117,112,179)"
12040,2020-06-30,Hungary,4,3,4145,"rgb(117,112,179)"
12041,2020-07-01,Hungary,0,10,4155,"rgb(117,112,179)"
12042,2020-07-02,Hungary,1,2,4157,"rgb(117,112,179)"
12043,2020-07-03,Hungary,1,9,4166,"rgb(117,112,179)"
12044,2020-07-04,Hungary,1,6,4172,"rgb(117,112,179)"
12045,2020-07-05,Hungary,1,11,4183,"rgb(117,112,179)"
12046,2020-07-06,Hungary,0,0,4183,"rgb(117,112,179)"
12047,2020-07-07,Hungary,0,6,4189,"rgb(117,112,179)"
12048,2020-07-08,Hungary,0,21,4210,"rgb(117,112,179)"
12049,2020-07-09,Hungary,0,0,4210,"rgb(117,112,179)"
12050,2020-07-10,Hungary,2,10,4220,"rgb(117,112,179)"
12051,2020-07-11,Hungary,2,3,4223,"rgb(117,112,179)"
12052,2020-07-12,Hungary,2,6,4229,"rgb(117,112,179)"
12053,2020-07-13,Hungary,0,5,4234,"rgb(117,112,179)"
12054,2019-12-31,Indonesia,0,0,0,"rgb(231,41,138)"
12055,2020-01-01,Indonesia,0,0,0,"rgb(231,41,138)"
12056,2020-01-02,Indonesia,0,0,0,"rgb(231,41,138)"
12057,2020-01-03,Indonesia,0,0,0,"rgb(231,41,138)"
12058,2020-01-04,Indonesia,0,0,0,"rgb(231,41,138)"
12059,2020-01-05,Indonesia,0,0,0,"rgb(231,41,138)"
12060,2020-01-06,Indonesia,0,0,0,"rgb(231,41,138)"
12061,2020-01-07,Indonesia,0,0,0,"rgb(231,41,138)"
12062,2020-01-08,Indonesia,0,0,0,"rgb(231,41,138)"
12063,2020-01-09,Indonesia,0,0,0,"rgb(231,41,138)"
12064,2020-01-10,Indonesia,0,0,0,"rgb(231,41,138)"
12065,2020-01-11,Indonesia,0,0,0,"rgb(231,41,138)"
12066,2020-01-12,Indonesia,0,0,0,"rgb(231,41,138)"
12067,2020-01-13,Indonesia,0,0,0,"rgb(231,41,138)"
12068,2020-01-14,Indonesia,0,0,0,"rgb(231,41,138)"
12069,2020-01-15,Indonesia,0,0,0,"rgb(231,41,138)"
12070,2020-01-16,Indonesia,0,0,0,"rgb(231,41,138)"
12071,2020-01-17,Indonesia,0,0,0,"rgb(231,41,138)"
12072,2020-01-18,Indonesia,0,0,0,"rgb(231,41,138)"
12073,2020-01-19,Indonesia,0,0,0,"rgb(231,41,138)"
12074,2020-01-20,Indonesia,0,0,0,"rgb(231,41,138)"
12075,2020-01-21,Indonesia,0,0,0,"rgb(231,41,138)"
12076,2020-01-22,Indonesia,0,0,0,"rgb(231,41,138)"
12077,2020-01-23,Indonesia,0,0,0,"rgb(231,41,138)"
12078,2020-01-24,Indonesia,0,0,0,"rgb(231,41,138)"
12079,2020-01-25,Indonesia,0,0,0,"rgb(231,41,138)"
12080,2020-01-26,Indonesia,0,0,0,"rgb(231,41,138)"
12081,2020-01-27,Indonesia,0,0,0,"rgb(231,41,138)"
12082,2020-01-28,Indonesia,0,0,0,"rgb(231,41,138)"
12083,2020-01-29,Indonesia,0,0,0,"rgb(231,41,138)"
12084,2020-01-30,Indonesia,0,0,0,"rgb(231,41,138)"
12085,2020-01-31,Indonesia,0,0,0,"rgb(231,41,138)"
12086,2020-02-01,Indonesia,0,0,0,"rgb(231,41,138)"
12087,2020-02-02,Indonesia,0,0,0,"rgb(231,41,138)"
12088,2020-02-03,Indonesia,0,0,0,"rgb(231,41,138)"
12089,2020-02-04,Indonesia,0,0,0,"rgb(231,41,138)"
12090,2020-02-05,Indonesia,0,0,0,"rgb(231,41,138)"
12091,2020-02-06,Indonesia,0,0,0,"rgb(231,41,138)"
12092,2020-02-07,Indonesia,0,0,0,"rgb(231,41,138)"
12093,2020-02-08,Indonesia,0,0,0,"rgb(231,41,138)"
12094,2020-02-09,Indonesia,0,0,0,"rgb(231,41,138)"
12095,2020-02-10,Indonesia,0,0,0,"rgb(231,41,138)"
12096,2020-02-11,Indonesia,0,0,0,"rgb(231,41,138)"
12097,2020-02-12,Indonesia,0,0,0,"rgb(231,41,138)"
12098,2020-02-13,Indonesia,0,0,0,"rgb(231,41,138)"
12099,2020-02-14,Indonesia,0,0,0,"rgb(231,41,138)"
12100,2020-02-15,Indonesia,0,0,0,"rgb(231,41,138)"
12101,2020-02-16,Indonesia,0,0,0,"rgb(231,41,138)"
12102,2020-02-17,Indonesia,0,0,0,"rgb(231,41,138)"
12103,2020-02-18,Indonesia,0,0,0,"rgb(231,41,138)"
12104,2020-02-19,Indonesia,0,0,0,"rgb(231,41,138)"
12105,2020-02-20,Indonesia,0,0,0,"rgb(231,41,138)"
12106,2020-02-21,Indonesia,0,0,0,"rgb(231,41,138)"
12107,2020-02-22,Indonesia,0,0,0,"rgb(231,41,138)"
12108,2020-02-23,Indonesia,0,0,0,"rgb(231,41,138)"
12109,2020-02-24,Indonesia,0,0,0,"rgb(231,41,138)"
12110,2020-02-25,Indonesia,0,0,0,"rgb(231,41,138)"
12111,2020-02-26,Indonesia,0,0,0,"rgb(231,41,138)"
12112,2020-02-27,Indonesia,0,0,0,"rgb(231,41,138)"
12113,2020-02-28,Indonesia,0,0,0,"rgb(231,41,138)"
12114,2020-02-29,Indonesia,0,0,0,"rgb(231,41,138)"
12115,2020-03-01,Indonesia,0,0,0,"rgb(231,41,138)"
12116,2020-03-02,Indonesia,0,2,2,"rgb(231,41,138)"
12117,2020-03-07,Indonesia,0,2,4,"rgb(231,41,138)"
12118,2020-03-09,Indonesia,0,2,6,"rgb(231,41,138)"
12119,2020-03-11,Indonesia,0,13,19,"rgb(231,41,138)"
12120,2020-03-12,Indonesia,1,15,34,"rgb(231,41,138)"
12121,2020-03-14,Indonesia,3,35,69,"rgb(231,41,138)"
12122,2020-03-15,Indonesia,0,27,96,"rgb(231,41,138)"
12123,2020-03-16,Indonesia,1,21,117,"rgb(231,41,138)"
12124,2020-03-17,Indonesia,0,17,134,"rgb(231,41,138)"
12125,2020-03-18,Indonesia,0,38,172,"rgb(231,41,138)"
12126,2020-03-19,Indonesia,0,0,172,"rgb(231,41,138)"
12127,2020-03-20,Indonesia,14,55,227,"rgb(231,41,138)"
12128,2020-03-21,Indonesia,6,82,309,"rgb(231,41,138)"
12129,2020-03-22,Indonesia,13,141,450,"rgb(231,41,138)"
12130,2020-03-23,Indonesia,10,64,514,"rgb(231,41,138)"
12131,2020-03-24,Indonesia,1,65,579,"rgb(231,41,138)"
12132,2020-03-25,Indonesia,6,107,686,"rgb(231,41,138)"
12133,2020-03-26,Indonesia,3,104,790,"rgb(231,41,138)"
12134,2020-03-27,Indonesia,20,103,893,"rgb(231,41,138)"
12135,2020-03-28,Indonesia,9,153,1046,"rgb(231,41,138)"
12136,2020-03-29,Indonesia,15,109,1155,"rgb(231,41,138)"
12137,2020-03-30,Indonesia,12,130,1285,"rgb(231,41,138)"
12138,2020-03-31,Indonesia,8,129,1414,"rgb(231,41,138)"
12139,2020-04-01,Indonesia,14,114,1528,"rgb(231,41,138)"
12140,2020-04-02,Indonesia,21,149,1677,"rgb(231,41,138)"
12141,2020-04-03,Indonesia,13,113,1790,"rgb(231,41,138)"
12142,2020-04-04,Indonesia,11,196,1986,"rgb(231,41,138)"
12143,2020-04-05,Indonesia,10,106,2092,"rgb(231,41,138)"
12144,2020-04-06,Indonesia,7,181,2273,"rgb(231,41,138)"
12145,2020-04-07,Indonesia,11,218,2491,"rgb(231,41,138)"
12146,2020-04-08,Indonesia,12,247,2738,"rgb(231,41,138)"
12147,2020-04-09,Indonesia,19,218,2956,"rgb(231,41,138)"
12148,2020-04-10,Indonesia,40,337,3293,"rgb(231,41,138)"
12149,2020-04-11,Indonesia,26,219,3512,"rgb(231,41,138)"
12150,2020-04-12,Indonesia,21,330,3842,"rgb(231,41,138)"
12151,2020-04-13,Indonesia,46,399,4241,"rgb(231,41,138)"
12152,2020-04-14,Indonesia,26,316,4557,"rgb(231,41,138)"
12153,2020-04-15,Indonesia,60,282,4839,"rgb(231,41,138)"
12154,2020-04-16,Indonesia,10,297,5136,"rgb(231,41,138)"
12155,2020-04-17,Indonesia,27,380,5516,"rgb(231,41,138)"
12156,2020-04-18,Indonesia,24,407,5923,"rgb(231,41,138)"
12157,2020-04-19,Indonesia,15,325,6248,"rgb(231,41,138)"
12158,2020-04-20,Indonesia,47,327,6575,"rgb(231,41,138)"
12159,2020-04-21,Indonesia,8,185,6760,"rgb(231,41,138)"
12160,2020-04-22,Indonesia,26,375,7135,"rgb(231,41,138)"
12161,2020-04-23,Indonesia,19,283,7418,"rgb(231,41,138)"
12162,2020-04-24,Indonesia,12,357,7775,"rgb(231,41,138)"
12163,2020-04-25,Indonesia,42,436,8211,"rgb(231,41,138)"
12164,2020-04-26,Indonesia,31,396,8607,"rgb(231,41,138)"
12165,2020-04-27,Indonesia,23,275,8882,"rgb(231,41,138)"
12166,2020-04-28,Indonesia,22,214,9096,"rgb(231,41,138)"
12167,2020-04-29,Indonesia,8,415,9511,"rgb(231,41,138)"
12168,2020-04-30,Indonesia,11,260,9771,"rgb(231,41,138)"
12169,2020-05-01,Indonesia,8,347,10118,"rgb(231,41,138)"
12170,2020-05-02,Indonesia,8,433,10551,"rgb(231,41,138)"
12171,2020-05-03,Indonesia,31,292,10843,"rgb(231,41,138)"
12172,2020-05-04,Indonesia,14,349,11192,"rgb(231,41,138)"
12173,2020-05-05,Indonesia,19,395,11587,"rgb(231,41,138)"
12174,2020-05-06,Indonesia,8,484,12071,"rgb(231,41,138)"
12175,2020-05-07,Indonesia,23,367,12438,"rgb(231,41,138)"
12176,2020-05-08,Indonesia,35,338,12776,"rgb(231,41,138)"
12177,2020-05-09,Indonesia,13,336,13112,"rgb(231,41,138)"
12178,2020-05-10,Indonesia,16,533,13645,"rgb(231,41,138)"
12179,2020-05-11,Indonesia,14,387,14032,"rgb(231,41,138)"
12180,2020-05-12,Indonesia,18,233,14265,"rgb(231,41,138)"
12181,2020-05-13,Indonesia,16,484,14749,"rgb(231,41,138)"
12182,2020-05-14,Indonesia,21,689,15438,"rgb(231,41,138)"
12183,2020-05-15,Indonesia,15,568,16006,"rgb(231,41,138)"
12184,2020-05-16,Indonesia,33,490,16496,"rgb(231,41,138)"
12185,2020-05-17,Indonesia,13,529,17025,"rgb(231,41,138)"
12186,2020-05-18,Indonesia,59,489,17514,"rgb(231,41,138)"
12187,2020-05-19,Indonesia,43,496,18010,"rgb(231,41,138)"
12188,2020-05-20,Indonesia,30,486,18496,"rgb(231,41,138)"
12189,2020-05-21,Indonesia,21,693,19189,"rgb(231,41,138)"
12190,2020-05-22,Indonesia,36,973,20162,"rgb(231,41,138)"
12191,2020-05-23,Indonesia,48,634,20796,"rgb(231,41,138)"
12192,2020-05-24,Indonesia,25,949,21745,"rgb(231,41,138)"
12193,2020-05-25,Indonesia,21,526,22271,"rgb(231,41,138)"
12194,2020-05-26,Indonesia,19,479,22750,"rgb(231,41,138)"
12195,2020-05-27,Indonesia,27,415,23165,"rgb(231,41,138)"
12196,2020-05-28,Indonesia,55,686,23851,"rgb(231,41,138)"
12197,2020-05-29,Indonesia,23,687,24538,"rgb(231,41,138)"
12198,2020-05-30,Indonesia,24,678,25216,"rgb(231,41,138)"
12199,2020-05-31,Indonesia,53,557,25773,"rgb(231,41,138)"
12200,2020-06-01,Indonesia,40,700,26473,"rgb(231,41,138)"
12201,2020-06-02,Indonesia,28,467,26940,"rgb(231,41,138)"
12202,2020-06-03,Indonesia,22,609,27549,"rgb(231,41,138)"
12203,2020-06-04,Indonesia,35,684,28233,"rgb(231,41,138)"
12204,2020-06-05,Indonesia,23,585,28818,"rgb(231,41,138)"
12205,2020-06-06,Indonesia,49,703,29521,"rgb(231,41,138)"
12206,2020-06-07,Indonesia,31,993,30514,"rgb(231,41,138)"
12207,2020-06-08,Indonesia,50,672,31186,"rgb(231,41,138)"
12208,2020-06-09,Indonesia,32,847,32033,"rgb(231,41,138)"
12209,2020-06-10,Indonesia,40,1043,33076,"rgb(231,41,138)"
12210,2020-06-11,Indonesia,36,1240,34316,"rgb(231,41,138)"
12211,2020-06-12,Indonesia,41,979,35295,"rgb(231,41,138)"
12212,2020-06-13,Indonesia,48,1111,36406,"rgb(231,41,138)"
12213,2020-06-14,Indonesia,43,1014,37420,"rgb(231,41,138)"
12214,2020-06-15,Indonesia,43,857,38277,"rgb(231,41,138)"
12215,2020-06-16,Indonesia,64,1017,39294,"rgb(231,41,138)"
12216,2020-06-17,Indonesia,33,1106,40400,"rgb(231,41,138)"
12217,2020-06-18,Indonesia,45,1031,41431,"rgb(231,41,138)"
12218,2020-06-19,Indonesia,63,1331,42762,"rgb(231,41,138)"
12219,2020-06-20,Indonesia,34,1041,43803,"rgb(231,41,138)"
12220,2020-06-21,Indonesia,56,1226,45029,"rgb(231,41,138)"
12221,2020-06-22,Indonesia,36,862,45891,"rgb(231,41,138)"
12222,2020-06-23,Indonesia,35,954,46845,"rgb(231,41,138)"
12223,2020-06-24,Indonesia,35,1051,47896,"rgb(231,41,138)"
12224,2020-06-25,Indonesia,38,1113,49009,"rgb(231,41,138)"
12225,2020-06-26,Indonesia,47,1178,50187,"rgb(231,41,138)"
12226,2020-06-27,Indonesia,63,1240,51427,"rgb(231,41,138)"
12227,2020-06-28,Indonesia,37,1385,52812,"rgb(231,41,138)"
12228,2020-06-29,Indonesia,34,1198,54010,"rgb(231,41,138)"
12229,2020-06-30,Indonesia,51,1082,55092,"rgb(231,41,138)"
12230,2020-07-01,Indonesia,71,1293,56385,"rgb(231,41,138)"
12231,2020-07-02,Indonesia,58,1385,57770,"rgb(231,41,138)"
12232,2020-07-03,Indonesia,53,1624,59394,"rgb(231,41,138)"
12233,2020-07-04,Indonesia,49,1301,60695,"rgb(231,41,138)"
12234,2020-07-05,Indonesia,53,1447,62142,"rgb(231,41,138)"
12235,2020-07-06,Indonesia,82,1607,63749,"rgb(231,41,138)"
12236,2020-07-07,Indonesia,70,1209,64958,"rgb(231,41,138)"
12237,2020-07-08,Indonesia,68,1268,66226,"rgb(231,41,138)"
12238,2020-07-09,Indonesia,50,1853,68079,"rgb(231,41,138)"
12239,2020-07-10,Indonesia,58,2657,70736,"rgb(231,41,138)"
12240,2020-07-11,Indonesia,52,1611,72347,"rgb(231,41,138)"
12241,2020-07-12,Indonesia,66,1671,74018,"rgb(231,41,138)"
12242,2020-07-13,Indonesia,71,1681,75699,"rgb(231,41,138)"
12243,2019-12-31,Ireland,0,0,0,"rgb(102,166,30)"
12244,2020-01-01,Ireland,0,0,0,"rgb(102,166,30)"
12245,2020-01-02,Ireland,0,0,0,"rgb(102,166,30)"
12246,2020-01-03,Ireland,0,0,0,"rgb(102,166,30)"
12247,2020-01-04,Ireland,0,0,0,"rgb(102,166,30)"
12248,2020-01-05,Ireland,0,0,0,"rgb(102,166,30)"
12249,2020-01-06,Ireland,0,0,0,"rgb(102,166,30)"
12250,2020-01-07,Ireland,0,0,0,"rgb(102,166,30)"
12251,2020-01-08,Ireland,0,0,0,"rgb(102,166,30)"
12252,2020-01-09,Ireland,0,0,0,"rgb(102,166,30)"
12253,2020-01-10,Ireland,0,0,0,"rgb(102,166,30)"
12254,2020-01-11,Ireland,0,0,0,"rgb(102,166,30)"
12255,2020-01-12,Ireland,0,0,0,"rgb(102,166,30)"
12256,2020-01-13,Ireland,0,0,0,"rgb(102,166,30)"
12257,2020-01-14,Ireland,0,0,0,"rgb(102,166,30)"
12258,2020-01-15,Ireland,0,0,0,"rgb(102,166,30)"
12259,2020-01-16,Ireland,0,0,0,"rgb(102,166,30)"
12260,2020-01-17,Ireland,0,0,0,"rgb(102,166,30)"
12261,2020-01-18,Ireland,0,0,0,"rgb(102,166,30)"
12262,2020-01-19,Ireland,0,0,0,"rgb(102,166,30)"
12263,2020-01-20,Ireland,0,0,0,"rgb(102,166,30)"
12264,2020-01-21,Ireland,0,0,0,"rgb(102,166,30)"
12265,2020-01-22,Ireland,0,0,0,"rgb(102,166,30)"
12266,2020-01-23,Ireland,0,0,0,"rgb(102,166,30)"
12267,2020-01-24,Ireland,0,0,0,"rgb(102,166,30)"
12268,2020-01-25,Ireland,0,0,0,"rgb(102,166,30)"
12269,2020-01-26,Ireland,0,0,0,"rgb(102,166,30)"
12270,2020-01-27,Ireland,0,0,0,"rgb(102,166,30)"
12271,2020-01-28,Ireland,0,0,0,"rgb(102,166,30)"
12272,2020-01-29,Ireland,0,0,0,"rgb(102,166,30)"
12273,2020-01-30,Ireland,0,0,0,"rgb(102,166,30)"
12274,2020-01-31,Ireland,0,0,0,"rgb(102,166,30)"
12275,2020-02-01,Ireland,0,0,0,"rgb(102,166,30)"
12276,2020-02-02,Ireland,0,0,0,"rgb(102,166,30)"
12277,2020-02-03,Ireland,0,0,0,"rgb(102,166,30)"
12278,2020-02-04,Ireland,0,0,0,"rgb(102,166,30)"
12279,2020-02-05,Ireland,0,0,0,"rgb(102,166,30)"
12280,2020-02-06,Ireland,0,0,0,"rgb(102,166,30)"
12281,2020-02-07,Ireland,0,0,0,"rgb(102,166,30)"
12282,2020-02-08,Ireland,0,0,0,"rgb(102,166,30)"
12283,2020-02-09,Ireland,0,0,0,"rgb(102,166,30)"
12284,2020-02-10,Ireland,0,0,0,"rgb(102,166,30)"
12285,2020-02-11,Ireland,0,0,0,"rgb(102,166,30)"
12286,2020-02-12,Ireland,0,0,0,"rgb(102,166,30)"
12287,2020-02-13,Ireland,0,0,0,"rgb(102,166,30)"
12288,2020-02-14,Ireland,0,0,0,"rgb(102,166,30)"
12289,2020-02-15,Ireland,0,0,0,"rgb(102,166,30)"
12290,2020-02-16,Ireland,0,0,0,"rgb(102,166,30)"
12291,2020-02-17,Ireland,0,0,0,"rgb(102,166,30)"
12292,2020-02-18,Ireland,0,0,0,"rgb(102,166,30)"
12293,2020-02-19,Ireland,0,0,0,"rgb(102,166,30)"
12294,2020-02-20,Ireland,0,0,0,"rgb(102,166,30)"
12295,2020-02-21,Ireland,0,0,0,"rgb(102,166,30)"
12296,2020-02-22,Ireland,0,0,0,"rgb(102,166,30)"
12297,2020-02-23,Ireland,0,0,0,"rgb(102,166,30)"
12298,2020-02-24,Ireland,0,0,0,"rgb(102,166,30)"
12299,2020-02-25,Ireland,0,0,0,"rgb(102,166,30)"
12300,2020-02-26,Ireland,0,0,0,"rgb(102,166,30)"
12301,2020-02-27,Ireland,0,0,0,"rgb(102,166,30)"
12302,2020-02-28,Ireland,0,0,0,"rgb(102,166,30)"
12303,2020-02-29,Ireland,0,0,0,"rgb(102,166,30)"
12304,2020-03-01,Ireland,0,1,1,"rgb(102,166,30)"
12305,2020-03-02,Ireland,0,0,1,"rgb(102,166,30)"
12306,2020-03-04,Ireland,0,1,2,"rgb(102,166,30)"
12307,2020-03-05,Ireland,0,4,6,"rgb(102,166,30)"
12308,2020-03-06,Ireland,0,7,13,"rgb(102,166,30)"
12309,2020-03-07,Ireland,0,5,18,"rgb(102,166,30)"
12310,2020-03-08,Ireland,0,1,19,"rgb(102,166,30)"
12311,2020-03-09,Ireland,0,2,21,"rgb(102,166,30)"
12312,2020-03-11,Ireland,0,14,35,"rgb(102,166,30)"
12313,2020-03-12,Ireland,1,8,43,"rgb(102,166,30)"
12314,2020-03-13,Ireland,0,27,70,"rgb(102,166,30)"
12315,2020-03-14,Ireland,0,21,91,"rgb(102,166,30)"
12316,2020-03-15,Ireland,1,38,129,"rgb(102,166,30)"
12317,2020-03-16,Ireland,0,40,169,"rgb(102,166,30)"
12318,2020-03-17,Ireland,0,54,223,"rgb(102,166,30)"
12319,2020-03-18,Ireland,0,69,292,"rgb(102,166,30)"
12320,2020-03-19,Ireland,0,74,366,"rgb(102,166,30)"
12321,2020-03-20,Ireland,1,191,557,"rgb(102,166,30)"
12322,2020-03-21,Ireland,0,126,683,"rgb(102,166,30)"
12323,2020-03-22,Ireland,0,102,785,"rgb(102,166,30)"
12324,2020-03-23,Ireland,1,121,906,"rgb(102,166,30)"
12325,2020-03-24,Ireland,2,219,1125,"rgb(102,166,30)"
12326,2020-03-25,Ireland,1,204,1329,"rgb(102,166,30)"
12327,2020-03-26,Ireland,2,235,1564,"rgb(102,166,30)"
12328,2020-03-27,Ireland,10,255,1819,"rgb(102,166,30)"
12329,2020-03-28,Ireland,3,302,2121,"rgb(102,166,30)"
12330,2020-03-29,Ireland,14,294,2415,"rgb(102,166,30)"
12331,2020-03-30,Ireland,10,200,2615,"rgb(102,166,30)"
12332,2020-03-31,Ireland,8,295,2910,"rgb(102,166,30)"
12333,2020-04-01,Ireland,17,325,3235,"rgb(102,166,30)"
12334,2020-04-02,Ireland,14,212,3447,"rgb(102,166,30)"
12335,2020-04-03,Ireland,13,402,3849,"rgb(102,166,30)"
12336,2020-04-04,Ireland,22,424,4273,"rgb(102,166,30)"
12337,2020-04-05,Ireland,17,331,4604,"rgb(102,166,30)"
12338,2020-04-06,Ireland,21,507,5111,"rgb(102,166,30)"
12339,2020-04-07,Ireland,16,253,5364,"rgb(102,166,30)"
12340,2020-04-08,Ireland,36,345,5709,"rgb(102,166,30)"
12341,2020-04-09,Ireland,25,515,6224,"rgb(102,166,30)"
12342,2020-04-10,Ireland,28,1169,7393,"rgb(102,166,30)"
12343,2020-04-11,Ireland,24,696,8089,"rgb(102,166,30)"
12344,2020-04-12,Ireland,33,839,8928,"rgb(102,166,30)"
12345,2020-04-13,Ireland,14,727,9655,"rgb(102,166,30)"
12346,2020-04-14,Ireland,31,992,10647,"rgb(102,166,30)"
12347,2020-04-15,Ireland,41,832,11479,"rgb(102,166,30)"
12348,2020-04-16,Ireland,38,1068,12547,"rgb(102,166,30)"
12349,2020-04-17,Ireland,42,724,13271,"rgb(102,166,30)"
12350,2020-04-18,Ireland,44,709,13980,"rgb(102,166,30)"
12351,2020-04-19,Ireland,41,778,14758,"rgb(102,166,30)"
12352,2020-04-20,Ireland,39,493,15251,"rgb(102,166,30)"
12353,2020-04-21,Ireland,77,401,15652,"rgb(102,166,30)"
12354,2020-04-22,Ireland,43,388,16040,"rgb(102,166,30)"
12355,2020-04-23,Ireland,39,631,16671,"rgb(102,166,30)"
12356,2020-04-24,Ireland,25,936,17607,"rgb(102,166,30)"
12357,2020-04-25,Ireland,35,577,18184,"rgb(102,166,30)"
12358,2020-04-26,Ireland,234,377,18561,"rgb(102,166,30)"
12359,2020-04-27,Ireland,24,701,19262,"rgb(102,166,30)"
12360,2020-04-28,Ireland,15,386,19648,"rgb(102,166,30)"
12361,2020-04-29,Ireland,57,229,19877,"rgb(102,166,30)"
12362,2020-04-30,Ireland,31,376,20253,"rgb(102,166,30)"
12363,2020-05-01,Ireland,42,359,20612,"rgb(102,166,30)"
12364,2020-05-02,Ireland,33,221,20833,"rgb(102,166,30)"
12365,2020-05-03,Ireland,0,343,21176,"rgb(102,166,30)"
12366,2020-05-04,Ireland,38,330,21506,"rgb(102,166,30)"
12367,2020-05-05,Ireland,16,216,21722,"rgb(102,166,30)"
12368,2020-05-06,Ireland,20,261,21983,"rgb(102,166,30)"
12369,2020-05-07,Ireland,36,265,22248,"rgb(102,166,30)"
12370,2020-05-08,Ireland,28,137,22385,"rgb(102,166,30)"
12371,2020-05-09,Ireland,26,156,22541,"rgb(102,166,30)"
12372,2020-05-10,Ireland,17,219,22760,"rgb(102,166,30)"
12373,2020-05-11,Ireland,12,236,22996,"rgb(102,166,30)"
12374,2020-05-12,Ireland,9,139,23135,"rgb(102,166,30)"
12375,2020-05-13,Ireland,21,107,23242,"rgb(102,166,30)"
12376,2020-05-14,Ireland,9,159,23401,"rgb(102,166,30)"
12377,2020-05-15,Ireland,9,426,23827,"rgb(102,166,30)"
12378,2020-05-16,Ireland,12,129,23956,"rgb(102,166,30)"
12379,2020-05-17,Ireland,15,92,24048,"rgb(102,166,30)"
12380,2020-05-18,Ireland,10,64,24112,"rgb(102,166,30)"
12381,2020-05-19,Ireland,4,88,24200,"rgb(102,166,30)"
12382,2020-05-20,Ireland,14,51,24251,"rgb(102,166,30)"
12383,2020-05-21,Ireland,10,64,24315,"rgb(102,166,30)"
12384,2020-05-22,Ireland,12,76,24391,"rgb(102,166,30)"
12385,2020-05-23,Ireland,9,115,24506,"rgb(102,166,30)"
12386,2020-05-24,Ireland,12,76,24582,"rgb(102,166,30)"
12387,2020-05-25,Ireland,2,57,24639,"rgb(102,166,30)"
12388,2020-05-26,Ireland,0,59,24698,"rgb(102,166,30)"
12389,2020-05-27,Ireland,9,37,24735,"rgb(102,166,30)"
12390,2020-05-28,Ireland,16,68,24803,"rgb(102,166,30)"
12391,2020-05-29,Ireland,8,38,24841,"rgb(102,166,30)"
12392,2020-05-30,Ireland,6,35,24876,"rgb(102,166,30)"
12393,2020-05-31,Ireland,5,53,24929,"rgb(102,166,30)"
12394,2020-06-01,Ireland,0,61,24990,"rgb(102,166,30)"
12395,2020-06-02,Ireland,0,72,25062,"rgb(102,166,30)"
12396,2020-06-03,Ireland,8,4,25066,"rgb(102,166,30)"
12397,2020-06-04,Ireland,1,45,25111,"rgb(102,166,30)"
12398,2020-06-05,Ireland,5,31,25142,"rgb(102,166,30)"
12399,2020-06-06,Ireland,6,21,25163,"rgb(102,166,30)"
12400,2020-06-07,Ireland,0,20,25183,"rgb(102,166,30)"
12401,2020-06-08,Ireland,9,18,25201,"rgb(102,166,30)"
12402,2020-06-09,Ireland,4,6,25207,"rgb(102,166,30)"
12403,2020-06-10,Ireland,8,8,25215,"rgb(102,166,30)"
12404,2020-06-11,Ireland,4,16,25231,"rgb(102,166,30)"
12405,2020-06-12,Ireland,8,7,25238,"rgb(102,166,30)"
12406,2020-06-13,Ireland,2,12,25250,"rgb(102,166,30)"
12407,2020-06-14,Ireland,0,45,25295,"rgb(102,166,30)"
12408,2020-06-15,Ireland,1,8,25303,"rgb(102,166,30)"
12409,2020-06-16,Ireland,0,18,25321,"rgb(102,166,30)"
12410,2020-06-17,Ireland,3,13,25334,"rgb(102,166,30)"
12411,2020-06-18,Ireland,1,7,25341,"rgb(102,166,30)"
12412,2020-06-19,Ireland,4,14,25355,"rgb(102,166,30)"
12413,2020-06-20,Ireland,0,13,25368,"rgb(102,166,30)"
12414,2020-06-21,Ireland,1,6,25374,"rgb(102,166,30)"
12415,2020-06-22,Ireland,0,5,25379,"rgb(102,166,30)"
12416,2020-06-23,Ireland,2,4,25383,"rgb(102,166,30)"
12417,2020-06-24,Ireland,3,8,25391,"rgb(102,166,30)"
12418,2020-06-25,Ireland,6,5,25396,"rgb(102,166,30)"
12419,2020-06-26,Ireland,1,9,25405,"rgb(102,166,30)"
12420,2020-06-27,Ireland,3,9,25414,"rgb(102,166,30)"
12421,2020-06-28,Ireland,4,23,25437,"rgb(102,166,30)"
12422,2020-06-29,Ireland,1,2,25439,"rgb(102,166,30)"
12423,2020-06-30,Ireland,0,23,25462,"rgb(102,166,30)"
12424,2020-07-01,Ireland,1,11,25473,"rgb(102,166,30)"
12425,2020-07-02,Ireland,2,4,25477,"rgb(102,166,30)"
12426,2020-07-03,Ireland,0,12,25489,"rgb(102,166,30)"
12427,2020-07-04,Ireland,2,9,25498,"rgb(102,166,30)"
12428,2020-07-05,Ireland,1,11,25509,"rgb(102,166,30)"
12429,2020-07-06,Ireland,0,18,25527,"rgb(102,166,30)"
12430,2020-07-07,Ireland,0,4,25531,"rgb(102,166,30)"
12431,2020-07-08,Ireland,2,7,25538,"rgb(102,166,30)"
12432,2020-07-09,Ireland,0,4,25542,"rgb(102,166,30)"
12433,2020-07-10,Ireland,0,23,25565,"rgb(102,166,30)"
12434,2020-07-11,Ireland,1,24,25589,"rgb(102,166,30)"
12435,2020-07-12,Ireland,2,22,25611,"rgb(102,166,30)"
12436,2020-07-13,Ireland,0,17,25628,"rgb(102,166,30)"
12437,2019-12-31,Israel,0,0,0,"rgb(230,171,2)"
12438,2020-01-01,Israel,0,0,0,"rgb(230,171,2)"
12439,2020-01-02,Israel,0,0,0,"rgb(230,171,2)"
12440,2020-01-03,Israel,0,0,0,"rgb(230,171,2)"
12441,2020-01-04,Israel,0,0,0,"rgb(230,171,2)"
12442,2020-01-05,Israel,0,0,0,"rgb(230,171,2)"
12443,2020-01-06,Israel,0,0,0,"rgb(230,171,2)"
12444,2020-01-07,Israel,0,0,0,"rgb(230,171,2)"
12445,2020-01-08,Israel,0,0,0,"rgb(230,171,2)"
12446,2020-01-09,Israel,0,0,0,"rgb(230,171,2)"
12447,2020-01-10,Israel,0,0,0,"rgb(230,171,2)"
12448,2020-01-11,Israel,0,0,0,"rgb(230,171,2)"
12449,2020-01-12,Israel,0,0,0,"rgb(230,171,2)"
12450,2020-01-13,Israel,0,0,0,"rgb(230,171,2)"
12451,2020-01-14,Israel,0,0,0,"rgb(230,171,2)"
12452,2020-01-15,Israel,0,0,0,"rgb(230,171,2)"
12453,2020-01-16,Israel,0,0,0,"rgb(230,171,2)"
12454,2020-01-17,Israel,0,0,0,"rgb(230,171,2)"
12455,2020-01-18,Israel,0,0,0,"rgb(230,171,2)"
12456,2020-01-19,Israel,0,0,0,"rgb(230,171,2)"
12457,2020-01-20,Israel,0,0,0,"rgb(230,171,2)"
12458,2020-01-21,Israel,0,0,0,"rgb(230,171,2)"
12459,2020-01-22,Israel,0,0,0,"rgb(230,171,2)"
12460,2020-01-23,Israel,0,0,0,"rgb(230,171,2)"
12461,2020-01-24,Israel,0,0,0,"rgb(230,171,2)"
12462,2020-01-25,Israel,0,0,0,"rgb(230,171,2)"
12463,2020-01-26,Israel,0,0,0,"rgb(230,171,2)"
12464,2020-01-27,Israel,0,0,0,"rgb(230,171,2)"
12465,2020-01-28,Israel,0,0,0,"rgb(230,171,2)"
12466,2020-01-29,Israel,0,0,0,"rgb(230,171,2)"
12467,2020-01-30,Israel,0,0,0,"rgb(230,171,2)"
12468,2020-01-31,Israel,0,0,0,"rgb(230,171,2)"
12469,2020-02-01,Israel,0,0,0,"rgb(230,171,2)"
12470,2020-02-02,Israel,0,0,0,"rgb(230,171,2)"
12471,2020-02-03,Israel,0,0,0,"rgb(230,171,2)"
12472,2020-02-04,Israel,0,0,0,"rgb(230,171,2)"
12473,2020-02-05,Israel,0,0,0,"rgb(230,171,2)"
12474,2020-02-06,Israel,0,0,0,"rgb(230,171,2)"
12475,2020-02-07,Israel,0,0,0,"rgb(230,171,2)"
12476,2020-02-08,Israel,0,0,0,"rgb(230,171,2)"
12477,2020-02-09,Israel,0,0,0,"rgb(230,171,2)"
12478,2020-02-10,Israel,0,0,0,"rgb(230,171,2)"
12479,2020-02-11,Israel,0,0,0,"rgb(230,171,2)"
12480,2020-02-12,Israel,0,0,0,"rgb(230,171,2)"
12481,2020-02-13,Israel,0,0,0,"rgb(230,171,2)"
12482,2020-02-14,Israel,0,0,0,"rgb(230,171,2)"
12483,2020-02-15,Israel,0,0,0,"rgb(230,171,2)"
12484,2020-02-16,Israel,0,0,0,"rgb(230,171,2)"
12485,2020-02-17,Israel,0,0,0,"rgb(230,171,2)"
12486,2020-02-18,Israel,0,0,0,"rgb(230,171,2)"
12487,2020-02-19,Israel,0,0,0,"rgb(230,171,2)"
12488,2020-02-20,Israel,0,0,0,"rgb(230,171,2)"
12489,2020-02-21,Israel,0,0,0,"rgb(230,171,2)"
12490,2020-02-22,Israel,0,1,1,"rgb(230,171,2)"
12491,2020-02-23,Israel,0,0,1,"rgb(230,171,2)"
12492,2020-02-24,Israel,0,1,2,"rgb(230,171,2)"
12493,2020-02-25,Israel,0,0,2,"rgb(230,171,2)"
12494,2020-02-26,Israel,0,0,2,"rgb(230,171,2)"
12495,2020-02-27,Israel,0,0,2,"rgb(230,171,2)"
12496,2020-02-28,Israel,0,1,3,"rgb(230,171,2)"
12497,2020-02-29,Israel,0,4,7,"rgb(230,171,2)"
12498,2020-03-01,Israel,0,0,7,"rgb(230,171,2)"
12499,2020-03-02,Israel,0,3,10,"rgb(230,171,2)"
12500,2020-03-05,Israel,0,5,15,"rgb(230,171,2)"
12501,2020-03-06,Israel,0,2,17,"rgb(230,171,2)"
12502,2020-03-07,Israel,0,2,19,"rgb(230,171,2)"
12503,2020-03-08,Israel,0,6,25,"rgb(230,171,2)"
12504,2020-03-09,Israel,0,14,39,"rgb(230,171,2)"
12505,2020-03-11,Israel,0,31,70,"rgb(230,171,2)"
12506,2020-03-12,Israel,0,12,82,"rgb(230,171,2)"
12507,2020-03-13,Israel,0,14,96,"rgb(230,171,2)"
12508,2020-03-14,Israel,0,20,116,"rgb(230,171,2)"
12509,2020-03-15,Israel,0,62,178,"rgb(230,171,2)"
12510,2020-03-16,Israel,0,72,250,"rgb(230,171,2)"
12511,2020-03-17,Israel,0,10,260,"rgb(230,171,2)"
12512,2020-03-18,Israel,0,167,427,"rgb(230,171,2)"
12513,2020-03-19,Israel,0,6,433,"rgb(230,171,2)"
12514,2020-03-20,Israel,0,244,677,"rgb(230,171,2)"
12515,2020-03-21,Israel,1,35,712,"rgb(230,171,2)"
12516,2020-03-22,Israel,0,171,883,"rgb(230,171,2)"
12517,2020-03-23,Israel,0,188,1071,"rgb(230,171,2)"
12518,2020-03-24,Israel,0,371,1442,"rgb(230,171,2)"
12519,2020-03-25,Israel,2,488,1930,"rgb(230,171,2)"
12520,2020-03-26,Israel,2,439,2369,"rgb(230,171,2)"
12521,2020-03-27,Israel,3,297,2666,"rgb(230,171,2)"
12522,2020-03-28,Israel,2,369,3035,"rgb(230,171,2)"
12523,2020-03-29,Israel,2,584,3619,"rgb(230,171,2)"
12524,2020-03-30,Israel,3,628,4247,"rgb(230,171,2)"
12525,2020-03-31,Israel,2,226,4473,"rgb(230,171,2)"
12526,2020-04-01,Israel,3,443,4916,"rgb(230,171,2)"
12527,2020-04-02,Israel,1,675,5591,"rgb(230,171,2)"
12528,2020-04-03,Israel,13,661,6252,"rgb(230,171,2)"
12529,2020-04-04,Israel,5,1176,7428,"rgb(230,171,2)"
12530,2020-04-05,Israel,7,590,8018,"rgb(230,171,2)"
12531,2020-04-06,Israel,3,412,8430,"rgb(230,171,2)"
12532,2020-04-07,Israel,8,474,8904,"rgb(230,171,2)"
12533,2020-04-08,Israel,8,344,9248,"rgb(230,171,2)"
12534,2020-04-09,Israel,6,156,9404,"rgb(230,171,2)"
12535,2020-04-10,Israel,15,564,9968,"rgb(230,171,2)"
12536,2020-04-11,Israel,9,440,10408,"rgb(230,171,2)"
12537,2020-04-12,Israel,6,335,10743,"rgb(230,171,2)"
12538,2020-04-13,Israel,2,402,11145,"rgb(230,171,2)"
12539,2020-04-14,Israel,13,441,11586,"rgb(230,171,2)"
12540,2020-04-15,Israel,7,460,12046,"rgb(230,171,2)"
12541,2020-04-16,Israel,7,455,12501,"rgb(230,171,2)"
12542,2020-04-17,Israel,12,257,12758,"rgb(230,171,2)"
12543,2020-04-18,Israel,9,224,12982,"rgb(230,171,2)"
12544,2020-04-19,Israel,13,283,13265,"rgb(230,171,2)"
12545,2020-04-20,Israel,8,226,13491,"rgb(230,171,2)"
12546,2020-04-21,Israel,5,222,13713,"rgb(230,171,2)"
12547,2020-04-22,Israel,7,229,13942,"rgb(230,171,2)"
12548,2020-04-23,Israel,7,650,14592,"rgb(230,171,2)"
12549,2020-04-24,Israel,2,290,14882,"rgb(230,171,2)"
12550,2020-04-25,Israel,1,176,15058,"rgb(230,171,2)"
12551,2020-04-26,Israel,5,240,15298,"rgb(230,171,2)"
12552,2020-04-27,Israel,0,100,15398,"rgb(230,171,2)"
12553,2020-04-28,Israel,3,68,15466,"rgb(230,171,2)"
12554,2020-04-29,Israel,6,123,15589,"rgb(230,171,2)"
12555,2020-04-30,Israel,7,245,15834,"rgb(230,171,2)"
12556,2020-05-01,Israel,7,112,15946,"rgb(230,171,2)"
12557,2020-05-02,Israel,3,155,16101,"rgb(230,171,2)"
12558,2020-05-03,Israel,4,84,16185,"rgb(230,171,2)"
12559,2020-05-04,Israel,3,23,16208,"rgb(230,171,2)"
12560,2020-05-05,Israel,3,38,16246,"rgb(230,171,2)"
12561,2020-05-06,Israel,3,43,16289,"rgb(230,171,2)"
12562,2020-05-07,Israel,1,21,16310,"rgb(230,171,2)"
12563,2020-05-08,Israel,1,71,16381,"rgb(230,171,2)"
12564,2020-05-09,Israel,5,55,16436,"rgb(230,171,2)"
12565,2020-05-10,Israel,2,18,16454,"rgb(230,171,2)"
12566,2020-05-11,Israel,5,23,16477,"rgb(230,171,2)"
12567,2020-05-12,Israel,6,29,16506,"rgb(230,171,2)"
12568,2020-05-13,Israel,2,23,16529,"rgb(230,171,2)"
12569,2020-05-14,Israel,4,19,16548,"rgb(230,171,2)"
12570,2020-05-15,Israel,1,31,16579,"rgb(230,171,2)"
12571,2020-05-16,Israel,1,10,16589,"rgb(230,171,2)"
12572,2020-05-17,Israel,2,19,16608,"rgb(230,171,2)"
12573,2020-05-18,Israel,4,9,16617,"rgb(230,171,2)"
12574,2020-05-19,Israel,0,4,16621,"rgb(230,171,2)"
12575,2020-05-20,Israel,5,29,16650,"rgb(230,171,2)"
12576,2020-05-21,Israel,2,20,16670,"rgb(230,171,2)"
12577,2020-05-22,Israel,0,20,16690,"rgb(230,171,2)"
12578,2020-05-23,Israel,0,0,16690,"rgb(230,171,2)"
12579,2020-05-24,Israel,0,0,16690,"rgb(230,171,2)"
12580,2020-05-25,Israel,1,30,16720,"rgb(230,171,2)"
12581,2020-05-26,Israel,1,14,16734,"rgb(230,171,2)"
12582,2020-05-27,Israel,0,23,16757,"rgb(230,171,2)"
12583,2020-05-28,Israel,0,36,16793,"rgb(230,171,2)"
12584,2020-05-29,Israel,3,79,16872,"rgb(230,171,2)"
12585,2020-05-30,Israel,0,115,16987,"rgb(230,171,2)"
12586,2020-05-31,Israel,0,25,17012,"rgb(230,171,2)"
12587,2020-06-01,Israel,1,59,17071,"rgb(230,171,2)"
12588,2020-06-02,Israel,2,148,17219,"rgb(230,171,2)"
12589,2020-06-03,Israel,3,123,17342,"rgb(230,171,2)"
12590,2020-06-04,Israel,1,87,17429,"rgb(230,171,2)"
12591,2020-06-05,Israel,0,133,17562,"rgb(230,171,2)"
12592,2020-06-06,Israel,1,144,17706,"rgb(230,171,2)"
12593,2020-06-07,Israel,5,77,17783,"rgb(230,171,2)"
12594,2020-06-08,Israel,1,132,17915,"rgb(230,171,2)"
12595,2020-06-09,Israel,0,174,18089,"rgb(230,171,2)"
12596,2020-06-10,Israel,1,179,18268,"rgb(230,171,2)"
12597,2020-06-11,Israel,0,87,18355,"rgb(230,171,2)"
12598,2020-06-12,Israel,1,346,18701,"rgb(230,171,2)"
12599,2020-06-13,Israel,0,175,18876,"rgb(230,171,2)"
12600,2020-06-14,Israel,0,132,19008,"rgb(230,171,2)"
12601,2020-06-15,Israel,2,113,19121,"rgb(230,171,2)"
12602,2020-06-16,Israel,0,217,19338,"rgb(230,171,2)"
12603,2020-06-17,Israel,1,299,19637,"rgb(230,171,2)"
12604,2020-06-18,Israel,0,257,19894,"rgb(230,171,2)"
12605,2020-06-19,Israel,0,142,20036,"rgb(230,171,2)"
12606,2020-06-20,Israel,1,303,20339,"rgb(230,171,2)"
12607,2020-06-21,Israel,1,294,20633,"rgb(230,171,2)"
12608,2020-06-22,Israel,1,145,20778,"rgb(230,171,2)"
12609,2020-06-23,Israel,1,304,21082,"rgb(230,171,2)"
12610,2020-06-24,Israel,1,430,21512,"rgb(230,171,2)"
12611,2020-06-25,Israel,0,532,22044,"rgb(230,171,2)"
12612,2020-06-26,Israel,1,356,22400,"rgb(230,171,2)"
12613,2020-06-27,Israel,5,400,22800,"rgb(230,171,2)"
12614,2020-06-28,Israel,3,621,23421,"rgb(230,171,2)"
12615,2020-06-29,Israel,1,334,23755,"rgb(230,171,2)"
12616,2020-06-30,Israel,1,686,24441,"rgb(230,171,2)"
12617,2020-07-01,Israel,1,803,25244,"rgb(230,171,2)"
12618,2020-07-02,Israel,2,1013,26257,"rgb(230,171,2)"
12619,2020-07-03,Israel,3,1285,27542,"rgb(230,171,2)"
12620,2020-07-04,Israel,1,513,28055,"rgb(230,171,2)"
12621,2020-07-05,Israel,4,1115,29170,"rgb(230,171,2)"
12622,2020-07-06,Israel,1,788,29958,"rgb(230,171,2)"
12623,2020-07-07,Israel,7,1228,31186,"rgb(230,171,2)"
12624,2020-07-08,Israel,4,1036,32222,"rgb(230,171,2)"
12625,2020-07-09,Israel,2,1335,33557,"rgb(230,171,2)"
12626,2020-07-10,Israel,4,1268,34825,"rgb(230,171,2)"
12627,2020-07-11,Israel,3,1441,36266,"rgb(230,171,2)"
12628,2020-07-12,Israel,3,1197,37463,"rgb(230,171,2)"
12629,2020-07-13,Israel,8,1207,38670,"rgb(230,171,2)"
12630,2020-03-21,Isle of Man,0,1,1,"rgb(166,118,29)"
12631,2020-03-22,Isle of Man,0,1,2,"rgb(166,118,29)"
12632,2020-03-23,Isle of Man,0,0,2,"rgb(166,118,29)"
12633,2020-03-24,Isle of Man,0,11,13,"rgb(166,118,29)"
12634,2020-03-25,Isle of Man,0,10,23,"rgb(166,118,29)"
12635,2020-03-26,Isle of Man,0,0,23,"rgb(166,118,29)"
12636,2020-03-27,Isle of Man,0,3,26,"rgb(166,118,29)"
12637,2020-03-28,Isle of Man,0,3,29,"rgb(166,118,29)"
12638,2020-03-29,Isle of Man,0,3,32,"rgb(166,118,29)"
12639,2020-03-30,Isle of Man,0,10,42,"rgb(166,118,29)"
12640,2020-03-31,Isle of Man,0,0,42,"rgb(166,118,29)"
12641,2020-04-01,Isle of Man,0,10,52,"rgb(166,118,29)"
12642,2020-04-02,Isle of Man,0,13,65,"rgb(166,118,29)"
12643,2020-04-03,Isle of Man,1,6,71,"rgb(166,118,29)"
12644,2020-04-04,Isle of Man,0,43,114,"rgb(166,118,29)"
12645,2020-04-05,Isle of Man,0,12,126,"rgb(166,118,29)"
12646,2020-04-06,Isle of Man,0,1,127,"rgb(166,118,29)"
12647,2020-04-07,Isle of Man,0,12,139,"rgb(166,118,29)"
12648,2020-04-08,Isle of Man,0,11,150,"rgb(166,118,29)"
12649,2020-04-09,Isle of Man,0,8,158,"rgb(166,118,29)"
12650,2020-04-10,Isle of Man,0,32,190,"rgb(166,118,29)"
12651,2020-04-11,Isle of Man,0,11,201,"rgb(166,118,29)"
12652,2020-04-12,Isle of Man,0,25,226,"rgb(166,118,29)"
12653,2020-04-13,Isle of Man,1,2,228,"rgb(166,118,29)"
12654,2020-04-14,Isle of Man,0,14,242,"rgb(166,118,29)"
12655,2020-04-15,Isle of Man,0,0,242,"rgb(166,118,29)"
12656,2020-04-16,Isle of Man,0,12,254,"rgb(166,118,29)"
12657,2020-04-17,Isle of Man,2,30,284,"rgb(166,118,29)"
12658,2020-04-18,Isle of Man,0,5,289,"rgb(166,118,29)"
12659,2020-04-19,Isle of Man,2,8,297,"rgb(166,118,29)"
12660,2020-04-20,Isle of Man,0,1,298,"rgb(166,118,29)"
12661,2020-04-21,Isle of Man,3,2,300,"rgb(166,118,29)"
12662,2020-04-22,Isle of Man,1,7,307,"rgb(166,118,29)"
12663,2020-04-23,Isle of Man,5,0,307,"rgb(166,118,29)"
12664,2020-04-24,Isle of Man,1,0,307,"rgb(166,118,29)"
12665,2020-04-25,Isle of Man,2,1,308,"rgb(166,118,29)"
12666,2020-04-26,Isle of Man,0,0,308,"rgb(166,118,29)"
12667,2020-04-27,Isle of Man,0,0,308,"rgb(166,118,29)"
12668,2020-04-28,Isle of Man,0,0,308,"rgb(166,118,29)"
12669,2020-04-29,Isle of Man,3,1,309,"rgb(166,118,29)"
12670,2020-04-30,Isle of Man,0,4,313,"rgb(166,118,29)"
12671,2020-05-01,Isle of Man,0,2,315,"rgb(166,118,29)"
12672,2020-05-02,Isle of Man,1,1,316,"rgb(166,118,29)"
12673,2020-05-03,Isle of Man,0,4,320,"rgb(166,118,29)"
12674,2020-05-04,Isle of Man,0,1,321,"rgb(166,118,29)"
12675,2020-05-05,Isle of Man,1,4,325,"rgb(166,118,29)"
12676,2020-05-06,Isle of Man,0,1,326,"rgb(166,118,29)"
12677,2020-05-07,Isle of Man,0,1,327,"rgb(166,118,29)"
12678,2020-05-08,Isle of Man,0,2,329,"rgb(166,118,29)"
12679,2020-05-09,Isle of Man,0,0,329,"rgb(166,118,29)"
12680,2020-05-10,Isle of Man,0,1,330,"rgb(166,118,29)"
12681,2020-05-11,Isle of Man,0,0,330,"rgb(166,118,29)"
12682,2020-05-12,Isle of Man,0,0,330,"rgb(166,118,29)"
12683,2020-05-13,Isle of Man,0,1,331,"rgb(166,118,29)"
12684,2020-05-14,Isle of Man,0,1,332,"rgb(166,118,29)"
12685,2020-05-15,Isle of Man,0,0,332,"rgb(166,118,29)"
12686,2020-05-16,Isle of Man,1,2,334,"rgb(166,118,29)"
12687,2020-05-17,Isle of Man,0,1,335,"rgb(166,118,29)"
12688,2020-05-18,Isle of Man,0,0,335,"rgb(166,118,29)"
12689,2020-05-19,Isle of Man,0,0,335,"rgb(166,118,29)"
12690,2020-05-20,Isle of Man,0,0,335,"rgb(166,118,29)"
12691,2020-05-21,Isle of Man,0,1,336,"rgb(166,118,29)"
12692,2020-05-22,Isle of Man,0,0,336,"rgb(166,118,29)"
12693,2020-05-23,Isle of Man,0,0,336,"rgb(166,118,29)"
12694,2020-05-24,Isle of Man,0,0,336,"rgb(166,118,29)"
12695,2020-05-25,Isle of Man,0,0,336,"rgb(166,118,29)"
12696,2020-05-26,Isle of Man,0,0,336,"rgb(166,118,29)"
12697,2020-05-27,Isle of Man,0,0,336,"rgb(166,118,29)"
12698,2020-05-28,Isle of Man,0,0,336,"rgb(166,118,29)"
12699,2020-05-29,Isle of Man,0,0,336,"rgb(166,118,29)"
12700,2020-05-30,Isle of Man,0,0,336,"rgb(166,118,29)"
12701,2020-05-31,Isle of Man,0,0,336,"rgb(166,118,29)"
12702,2020-06-01,Isle of Man,0,0,336,"rgb(166,118,29)"
12703,2020-06-02,Isle of Man,0,0,336,"rgb(166,118,29)"
12704,2020-06-03,Isle of Man,0,0,336,"rgb(166,118,29)"
12705,2020-06-04,Isle of Man,0,0,336,"rgb(166,118,29)"
12706,2020-06-05,Isle of Man,0,0,336,"rgb(166,118,29)"
12707,2020-06-06,Isle of Man,0,0,336,"rgb(166,118,29)"
12708,2020-06-07,Isle of Man,0,0,336,"rgb(166,118,29)"
12709,2020-06-08,Isle of Man,0,0,336,"rgb(166,118,29)"
12710,2020-06-09,Isle of Man,0,0,336,"rgb(166,118,29)"
12711,2020-06-10,Isle of Man,0,0,336,"rgb(166,118,29)"
12712,2020-06-11,Isle of Man,0,0,336,"rgb(166,118,29)"
12713,2020-06-12,Isle of Man,0,0,336,"rgb(166,118,29)"
12714,2020-06-13,Isle of Man,0,0,336,"rgb(166,118,29)"
12715,2020-06-14,Isle of Man,0,0,336,"rgb(166,118,29)"
12716,2020-06-15,Isle of Man,0,0,336,"rgb(166,118,29)"
12717,2020-06-16,Isle of Man,0,0,336,"rgb(166,118,29)"
12718,2020-06-17,Isle of Man,0,0,336,"rgb(166,118,29)"
12719,2020-06-18,Isle of Man,0,0,336,"rgb(166,118,29)"
12720,2020-06-19,Isle of Man,0,0,336,"rgb(166,118,29)"
12721,2020-06-20,Isle of Man,0,0,336,"rgb(166,118,29)"
12722,2020-06-21,Isle of Man,0,0,336,"rgb(166,118,29)"
12723,2020-06-22,Isle of Man,0,0,336,"rgb(166,118,29)"
12724,2020-06-23,Isle of Man,0,0,336,"rgb(166,118,29)"
12725,2020-06-24,Isle of Man,0,0,336,"rgb(166,118,29)"
12726,2020-06-25,Isle of Man,0,0,336,"rgb(166,118,29)"
12727,2020-06-26,Isle of Man,0,0,336,"rgb(166,118,29)"
12728,2020-06-27,Isle of Man,0,0,336,"rgb(166,118,29)"
12729,2020-06-28,Isle of Man,0,0,336,"rgb(166,118,29)"
12730,2020-06-29,Isle of Man,0,0,336,"rgb(166,118,29)"
12731,2020-06-30,Isle of Man,0,0,336,"rgb(166,118,29)"
12732,2020-07-01,Isle of Man,0,0,336,"rgb(166,118,29)"
12733,2020-07-02,Isle of Man,0,0,336,"rgb(166,118,29)"
12734,2020-07-03,Isle of Man,0,0,336,"rgb(166,118,29)"
12735,2020-07-04,Isle of Man,0,0,336,"rgb(166,118,29)"
12736,2020-07-05,Isle of Man,0,0,336,"rgb(166,118,29)"
12737,2020-07-06,Isle of Man,0,0,336,"rgb(166,118,29)"
12738,2020-07-07,Isle of Man,0,0,336,"rgb(166,118,29)"
12739,2020-07-08,Isle of Man,0,0,336,"rgb(166,118,29)"
12740,2020-07-09,Isle of Man,0,0,336,"rgb(166,118,29)"
12741,2020-07-10,Isle of Man,0,0,336,"rgb(166,118,29)"
12742,2020-07-11,Isle of Man,0,0,336,"rgb(166,118,29)"
12743,2020-07-12,Isle of Man,0,0,336,"rgb(166,118,29)"
12744,2020-07-13,Isle of Man,0,0,336,"rgb(166,118,29)"
12745,2019-12-31,India,0,0,0,"rgb(102,102,102)"
12746,2020-01-01,India,0,0,0,"rgb(102,102,102)"
12747,2020-01-02,India,0,0,0,"rgb(102,102,102)"
12748,2020-01-03,India,0,0,0,"rgb(102,102,102)"
12749,2020-01-04,India,0,0,0,"rgb(102,102,102)"
12750,2020-01-05,India,0,0,0,"rgb(102,102,102)"
12751,2020-01-06,India,0,0,0,"rgb(102,102,102)"
12752,2020-01-07,India,0,0,0,"rgb(102,102,102)"
12753,2020-01-08,India,0,0,0,"rgb(102,102,102)"
12754,2020-01-09,India,0,0,0,"rgb(102,102,102)"
12755,2020-01-10,India,0,0,0,"rgb(102,102,102)"
12756,2020-01-11,India,0,0,0,"rgb(102,102,102)"
12757,2020-01-12,India,0,0,0,"rgb(102,102,102)"
12758,2020-01-13,India,0,0,0,"rgb(102,102,102)"
12759,2020-01-14,India,0,0,0,"rgb(102,102,102)"
12760,2020-01-15,India,0,0,0,"rgb(102,102,102)"
12761,2020-01-16,India,0,0,0,"rgb(102,102,102)"
12762,2020-01-17,India,0,0,0,"rgb(102,102,102)"
12763,2020-01-18,India,0,0,0,"rgb(102,102,102)"
12764,2020-01-19,India,0,0,0,"rgb(102,102,102)"
12765,2020-01-20,India,0,0,0,"rgb(102,102,102)"
12766,2020-01-21,India,0,0,0,"rgb(102,102,102)"
12767,2020-01-22,India,0,0,0,"rgb(102,102,102)"
12768,2020-01-23,India,0,0,0,"rgb(102,102,102)"
12769,2020-01-24,India,0,0,0,"rgb(102,102,102)"
12770,2020-01-25,India,0,0,0,"rgb(102,102,102)"
12771,2020-01-26,India,0,0,0,"rgb(102,102,102)"
12772,2020-01-27,India,0,0,0,"rgb(102,102,102)"
12773,2020-01-28,India,0,0,0,"rgb(102,102,102)"
12774,2020-01-29,India,0,0,0,"rgb(102,102,102)"
12775,2020-01-30,India,0,1,1,"rgb(102,102,102)"
12776,2020-01-31,India,0,0,1,"rgb(102,102,102)"
12777,2020-02-01,India,0,0,1,"rgb(102,102,102)"
12778,2020-02-02,India,0,1,2,"rgb(102,102,102)"
12779,2020-02-03,India,0,0,2,"rgb(102,102,102)"
12780,2020-02-04,India,0,1,3,"rgb(102,102,102)"
12781,2020-02-05,India,0,0,3,"rgb(102,102,102)"
12782,2020-02-06,India,0,0,3,"rgb(102,102,102)"
12783,2020-02-07,India,0,0,3,"rgb(102,102,102)"
12784,2020-02-08,India,0,0,3,"rgb(102,102,102)"
12785,2020-02-09,India,0,0,3,"rgb(102,102,102)"
12786,2020-02-10,India,0,0,3,"rgb(102,102,102)"
12787,2020-02-11,India,0,0,3,"rgb(102,102,102)"
12788,2020-02-12,India,0,0,3,"rgb(102,102,102)"
12789,2020-02-13,India,0,0,3,"rgb(102,102,102)"
12790,2020-02-14,India,0,0,3,"rgb(102,102,102)"
12791,2020-02-15,India,0,0,3,"rgb(102,102,102)"
12792,2020-02-16,India,0,0,3,"rgb(102,102,102)"
12793,2020-02-17,India,0,0,3,"rgb(102,102,102)"
12794,2020-02-18,India,0,0,3,"rgb(102,102,102)"
12795,2020-02-19,India,0,0,3,"rgb(102,102,102)"
12796,2020-02-20,India,0,0,3,"rgb(102,102,102)"
12797,2020-02-21,India,0,0,3,"rgb(102,102,102)"
12798,2020-02-22,India,0,0,3,"rgb(102,102,102)"
12799,2020-02-23,India,0,0,3,"rgb(102,102,102)"
12800,2020-02-24,India,0,0,3,"rgb(102,102,102)"
12801,2020-02-25,India,0,0,3,"rgb(102,102,102)"
12802,2020-02-26,India,0,0,3,"rgb(102,102,102)"
12803,2020-02-27,India,0,0,3,"rgb(102,102,102)"
12804,2020-02-28,India,0,0,3,"rgb(102,102,102)"
12805,2020-02-29,India,0,0,3,"rgb(102,102,102)"
12806,2020-03-01,India,0,0,3,"rgb(102,102,102)"
12807,2020-03-02,India,0,0,3,"rgb(102,102,102)"
12808,2020-03-03,India,0,2,5,"rgb(102,102,102)"
12809,2020-03-04,India,0,1,6,"rgb(102,102,102)"
12810,2020-03-05,India,0,22,28,"rgb(102,102,102)"
12811,2020-03-06,India,0,1,29,"rgb(102,102,102)"
12812,2020-03-07,India,0,2,31,"rgb(102,102,102)"
12813,2020-03-08,India,0,3,34,"rgb(102,102,102)"
12814,2020-03-10,India,0,10,44,"rgb(102,102,102)"
12815,2020-03-11,India,0,6,50,"rgb(102,102,102)"
12816,2020-03-12,India,0,23,73,"rgb(102,102,102)"
12817,2020-03-13,India,1,2,75,"rgb(102,102,102)"
12818,2020-03-14,India,1,8,83,"rgb(102,102,102)"
12819,2020-03-15,India,0,7,90,"rgb(102,102,102)"
12820,2020-03-16,India,0,3,93,"rgb(102,102,102)"
12821,2020-03-17,India,1,32,125,"rgb(102,102,102)"
12822,2020-03-18,India,0,12,137,"rgb(102,102,102)"
12823,2020-03-19,India,0,28,165,"rgb(102,102,102)"
12824,2020-03-20,India,1,26,191,"rgb(102,102,102)"
12825,2020-03-21,India,0,40,231,"rgb(102,102,102)"
12826,2020-03-22,India,0,89,320,"rgb(102,102,102)"
12827,2020-03-23,India,3,119,439,"rgb(102,102,102)"
12828,2020-03-24,India,2,53,492,"rgb(102,102,102)"
12829,2020-03-25,India,0,70,562,"rgb(102,102,102)"
12830,2020-03-26,India,4,87,649,"rgb(102,102,102)"
12831,2020-03-27,India,4,75,724,"rgb(102,102,102)"
12832,2020-03-28,India,2,149,873,"rgb(102,102,102)"
12833,2020-03-29,India,6,106,979,"rgb(102,102,102)"
12834,2020-03-30,India,4,92,1071,"rgb(102,102,102)"
12835,2020-03-31,India,3,180,1251,"rgb(102,102,102)"
12836,2020-04-01,India,3,146,1397,"rgb(102,102,102)"
12837,2020-04-02,India,15,568,1965,"rgb(102,102,102)"
12838,2020-04-03,India,6,336,2301,"rgb(102,102,102)"
12839,2020-04-04,India,12,601,2902,"rgb(102,102,102)"
12840,2020-04-05,India,9,472,3374,"rgb(102,102,102)"
12841,2020-04-06,India,32,693,4067,"rgb(102,102,102)"
12842,2020-04-07,India,5,354,4421,"rgb(102,102,102)"
12843,2020-04-08,India,35,773,5194,"rgb(102,102,102)"
12844,2020-04-09,India,17,540,5734,"rgb(102,102,102)"
12845,2020-04-10,India,33,678,6412,"rgb(102,102,102)"
12846,2020-04-11,India,40,1035,7447,"rgb(102,102,102)"
12847,2020-04-12,India,34,909,8356,"rgb(102,102,102)"
12848,2020-04-13,India,35,796,9152,"rgb(102,102,102)"
12849,2020-04-14,India,31,1211,10363,"rgb(102,102,102)"
12850,2020-04-15,India,38,1075,11438,"rgb(102,102,102)"
12851,2020-04-16,India,37,942,12380,"rgb(102,102,102)"
12852,2020-04-17,India,23,1007,13387,"rgb(102,102,102)"
12853,2020-04-18,India,43,991,14378,"rgb(102,102,102)"
12854,2020-04-19,India,27,1334,15712,"rgb(102,102,102)"
12855,2020-04-20,India,36,1553,17265,"rgb(102,102,102)"
12856,2020-04-21,India,47,1335,18600,"rgb(102,102,102)"
12857,2020-04-22,India,50,1384,19984,"rgb(102,102,102)"
12858,2020-04-23,India,41,1409,21393,"rgb(102,102,102)"
12859,2020-04-24,India,37,1684,23077,"rgb(102,102,102)"
12860,2020-04-25,India,57,1429,24506,"rgb(102,102,102)"
12861,2020-04-26,India,49,1990,26496,"rgb(102,102,102)"
12862,2020-04-27,India,48,1396,27892,"rgb(102,102,102)"
12863,2020-04-28,India,62,1543,29435,"rgb(102,102,102)"
12864,2020-04-29,India,73,1897,31332,"rgb(102,102,102)"
12865,2020-04-30,India,67,1718,33050,"rgb(102,102,102)"
12866,2020-05-01,India,73,1993,35043,"rgb(102,102,102)"
12867,2020-05-02,India,71,2293,37336,"rgb(102,102,102)"
12868,2020-05-03,India,83,2644,39980,"rgb(102,102,102)"
12869,2020-05-04,India,72,2553,42533,"rgb(102,102,102)"
12870,2020-05-05,India,195,3900,46433,"rgb(102,102,102)"
12871,2020-05-06,India,126,2958,49391,"rgb(102,102,102)"
12872,2020-05-07,India,89,3561,52952,"rgb(102,102,102)"
12873,2020-05-08,India,103,3390,56342,"rgb(102,102,102)"
12874,2020-05-09,India,95,3320,59662,"rgb(102,102,102)"
12875,2020-05-10,India,128,3277,62939,"rgb(102,102,102)"
12876,2020-05-11,India,97,4213,67152,"rgb(102,102,102)"
12877,2020-05-12,India,87,3604,70756,"rgb(102,102,102)"
12878,2020-05-13,India,122,3525,74281,"rgb(102,102,102)"
12879,2020-05-14,India,134,3722,78003,"rgb(102,102,102)"
12880,2020-05-15,India,100,3967,81970,"rgb(102,102,102)"
12881,2020-05-16,India,103,3970,85940,"rgb(102,102,102)"
12882,2020-05-17,India,120,4987,90927,"rgb(102,102,102)"
12883,2020-05-18,India,157,5242,96169,"rgb(102,102,102)"
12884,2020-05-19,India,134,4970,101139,"rgb(102,102,102)"
12885,2020-05-20,India,140,5611,106750,"rgb(102,102,102)"
12886,2020-05-21,India,132,5609,112359,"rgb(102,102,102)"
12887,2020-05-22,India,148,6088,118447,"rgb(102,102,102)"
12888,2020-05-23,India,137,6654,125101,"rgb(102,102,102)"
12889,2020-05-24,India,147,6767,131868,"rgb(102,102,102)"
12890,2020-05-25,India,154,6977,138845,"rgb(102,102,102)"
12891,2020-05-26,India,146,6535,145380,"rgb(102,102,102)"
12892,2020-05-27,India,170,6387,151767,"rgb(102,102,102)"
12893,2020-05-28,India,194,6566,158333,"rgb(102,102,102)"
12894,2020-05-29,India,175,7466,165799,"rgb(102,102,102)"
12895,2020-05-30,India,265,7964,173763,"rgb(102,102,102)"
12896,2020-05-31,India,193,8380,182143,"rgb(102,102,102)"
12897,2020-06-01,India,230,8392,190535,"rgb(102,102,102)"
12898,2020-06-02,India,204,8171,198706,"rgb(102,102,102)"
12899,2020-06-03,India,217,8909,207615,"rgb(102,102,102)"
12900,2020-06-04,India,260,9304,216919,"rgb(102,102,102)"
12901,2020-06-05,India,273,9851,226770,"rgb(102,102,102)"
12902,2020-06-06,India,294,9887,236657,"rgb(102,102,102)"
12903,2020-06-07,India,287,9971,246628,"rgb(102,102,102)"
12904,2020-06-08,India,206,9983,256611,"rgb(102,102,102)"
12905,2020-06-09,India,331,9987,266598,"rgb(102,102,102)"
12906,2020-06-10,India,279,9985,276583,"rgb(102,102,102)"
12907,2020-06-11,India,357,9996,286579,"rgb(102,102,102)"
12908,2020-06-12,India,396,10956,297535,"rgb(102,102,102)"
12909,2020-06-13,India,386,11458,308993,"rgb(102,102,102)"
12910,2020-06-14,India,311,11929,320922,"rgb(102,102,102)"
12911,2020-06-15,India,325,11502,332424,"rgb(102,102,102)"
12912,2020-06-16,India,380,10667,343091,"rgb(102,102,102)"
12913,2020-06-17,India,2003,10974,354065,"rgb(102,102,102)"
12914,2020-06-18,India,334,12881,366946,"rgb(102,102,102)"
12915,2020-06-19,India,336,13586,380532,"rgb(102,102,102)"
12916,2020-06-20,India,375,14516,395048,"rgb(102,102,102)"
12917,2020-06-21,India,306,15413,410461,"rgb(102,102,102)"
12918,2020-06-22,India,445,14821,425282,"rgb(102,102,102)"
12919,2020-06-23,India,312,14933,440215,"rgb(102,102,102)"
12920,2020-06-24,India,465,15968,456183,"rgb(102,102,102)"
12921,2020-06-25,India,418,16922,473105,"rgb(102,102,102)"
12922,2020-06-26,India,407,17296,490401,"rgb(102,102,102)"
12923,2020-06-27,India,384,18552,508953,"rgb(102,102,102)"
12924,2020-06-28,India,410,19906,528859,"rgb(102,102,102)"
12925,2020-06-29,India,380,19459,548318,"rgb(102,102,102)"
12926,2020-06-30,India,418,18522,566840,"rgb(102,102,102)"
12927,2020-07-01,India,507,18653,585493,"rgb(102,102,102)"
12928,2020-07-02,India,434,19148,604641,"rgb(102,102,102)"
12929,2020-07-03,India,379,20903,625544,"rgb(102,102,102)"
12930,2020-07-04,India,442,22771,648315,"rgb(102,102,102)"
12931,2020-07-05,India,613,24850,673165,"rgb(102,102,102)"
12932,2020-07-06,India,425,24248,697413,"rgb(102,102,102)"
12933,2020-07-07,India,467,22252,719665,"rgb(102,102,102)"
12934,2020-07-08,India,482,22752,742417,"rgb(102,102,102)"
12935,2020-07-09,India,487,24879,767296,"rgb(102,102,102)"
12936,2020-07-10,India,475,26506,793802,"rgb(102,102,102)"
12937,2020-07-11,India,519,27114,820916,"rgb(102,102,102)"
12938,2020-07-12,India,551,28637,849553,"rgb(102,102,102)"
12939,2020-07-13,India,500,28701,878254,"rgb(102,102,102)"
12940,2019-12-31,Iraq,0,0,0,"rgb(102, 197, 204)"
12941,2020-01-01,Iraq,0,0,0,"rgb(102, 197, 204)"
12942,2020-01-02,Iraq,0,0,0,"rgb(102, 197, 204)"
12943,2020-01-03,Iraq,0,0,0,"rgb(102, 197, 204)"
12944,2020-01-04,Iraq,0,0,0,"rgb(102, 197, 204)"
12945,2020-01-05,Iraq,0,0,0,"rgb(102, 197, 204)"
12946,2020-01-06,Iraq,0,0,0,"rgb(102, 197, 204)"
12947,2020-01-07,Iraq,0,0,0,"rgb(102, 197, 204)"
12948,2020-01-08,Iraq,0,0,0,"rgb(102, 197, 204)"
12949,2020-01-09,Iraq,0,0,0,"rgb(102, 197, 204)"
12950,2020-01-10,Iraq,0,0,0,"rgb(102, 197, 204)"
12951,2020-01-11,Iraq,0,0,0,"rgb(102, 197, 204)"
12952,2020-01-12,Iraq,0,0,0,"rgb(102, 197, 204)"
12953,2020-01-13,Iraq,0,0,0,"rgb(102, 197, 204)"
12954,2020-01-14,Iraq,0,0,0,"rgb(102, 197, 204)"
12955,2020-01-15,Iraq,0,0,0,"rgb(102, 197, 204)"
12956,2020-01-16,Iraq,0,0,0,"rgb(102, 197, 204)"
12957,2020-01-17,Iraq,0,0,0,"rgb(102, 197, 204)"
12958,2020-01-18,Iraq,0,0,0,"rgb(102, 197, 204)"
12959,2020-01-19,Iraq,0,0,0,"rgb(102, 197, 204)"
12960,2020-01-20,Iraq,0,0,0,"rgb(102, 197, 204)"
12961,2020-01-21,Iraq,0,0,0,"rgb(102, 197, 204)"
12962,2020-01-22,Iraq,0,0,0,"rgb(102, 197, 204)"
12963,2020-01-23,Iraq,0,0,0,"rgb(102, 197, 204)"
12964,2020-01-24,Iraq,0,0,0,"rgb(102, 197, 204)"
12965,2020-01-25,Iraq,0,0,0,"rgb(102, 197, 204)"
12966,2020-01-26,Iraq,0,0,0,"rgb(102, 197, 204)"
12967,2020-01-27,Iraq,0,0,0,"rgb(102, 197, 204)"
12968,2020-01-28,Iraq,0,0,0,"rgb(102, 197, 204)"
12969,2020-01-29,Iraq,0,0,0,"rgb(102, 197, 204)"
12970,2020-01-30,Iraq,0,0,0,"rgb(102, 197, 204)"
12971,2020-01-31,Iraq,0,0,0,"rgb(102, 197, 204)"
12972,2020-02-01,Iraq,0,0,0,"rgb(102, 197, 204)"
12973,2020-02-02,Iraq,0,0,0,"rgb(102, 197, 204)"
12974,2020-02-03,Iraq,0,0,0,"rgb(102, 197, 204)"
12975,2020-02-04,Iraq,0,0,0,"rgb(102, 197, 204)"
12976,2020-02-05,Iraq,0,0,0,"rgb(102, 197, 204)"
12977,2020-02-06,Iraq,0,0,0,"rgb(102, 197, 204)"
12978,2020-02-07,Iraq,0,0,0,"rgb(102, 197, 204)"
12979,2020-02-08,Iraq,0,0,0,"rgb(102, 197, 204)"
12980,2020-02-09,Iraq,0,0,0,"rgb(102, 197, 204)"
12981,2020-02-10,Iraq,0,0,0,"rgb(102, 197, 204)"
12982,2020-02-11,Iraq,0,0,0,"rgb(102, 197, 204)"
12983,2020-02-12,Iraq,0,0,0,"rgb(102, 197, 204)"
12984,2020-02-13,Iraq,0,0,0,"rgb(102, 197, 204)"
12985,2020-02-14,Iraq,0,0,0,"rgb(102, 197, 204)"
12986,2020-02-15,Iraq,0,0,0,"rgb(102, 197, 204)"
12987,2020-02-16,Iraq,0,0,0,"rgb(102, 197, 204)"
12988,2020-02-17,Iraq,0,0,0,"rgb(102, 197, 204)"
12989,2020-02-18,Iraq,0,0,0,"rgb(102, 197, 204)"
12990,2020-02-19,Iraq,0,0,0,"rgb(102, 197, 204)"
12991,2020-02-20,Iraq,0,0,0,"rgb(102, 197, 204)"
12992,2020-02-21,Iraq,0,0,0,"rgb(102, 197, 204)"
12993,2020-02-22,Iraq,0,0,0,"rgb(102, 197, 204)"
12994,2020-02-23,Iraq,0,0,0,"rgb(102, 197, 204)"
12995,2020-02-24,Iraq,0,0,0,"rgb(102, 197, 204)"
12996,2020-02-25,Iraq,0,1,1,"rgb(102, 197, 204)"
12997,2020-02-26,Iraq,0,4,5,"rgb(102, 197, 204)"
12998,2020-02-27,Iraq,0,0,5,"rgb(102, 197, 204)"
12999,2020-02-28,Iraq,0,1,6,"rgb(102, 197, 204)"
13000,2020-02-29,Iraq,0,1,7,"rgb(102, 197, 204)"
13001,2020-03-01,Iraq,0,6,13,"rgb(102, 197, 204)"
13002,2020-03-02,Iraq,0,6,19,"rgb(102, 197, 204)"
13003,2020-03-03,Iraq,0,2,21,"rgb(102, 197, 204)"
13004,2020-03-04,Iraq,0,5,26,"rgb(102, 197, 204)"
13005,2020-03-05,Iraq,0,5,31,"rgb(102, 197, 204)"
13006,2020-03-06,Iraq,2,7,38,"rgb(102, 197, 204)"
13007,2020-03-08,Iraq,0,16,54,"rgb(102, 197, 204)"
13008,2020-03-09,Iraq,4,7,61,"rgb(102, 197, 204)"
13009,2020-03-11,Iraq,0,0,61,"rgb(102, 197, 204)"
13010,2020-03-12,Iraq,2,9,70,"rgb(102, 197, 204)"
13011,2020-03-13,Iraq,0,4,74,"rgb(102, 197, 204)"
13012,2020-03-14,Iraq,1,11,85,"rgb(102, 197, 204)"
13013,2020-03-15,Iraq,0,0,85,"rgb(102, 197, 204)"
13014,2020-03-16,Iraq,0,39,124,"rgb(102, 197, 204)"
13015,2020-03-17,Iraq,0,0,124,"rgb(102, 197, 204)"
13016,2020-03-18,Iraq,2,30,154,"rgb(102, 197, 204)"
13017,2020-03-19,Iraq,1,10,164,"rgb(102, 197, 204)"
13018,2020-03-20,Iraq,0,13,177,"rgb(102, 197, 204)"
13019,2020-03-21,Iraq,2,16,193,"rgb(102, 197, 204)"
13020,2020-03-22,Iraq,3,21,214,"rgb(102, 197, 204)"
13021,2020-03-23,Iraq,3,19,233,"rgb(102, 197, 204)"
13022,2020-03-24,Iraq,3,33,266,"rgb(102, 197, 204)"
13023,2020-03-25,Iraq,4,50,316,"rgb(102, 197, 204)"
13024,2020-03-26,Iraq,2,30,346,"rgb(102, 197, 204)"
13025,2020-03-27,Iraq,7,36,382,"rgb(102, 197, 204)"
13026,2020-03-28,Iraq,4,76,458,"rgb(102, 197, 204)"
13027,2020-03-29,Iraq,2,48,506,"rgb(102, 197, 204)"
13028,2020-03-30,Iraq,0,41,547,"rgb(102, 197, 204)"
13029,2020-03-31,Iraq,4,83,630,"rgb(102, 197, 204)"
13030,2020-04-01,Iraq,4,64,694,"rgb(102, 197, 204)"
13031,2020-04-02,Iraq,0,0,694,"rgb(102, 197, 204)"
13032,2020-04-03,Iraq,4,78,772,"rgb(102, 197, 204)"
13033,2020-04-04,Iraq,0,0,772,"rgb(102, 197, 204)"
13034,2020-04-05,Iraq,2,106,878,"rgb(102, 197, 204)"
13035,2020-04-06,Iraq,5,83,961,"rgb(102, 197, 204)"
13036,2020-04-07,Iraq,3,70,1031,"rgb(102, 197, 204)"
13037,2020-04-08,Iraq,0,0,1031,"rgb(102, 197, 204)"
13038,2020-04-09,Iraq,5,171,1202,"rgb(102, 197, 204)"
13039,2020-04-10,Iraq,0,30,1232,"rgb(102, 197, 204)"
13040,2020-04-11,Iraq,1,47,1279,"rgb(102, 197, 204)"
13041,2020-04-12,Iraq,2,39,1318,"rgb(102, 197, 204)"
13042,2020-04-13,Iraq,4,34,1352,"rgb(102, 197, 204)"
13043,2020-04-14,Iraq,2,26,1378,"rgb(102, 197, 204)"
13044,2020-04-15,Iraq,0,22,1400,"rgb(102, 197, 204)"
13045,2020-04-16,Iraq,1,15,1415,"rgb(102, 197, 204)"
13046,2020-04-17,Iraq,1,19,1434,"rgb(102, 197, 204)"
13047,2020-04-18,Iraq,1,48,1482,"rgb(102, 197, 204)"
13048,2020-04-19,Iraq,0,0,1482,"rgb(102, 197, 204)"
13049,2020-04-20,Iraq,1,57,1539,"rgb(102, 197, 204)"
13050,2020-04-21,Iraq,0,35,1574,"rgb(102, 197, 204)"
13051,2020-04-22,Iraq,1,28,1602,"rgb(102, 197, 204)"
13052,2020-04-23,Iraq,0,0,1602,"rgb(102, 197, 204)"
13053,2020-04-24,Iraq,0,75,1677,"rgb(102, 197, 204)"
13054,2020-04-25,Iraq,3,31,1708,"rgb(102, 197, 204)"
13055,2020-04-26,Iraq,0,55,1763,"rgb(102, 197, 204)"
13056,2020-04-27,Iraq,1,57,1820,"rgb(102, 197, 204)"
13057,2020-04-28,Iraq,1,27,1847,"rgb(102, 197, 204)"
13058,2020-04-29,Iraq,0,0,1847,"rgb(102, 197, 204)"
13059,2020-04-30,Iraq,4,156,2003,"rgb(102, 197, 204)"
13060,2020-05-01,Iraq,1,82,2085,"rgb(102, 197, 204)"
13061,2020-05-02,Iraq,1,68,2153,"rgb(102, 197, 204)"
13062,2020-05-03,Iraq,1,66,2219,"rgb(102, 197, 204)"
13063,2020-05-04,Iraq,2,77,2296,"rgb(102, 197, 204)"
13064,2020-05-05,Iraq,1,50,2346,"rgb(102, 197, 204)"
13065,2020-05-06,Iraq,4,85,2431,"rgb(102, 197, 204)"
13066,2020-05-07,Iraq,0,49,2480,"rgb(102, 197, 204)"
13067,2020-05-08,Iraq,0,63,2543,"rgb(102, 197, 204)"
13068,2020-05-09,Iraq,2,60,2603,"rgb(102, 197, 204)"
13069,2020-05-10,Iraq,3,76,2679,"rgb(102, 197, 204)"
13070,2020-05-11,Iraq,2,88,2767,"rgb(102, 197, 204)"
13071,2020-05-12,Iraq,1,51,2818,"rgb(102, 197, 204)"
13072,2020-05-13,Iraq,2,95,2913,"rgb(102, 197, 204)"
13073,2020-05-14,Iraq,3,119,3032,"rgb(102, 197, 204)"
13074,2020-05-15,Iraq,0,111,3143,"rgb(102, 197, 204)"
13075,2020-05-16,Iraq,2,50,3193,"rgb(102, 197, 204)"
13076,2020-05-17,Iraq,4,67,3260,"rgb(102, 197, 204)"
13077,2020-05-18,Iraq,2,144,3404,"rgb(102, 197, 204)"
13078,2020-05-19,Iraq,4,150,3554,"rgb(102, 197, 204)"
13079,2020-05-20,Iraq,4,57,3611,"rgb(102, 197, 204)"
13080,2020-05-21,Iraq,3,113,3724,"rgb(102, 197, 204)"
13081,2020-05-22,Iraq,6,153,3877,"rgb(102, 197, 204)"
13082,2020-05-23,Iraq,7,87,3964,"rgb(102, 197, 204)"
13083,2020-05-24,Iraq,5,308,4272,"rgb(102, 197, 204)"
13084,2020-05-25,Iraq,8,197,4469,"rgb(102, 197, 204)"
13085,2020-05-26,Iraq,3,163,4632,"rgb(102, 197, 204)"
13086,2020-05-27,Iraq,6,216,4848,"rgb(102, 197, 204)"
13087,2020-05-28,Iraq,6,287,5135,"rgb(102, 197, 204)"
13088,2020-05-29,Iraq,4,322,5457,"rgb(102, 197, 204)"
13089,2020-05-30,Iraq,6,416,5873,"rgb(102, 197, 204)"
13090,2020-05-31,Iraq,10,306,6179,"rgb(102, 197, 204)"
13091,2020-06-01,Iraq,10,260,6439,"rgb(102, 197, 204)"
13092,2020-06-02,Iraq,10,429,6868,"rgb(102, 197, 204)"
13093,2020-06-03,Iraq,20,519,7387,"rgb(102, 197, 204)"
13094,2020-06-04,Iraq,21,781,8168,"rgb(102, 197, 204)"
13095,2020-06-05,Iraq,15,672,8840,"rgb(102, 197, 204)"
13096,2020-06-06,Iraq,14,1006,9846,"rgb(102, 197, 204)"
13097,2020-06-07,Iraq,33,1252,11098,"rgb(102, 197, 204)"
13098,2020-06-08,Iraq,28,1268,12366,"rgb(102, 197, 204)"
13099,2020-06-09,Iraq,24,1115,13481,"rgb(102, 197, 204)"
13100,2020-06-10,Iraq,22,787,14268,"rgb(102, 197, 204)"
13101,2020-06-11,Iraq,34,1146,15414,"rgb(102, 197, 204)"
13102,2020-06-12,Iraq,31,1261,16675,"rgb(102, 197, 204)"
13103,2020-06-13,Iraq,39,1095,17770,"rgb(102, 197, 204)"
13104,2020-06-14,Iraq,53,1180,18950,"rgb(102, 197, 204)"
13105,2020-06-15,Iraq,58,1259,20209,"rgb(102, 197, 204)"
13106,2020-06-16,Iraq,45,1106,21315,"rgb(102, 197, 204)"
13107,2020-06-17,Iraq,60,1385,22700,"rgb(102, 197, 204)"
13108,2020-06-18,Iraq,61,1554,24254,"rgb(102, 197, 204)"
13109,2020-06-19,Iraq,83,1463,25717,"rgb(102, 197, 204)"
13110,2020-06-20,Iraq,0,0,25717,"rgb(102, 197, 204)"
13111,2020-06-21,Iraq,157,3505,29222,"rgb(102, 197, 204)"
13112,2020-06-22,Iraq,87,1646,30868,"rgb(102, 197, 204)"
13113,2020-06-23,Iraq,67,1808,32676,"rgb(102, 197, 204)"
13114,2020-06-24,Iraq,84,1826,34502,"rgb(102, 197, 204)"
13115,2020-06-25,Iraq,79,2200,36702,"rgb(102, 197, 204)"
13116,2020-06-26,Iraq,107,2437,39139,"rgb(102, 197, 204)"
13117,2020-06-27,Iraq,122,2054,41193,"rgb(102, 197, 204)"
13118,2020-06-28,Iraq,101,2069,43262,"rgb(102, 197, 204)"
13119,2020-06-29,Iraq,96,2140,45402,"rgb(102, 197, 204)"
13120,2020-06-30,Iraq,83,1749,47151,"rgb(102, 197, 204)"
13121,2020-07-01,Iraq,104,1958,49109,"rgb(102, 197, 204)"
13122,2020-07-02,Iraq,107,2415,51524,"rgb(102, 197, 204)"
13123,2020-07-03,Iraq,110,2184,53708,"rgb(102, 197, 204)"
13124,2020-07-04,Iraq,102,2312,56020,"rgb(102, 197, 204)"
13125,2020-07-05,Iraq,106,2334,58354,"rgb(102, 197, 204)"
13126,2020-07-06,Iraq,105,2125,60479,"rgb(102, 197, 204)"
13127,2020-07-07,Iraq,94,1796,62275,"rgb(102, 197, 204)"
13128,2020-07-08,Iraq,118,2426,64701,"rgb(102, 197, 204)"
13129,2020-07-09,Iraq,94,2741,67442,"rgb(102, 197, 204)"
13130,2020-07-10,Iraq,103,2170,69612,"rgb(102, 197, 204)"
13131,2020-07-11,Iraq,78,2848,72460,"rgb(102, 197, 204)"
13132,2020-07-12,Iraq,95,2734,75194,"rgb(102, 197, 204)"
13133,2020-07-13,Iraq,95,2312,77506,"rgb(102, 197, 204)"
13134,2019-12-31,Iran,0,0,0,"rgb(246, 207, 113)"
13135,2020-01-01,Iran,0,0,0,"rgb(246, 207, 113)"
13136,2020-01-02,Iran,0,0,0,"rgb(246, 207, 113)"
13137,2020-01-03,Iran,0,0,0,"rgb(246, 207, 113)"
13138,2020-01-04,Iran,0,0,0,"rgb(246, 207, 113)"
13139,2020-01-05,Iran,0,0,0,"rgb(246, 207, 113)"
13140,2020-01-06,Iran,0,0,0,"rgb(246, 207, 113)"
13141,2020-01-07,Iran,0,0,0,"rgb(246, 207, 113)"
13142,2020-01-08,Iran,0,0,0,"rgb(246, 207, 113)"
13143,2020-01-09,Iran,0,0,0,"rgb(246, 207, 113)"
13144,2020-01-10,Iran,0,0,0,"rgb(246, 207, 113)"
13145,2020-01-11,Iran,0,0,0,"rgb(246, 207, 113)"
13146,2020-01-12,Iran,0,0,0,"rgb(246, 207, 113)"
13147,2020-01-13,Iran,0,0,0,"rgb(246, 207, 113)"
13148,2020-01-14,Iran,0,0,0,"rgb(246, 207, 113)"
13149,2020-01-15,Iran,0,0,0,"rgb(246, 207, 113)"
13150,2020-01-16,Iran,0,0,0,"rgb(246, 207, 113)"
13151,2020-01-17,Iran,0,0,0,"rgb(246, 207, 113)"
13152,2020-01-18,Iran,0,0,0,"rgb(246, 207, 113)"
13153,2020-01-19,Iran,0,0,0,"rgb(246, 207, 113)"
13154,2020-01-20,Iran,0,0,0,"rgb(246, 207, 113)"
13155,2020-01-21,Iran,0,0,0,"rgb(246, 207, 113)"
13156,2020-01-22,Iran,0,0,0,"rgb(246, 207, 113)"
13157,2020-01-23,Iran,0,0,0,"rgb(246, 207, 113)"
13158,2020-01-24,Iran,0,0,0,"rgb(246, 207, 113)"
13159,2020-01-25,Iran,0,0,0,"rgb(246, 207, 113)"
13160,2020-01-26,Iran,0,0,0,"rgb(246, 207, 113)"
13161,2020-01-27,Iran,0,0,0,"rgb(246, 207, 113)"
13162,2020-01-28,Iran,0,0,0,"rgb(246, 207, 113)"
13163,2020-01-29,Iran,0,0,0,"rgb(246, 207, 113)"
13164,2020-01-30,Iran,0,0,0,"rgb(246, 207, 113)"
13165,2020-01-31,Iran,0,0,0,"rgb(246, 207, 113)"
13166,2020-02-01,Iran,0,0,0,"rgb(246, 207, 113)"
13167,2020-02-02,Iran,0,0,0,"rgb(246, 207, 113)"
13168,2020-02-03,Iran,0,0,0,"rgb(246, 207, 113)"
13169,2020-02-04,Iran,0,0,0,"rgb(246, 207, 113)"
13170,2020-02-05,Iran,0,0,0,"rgb(246, 207, 113)"
13171,2020-02-06,Iran,0,0,0,"rgb(246, 207, 113)"
13172,2020-02-07,Iran,0,0,0,"rgb(246, 207, 113)"
13173,2020-02-08,Iran,0,0,0,"rgb(246, 207, 113)"
13174,2020-02-09,Iran,0,0,0,"rgb(246, 207, 113)"
13175,2020-02-10,Iran,0,0,0,"rgb(246, 207, 113)"
13176,2020-02-11,Iran,0,0,0,"rgb(246, 207, 113)"
13177,2020-02-12,Iran,0,0,0,"rgb(246, 207, 113)"
13178,2020-02-13,Iran,0,0,0,"rgb(246, 207, 113)"
13179,2020-02-14,Iran,0,0,0,"rgb(246, 207, 113)"
13180,2020-02-15,Iran,0,0,0,"rgb(246, 207, 113)"
13181,2020-02-16,Iran,0,0,0,"rgb(246, 207, 113)"
13182,2020-02-17,Iran,0,0,0,"rgb(246, 207, 113)"
13183,2020-02-18,Iran,0,0,0,"rgb(246, 207, 113)"
13184,2020-02-19,Iran,0,0,0,"rgb(246, 207, 113)"
13185,2020-02-20,Iran,2,2,2,"rgb(246, 207, 113)"
13186,2020-02-21,Iran,0,3,5,"rgb(246, 207, 113)"
13187,2020-02-22,Iran,2,13,18,"rgb(246, 207, 113)"
13188,2020-02-23,Iran,1,10,28,"rgb(246, 207, 113)"
13189,2020-02-24,Iran,3,15,43,"rgb(246, 207, 113)"
13190,2020-02-25,Iran,4,18,61,"rgb(246, 207, 113)"
13191,2020-02-26,Iran,3,34,95,"rgb(246, 207, 113)"
13192,2020-02-27,Iran,4,44,139,"rgb(246, 207, 113)"
13193,2020-02-28,Iran,7,106,245,"rgb(246, 207, 113)"
13194,2020-02-29,Iran,8,143,388,"rgb(246, 207, 113)"
13195,2020-03-01,Iran,9,205,593,"rgb(246, 207, 113)"
13196,2020-03-02,Iran,11,385,978,"rgb(246, 207, 113)"
13197,2020-03-03,Iran,12,523,1501,"rgb(246, 207, 113)"
13198,2020-03-04,Iran,11,835,2336,"rgb(246, 207, 113)"
13199,2020-03-05,Iran,15,586,2922,"rgb(246, 207, 113)"
13200,2020-03-06,Iran,15,591,3513,"rgb(246, 207, 113)"
13201,2020-03-07,Iran,17,1234,4747,"rgb(246, 207, 113)"
13202,2020-03-08,Iran,21,1076,5823,"rgb(246, 207, 113)"
13203,2020-03-09,Iran,49,743,6566,"rgb(246, 207, 113)"
13204,2020-03-10,Iran,43,595,7161,"rgb(246, 207, 113)"
13205,2020-03-11,Iran,54,881,8042,"rgb(246, 207, 113)"
13206,2020-03-12,Iran,63,958,9000,"rgb(246, 207, 113)"
13207,2020-03-13,Iran,75,1075,10075,"rgb(246, 207, 113)"
13208,2020-03-14,Iran,85,1289,11364,"rgb(246, 207, 113)"
13209,2020-03-15,Iran,97,1365,12729,"rgb(246, 207, 113)"
13210,2020-03-16,Iran,113,1209,13938,"rgb(246, 207, 113)"
13211,2020-03-17,Iran,129,1053,14991,"rgb(246, 207, 113)"
13212,2020-03-18,Iran,135,1178,16169,"rgb(246, 207, 113)"
13213,2020-03-19,Iran,147,1192,17361,"rgb(246, 207, 113)"
13214,2020-03-20,Iran,149,1046,18407,"rgb(246, 207, 113)"
13215,2020-03-21,Iran,149,1237,19644,"rgb(246, 207, 113)"
13216,2020-03-22,Iran,123,966,20610,"rgb(246, 207, 113)"
13217,2020-03-23,Iran,129,1028,21638,"rgb(246, 207, 113)"
13218,2020-03-24,Iran,127,1411,23049,"rgb(246, 207, 113)"
13219,2020-03-25,Iran,122,1762,24811,"rgb(246, 207, 113)"
13220,2020-03-26,Iran,143,2206,27017,"rgb(246, 207, 113)"
13221,2020-03-27,Iran,157,2389,29406,"rgb(246, 207, 113)"
13222,2020-03-28,Iran,144,2926,32332,"rgb(246, 207, 113)"
13223,2020-03-29,Iran,139,3076,35408,"rgb(246, 207, 113)"
13224,2020-03-30,Iran,123,2901,38309,"rgb(246, 207, 113)"
13225,2020-03-31,Iran,117,3186,41495,"rgb(246, 207, 113)"
13226,2020-04-01,Iran,141,3111,44606,"rgb(246, 207, 113)"
13227,2020-04-02,Iran,138,2987,47593,"rgb(246, 207, 113)"
13228,2020-04-03,Iran,124,2875,50468,"rgb(246, 207, 113)"
13229,2020-04-04,Iran,0,0,50468,"rgb(246, 207, 113)"
13230,2020-04-05,Iran,292,5275,55743,"rgb(246, 207, 113)"
13231,2020-04-06,Iran,151,2483,58226,"rgb(246, 207, 113)"
13232,2020-04-07,Iran,136,2274,60500,"rgb(246, 207, 113)"
13233,2020-04-08,Iran,133,2089,62589,"rgb(246, 207, 113)"
13234,2020-04-09,Iran,121,1997,64586,"rgb(246, 207, 113)"
13235,2020-04-10,Iran,117,1634,66220,"rgb(246, 207, 113)"
13236,2020-04-11,Iran,122,1972,68192,"rgb(246, 207, 113)"
13237,2020-04-12,Iran,125,1837,70029,"rgb(246, 207, 113)"
13238,2020-04-13,Iran,117,1657,71686,"rgb(246, 207, 113)"
13239,2020-04-14,Iran,111,1617,73303,"rgb(246, 207, 113)"
13240,2020-04-15,Iran,98,1574,74877,"rgb(246, 207, 113)"
13241,2020-04-16,Iran,94,1512,76389,"rgb(246, 207, 113)"
13242,2020-04-17,Iran,92,1606,77995,"rgb(246, 207, 113)"
13243,2020-04-18,Iran,89,1499,79494,"rgb(246, 207, 113)"
13244,2020-04-19,Iran,73,1374,80868,"rgb(246, 207, 113)"
13245,2020-04-20,Iran,87,1343,82211,"rgb(246, 207, 113)"
13246,2020-04-21,Iran,91,1294,83505,"rgb(246, 207, 113)"
13247,2020-04-22,Iran,88,1297,84802,"rgb(246, 207, 113)"
13248,2020-04-23,Iran,94,1194,85996,"rgb(246, 207, 113)"
13249,2020-04-24,Iran,90,1030,87026,"rgb(246, 207, 113)"
13250,2020-04-25,Iran,93,1168,88194,"rgb(246, 207, 113)"
13251,2020-04-26,Iran,76,1134,89328,"rgb(246, 207, 113)"
13252,2020-04-27,Iran,60,1153,90481,"rgb(246, 207, 113)"
13253,2020-04-28,Iran,96,991,91472,"rgb(246, 207, 113)"
13254,2020-04-29,Iran,71,1112,92584,"rgb(246, 207, 113)"
13255,2020-04-30,Iran,80,1073,93657,"rgb(246, 207, 113)"
13256,2020-05-01,Iran,71,983,94640,"rgb(246, 207, 113)"
13257,2020-05-02,Iran,63,1006,95646,"rgb(246, 207, 113)"
13258,2020-05-03,Iran,65,802,96448,"rgb(246, 207, 113)"
13259,2020-05-04,Iran,47,976,97424,"rgb(246, 207, 113)"
13260,2020-05-05,Iran,74,1223,98647,"rgb(246, 207, 113)"
13261,2020-05-06,Iran,63,1323,99970,"rgb(246, 207, 113)"
13262,2020-05-07,Iran,78,1680,101650,"rgb(246, 207, 113)"
13263,2020-05-08,Iran,68,1485,103135,"rgb(246, 207, 113)"
13264,2020-05-09,Iran,55,1556,104691,"rgb(246, 207, 113)"
13265,2020-05-10,Iran,48,1529,106220,"rgb(246, 207, 113)"
13266,2020-05-11,Iran,51,1383,107603,"rgb(246, 207, 113)"
13267,2020-05-12,Iran,45,1683,109286,"rgb(246, 207, 113)"
13268,2020-05-13,Iran,48,1481,110767,"rgb(246, 207, 113)"
13269,2020-05-14,Iran,50,1958,112725,"rgb(246, 207, 113)"
13270,2020-05-15,Iran,71,1808,114533,"rgb(246, 207, 113)"
13271,2020-05-16,Iran,48,2102,116635,"rgb(246, 207, 113)"
13272,2020-05-17,Iran,35,1757,118392,"rgb(246, 207, 113)"
13273,2020-05-18,Iran,51,1806,120198,"rgb(246, 207, 113)"
13274,2020-05-19,Iran,69,2294,122492,"rgb(246, 207, 113)"
13275,2020-05-20,Iran,62,2111,124603,"rgb(246, 207, 113)"
13276,2020-05-21,Iran,64,2346,126949,"rgb(246, 207, 113)"
13277,2020-05-22,Iran,66,2392,129341,"rgb(246, 207, 113)"
13278,2020-05-23,Iran,51,2311,131652,"rgb(246, 207, 113)"
13279,2020-05-24,Iran,59,1869,133521,"rgb(246, 207, 113)"
13280,2020-05-25,Iran,58,2180,135701,"rgb(246, 207, 113)"
13281,2020-05-26,Iran,34,2023,137724,"rgb(246, 207, 113)"
13282,2020-05-27,Iran,57,1787,139511,"rgb(246, 207, 113)"
13283,2020-05-28,Iran,56,2080,141591,"rgb(246, 207, 113)"
13284,2020-05-29,Iran,63,2258,143849,"rgb(246, 207, 113)"
13285,2020-05-30,Iran,50,2819,146668,"rgb(246, 207, 113)"
13286,2020-05-31,Iran,57,2282,148950,"rgb(246, 207, 113)"
13287,2020-06-01,Iran,63,2516,151466,"rgb(246, 207, 113)"
13288,2020-06-02,Iran,81,2979,154445,"rgb(246, 207, 113)"
13289,2020-06-03,Iran,64,3117,157562,"rgb(246, 207, 113)"
13290,2020-06-04,Iran,70,3134,160696,"rgb(246, 207, 113)"
13291,2020-06-05,Iran,59,3574,164270,"rgb(246, 207, 113)"
13292,2020-06-06,Iran,63,2886,167156,"rgb(246, 207, 113)"
13293,2020-06-07,Iran,75,2269,169425,"rgb(246, 207, 113)"
13294,2020-06-08,Iran,72,2364,171789,"rgb(246, 207, 113)"
13295,2020-06-09,Iran,70,2043,173832,"rgb(246, 207, 113)"
13296,2020-06-10,Iran,74,2095,175927,"rgb(246, 207, 113)"
13297,2020-06-11,Iran,81,2011,177938,"rgb(246, 207, 113)"
13298,2020-06-12,Iran,78,2238,180176,"rgb(246, 207, 113)"
13299,2020-06-13,Iran,75,2369,182545,"rgb(246, 207, 113)"
13300,2020-06-14,Iran,71,2410,184955,"rgb(246, 207, 113)"
13301,2020-06-15,Iran,107,2472,187427,"rgb(246, 207, 113)"
13302,2020-06-16,Iran,113,2449,189876,"rgb(246, 207, 113)"
13303,2020-06-17,Iran,115,2563,192439,"rgb(246, 207, 113)"
13304,2020-06-18,Iran,120,2612,195051,"rgb(246, 207, 113)"
13305,2020-06-19,Iran,87,2596,197647,"rgb(246, 207, 113)"
13306,2020-06-20,Iran,120,2615,200262,"rgb(246, 207, 113)"
13307,2020-06-21,Iran,115,2322,202584,"rgb(246, 207, 113)"
13308,2020-06-22,Iran,116,2368,204952,"rgb(246, 207, 113)"
13309,2020-06-23,Iran,119,2573,207525,"rgb(246, 207, 113)"
13310,2020-06-24,Iran,121,2445,209970,"rgb(246, 207, 113)"
13311,2020-06-25,Iran,133,2531,212501,"rgb(246, 207, 113)"
13312,2020-06-26,Iran,134,2595,215096,"rgb(246, 207, 113)"
13313,2020-06-27,Iran,0,2628,217724,"rgb(246, 207, 113)"
13314,2020-06-28,Iran,234,2456,220180,"rgb(246, 207, 113)"
13315,2020-06-29,Iran,144,2489,222669,"rgb(246, 207, 113)"
13316,2020-06-30,Iran,162,2536,225205,"rgb(246, 207, 113)"
13317,2020-07-01,Iran,147,2457,227662,"rgb(246, 207, 113)"
13318,2020-07-02,Iran,141,2549,230211,"rgb(246, 207, 113)"
13319,2020-07-03,Iran,148,2652,232863,"rgb(246, 207, 113)"
13320,2020-07-04,Iran,154,2566,235429,"rgb(246, 207, 113)"
13321,2020-07-05,Iran,148,2449,237878,"rgb(246, 207, 113)"
13322,2020-07-06,Iran,163,2560,240438,"rgb(246, 207, 113)"
13323,2020-07-07,Iran,160,2613,243051,"rgb(246, 207, 113)"
13324,2020-07-08,Iran,200,2637,245688,"rgb(246, 207, 113)"
13325,2020-07-09,Iran,153,2691,248379,"rgb(246, 207, 113)"
13326,2020-07-10,Iran,221,2079,250458,"rgb(246, 207, 113)"
13327,2020-07-11,Iran,142,2262,252720,"rgb(246, 207, 113)"
13328,2020-07-12,Iran,188,2397,255117,"rgb(246, 207, 113)"
13329,2020-07-13,Iran,194,2186,257303,"rgb(246, 207, 113)"
13330,2019-12-31,Iceland,0,0,0,"rgb(248, 156, 116)"
13331,2020-01-01,Iceland,0,0,0,"rgb(248, 156, 116)"
13332,2020-01-02,Iceland,0,0,0,"rgb(248, 156, 116)"
13333,2020-01-03,Iceland,0,0,0,"rgb(248, 156, 116)"
13334,2020-01-04,Iceland,0,0,0,"rgb(248, 156, 116)"
13335,2020-01-05,Iceland,0,0,0,"rgb(248, 156, 116)"
13336,2020-01-06,Iceland,0,0,0,"rgb(248, 156, 116)"
13337,2020-01-07,Iceland,0,0,0,"rgb(248, 156, 116)"
13338,2020-01-08,Iceland,0,0,0,"rgb(248, 156, 116)"
13339,2020-01-09,Iceland,0,0,0,"rgb(248, 156, 116)"
13340,2020-01-10,Iceland,0,0,0,"rgb(248, 156, 116)"
13341,2020-01-11,Iceland,0,0,0,"rgb(248, 156, 116)"
13342,2020-01-12,Iceland,0,0,0,"rgb(248, 156, 116)"
13343,2020-01-13,Iceland,0,0,0,"rgb(248, 156, 116)"
13344,2020-01-14,Iceland,0,0,0,"rgb(248, 156, 116)"
13345,2020-01-15,Iceland,0,0,0,"rgb(248, 156, 116)"
13346,2020-01-16,Iceland,0,0,0,"rgb(248, 156, 116)"
13347,2020-01-17,Iceland,0,0,0,"rgb(248, 156, 116)"
13348,2020-01-18,Iceland,0,0,0,"rgb(248, 156, 116)"
13349,2020-01-19,Iceland,0,0,0,"rgb(248, 156, 116)"
13350,2020-01-20,Iceland,0,0,0,"rgb(248, 156, 116)"
13351,2020-01-21,Iceland,0,0,0,"rgb(248, 156, 116)"
13352,2020-01-22,Iceland,0,0,0,"rgb(248, 156, 116)"
13353,2020-01-23,Iceland,0,0,0,"rgb(248, 156, 116)"
13354,2020-01-24,Iceland,0,0,0,"rgb(248, 156, 116)"
13355,2020-01-25,Iceland,0,0,0,"rgb(248, 156, 116)"
13356,2020-01-26,Iceland,0,0,0,"rgb(248, 156, 116)"
13357,2020-01-27,Iceland,0,0,0,"rgb(248, 156, 116)"
13358,2020-01-28,Iceland,0,0,0,"rgb(248, 156, 116)"
13359,2020-01-29,Iceland,0,0,0,"rgb(248, 156, 116)"
13360,2020-01-30,Iceland,0,0,0,"rgb(248, 156, 116)"
13361,2020-01-31,Iceland,0,0,0,"rgb(248, 156, 116)"
13362,2020-02-01,Iceland,0,0,0,"rgb(248, 156, 116)"
13363,2020-02-02,Iceland,0,0,0,"rgb(248, 156, 116)"
13364,2020-02-03,Iceland,0,0,0,"rgb(248, 156, 116)"
13365,2020-02-04,Iceland,0,0,0,"rgb(248, 156, 116)"
13366,2020-02-05,Iceland,0,0,0,"rgb(248, 156, 116)"
13367,2020-02-06,Iceland,0,0,0,"rgb(248, 156, 116)"
13368,2020-02-07,Iceland,0,0,0,"rgb(248, 156, 116)"
13369,2020-02-08,Iceland,0,0,0,"rgb(248, 156, 116)"
13370,2020-02-09,Iceland,0,0,0,"rgb(248, 156, 116)"
13371,2020-02-10,Iceland,0,0,0,"rgb(248, 156, 116)"
13372,2020-02-11,Iceland,0,0,0,"rgb(248, 156, 116)"
13373,2020-02-12,Iceland,0,0,0,"rgb(248, 156, 116)"
13374,2020-02-13,Iceland,0,0,0,"rgb(248, 156, 116)"
13375,2020-02-14,Iceland,0,0,0,"rgb(248, 156, 116)"
13376,2020-02-15,Iceland,0,0,0,"rgb(248, 156, 116)"
13377,2020-02-16,Iceland,0,0,0,"rgb(248, 156, 116)"
13378,2020-02-17,Iceland,0,0,0,"rgb(248, 156, 116)"
13379,2020-02-18,Iceland,0,0,0,"rgb(248, 156, 116)"
13380,2020-02-19,Iceland,0,0,0,"rgb(248, 156, 116)"
13381,2020-02-20,Iceland,0,0,0,"rgb(248, 156, 116)"
13382,2020-02-21,Iceland,0,0,0,"rgb(248, 156, 116)"
13383,2020-02-22,Iceland,0,0,0,"rgb(248, 156, 116)"
13384,2020-02-23,Iceland,0,0,0,"rgb(248, 156, 116)"
13385,2020-02-24,Iceland,0,0,0,"rgb(248, 156, 116)"
13386,2020-02-25,Iceland,0,0,0,"rgb(248, 156, 116)"
13387,2020-02-26,Iceland,0,0,0,"rgb(248, 156, 116)"
13388,2020-02-27,Iceland,0,0,0,"rgb(248, 156, 116)"
13389,2020-02-28,Iceland,0,0,0,"rgb(248, 156, 116)"
13390,2020-02-29,Iceland,0,1,1,"rgb(248, 156, 116)"
13391,2020-03-01,Iceland,0,0,1,"rgb(248, 156, 116)"
13392,2020-03-02,Iceland,0,2,3,"rgb(248, 156, 116)"
13393,2020-03-03,Iceland,0,3,6,"rgb(248, 156, 116)"
13394,2020-03-04,Iceland,0,10,16,"rgb(248, 156, 116)"
13395,2020-03-05,Iceland,0,10,26,"rgb(248, 156, 116)"
13396,2020-03-06,Iceland,0,9,35,"rgb(248, 156, 116)"
13397,2020-03-07,Iceland,0,8,43,"rgb(248, 156, 116)"
13398,2020-03-08,Iceland,0,10,53,"rgb(248, 156, 116)"
13399,2020-03-09,Iceland,0,2,55,"rgb(248, 156, 116)"
13400,2020-03-10,Iceland,0,10,65,"rgb(248, 156, 116)"
13401,2020-03-11,Iceland,0,5,70,"rgb(248, 156, 116)"
13402,2020-03-12,Iceland,0,15,85,"rgb(248, 156, 116)"
13403,2020-03-13,Iceland,0,32,117,"rgb(248, 156, 116)"
13404,2020-03-14,Iceland,0,0,117,"rgb(248, 156, 116)"
13405,2020-03-15,Iceland,0,21,138,"rgb(248, 156, 116)"
13406,2020-03-16,Iceland,0,40,178,"rgb(248, 156, 116)"
13407,2020-03-17,Iceland,0,21,199,"rgb(248, 156, 116)"
13408,2020-03-18,Iceland,0,48,247,"rgb(248, 156, 116)"
13409,2020-03-19,Iceland,0,3,250,"rgb(248, 156, 116)"
13410,2020-03-20,Iceland,1,80,330,"rgb(248, 156, 116)"
13411,2020-03-21,Iceland,0,79,409,"rgb(248, 156, 116)"
13412,2020-03-22,Iceland,0,64,473,"rgb(248, 156, 116)"
13413,2020-03-23,Iceland,0,95,568,"rgb(248, 156, 116)"
13414,2020-03-24,Iceland,1,20,588,"rgb(248, 156, 116)"
13415,2020-03-25,Iceland,0,60,648,"rgb(248, 156, 116)"
13416,2020-03-26,Iceland,0,89,737,"rgb(248, 156, 116)"
13417,2020-03-27,Iceland,0,65,802,"rgb(248, 156, 116)"
13418,2020-03-28,Iceland,0,88,890,"rgb(248, 156, 116)"
13419,2020-03-29,Iceland,0,73,963,"rgb(248, 156, 116)"
13420,2020-03-30,Iceland,0,57,1020,"rgb(248, 156, 116)"
13421,2020-03-31,Iceland,0,66,1086,"rgb(248, 156, 116)"
13422,2020-04-01,Iceland,0,49,1135,"rgb(248, 156, 116)"
13423,2020-04-02,Iceland,0,85,1220,"rgb(248, 156, 116)"
13424,2020-04-03,Iceland,2,99,1319,"rgb(248, 156, 116)"
13425,2020-04-04,Iceland,0,45,1364,"rgb(248, 156, 116)"
13426,2020-04-05,Iceland,0,53,1417,"rgb(248, 156, 116)"
13427,2020-04-06,Iceland,0,69,1486,"rgb(248, 156, 116)"
13428,2020-04-07,Iceland,2,76,1562,"rgb(248, 156, 116)"
13429,2020-04-08,Iceland,0,24,1586,"rgb(248, 156, 116)"
13430,2020-04-09,Iceland,0,30,1616,"rgb(248, 156, 116)"
13431,2020-04-10,Iceland,0,32,1648,"rgb(248, 156, 116)"
13432,2020-04-11,Iceland,1,27,1675,"rgb(248, 156, 116)"
13433,2020-04-12,Iceland,1,14,1689,"rgb(248, 156, 116)"
13434,2020-04-13,Iceland,0,12,1701,"rgb(248, 156, 116)"
13435,2020-04-14,Iceland,0,10,1711,"rgb(248, 156, 116)"
13436,2020-04-15,Iceland,0,9,1720,"rgb(248, 156, 116)"
13437,2020-04-16,Iceland,0,7,1727,"rgb(248, 156, 116)"
13438,2020-04-17,Iceland,0,12,1739,"rgb(248, 156, 116)"
13439,2020-04-18,Iceland,0,15,1754,"rgb(248, 156, 116)"
13440,2020-04-19,Iceland,1,6,1760,"rgb(248, 156, 116)"
13441,2020-04-20,Iceland,0,11,1771,"rgb(248, 156, 116)"
13442,2020-04-21,Iceland,1,2,1773,"rgb(248, 156, 116)"
13443,2020-04-22,Iceland,0,5,1778,"rgb(248, 156, 116)"
13444,2020-04-23,Iceland,0,7,1785,"rgb(248, 156, 116)"
13445,2020-04-24,Iceland,0,4,1789,"rgb(248, 156, 116)"
13446,2020-04-25,Iceland,0,0,1789,"rgb(248, 156, 116)"
13447,2020-04-26,Iceland,0,1,1790,"rgb(248, 156, 116)"
13448,2020-04-27,Iceland,0,2,1792,"rgb(248, 156, 116)"
13449,2020-04-28,Iceland,0,0,1792,"rgb(248, 156, 116)"
13450,2020-04-29,Iceland,0,3,1795,"rgb(248, 156, 116)"
13451,2020-04-30,Iceland,0,2,1797,"rgb(248, 156, 116)"
13452,2020-05-01,Iceland,0,0,1797,"rgb(248, 156, 116)"
13453,2020-05-02,Iceland,0,1,1798,"rgb(248, 156, 116)"
13454,2020-05-03,Iceland,0,0,1798,"rgb(248, 156, 116)"
13455,2020-05-04,Iceland,0,1,1799,"rgb(248, 156, 116)"
13456,2020-05-05,Iceland,0,0,1799,"rgb(248, 156, 116)"
13457,2020-05-06,Iceland,0,0,1799,"rgb(248, 156, 116)"
13458,2020-05-07,Iceland,0,0,1799,"rgb(248, 156, 116)"
13459,2020-05-08,Iceland,0,2,1801,"rgb(248, 156, 116)"
13460,2020-05-09,Iceland,0,0,1801,"rgb(248, 156, 116)"
13461,2020-05-10,Iceland,0,0,1801,"rgb(248, 156, 116)"
13462,2020-05-11,Iceland,0,0,1801,"rgb(248, 156, 116)"
13463,2020-05-12,Iceland,0,0,1801,"rgb(248, 156, 116)"
13464,2020-05-13,Iceland,0,0,1801,"rgb(248, 156, 116)"
13465,2020-05-14,Iceland,0,1,1802,"rgb(248, 156, 116)"
13466,2020-05-15,Iceland,0,0,1802,"rgb(248, 156, 116)"
13467,2020-05-16,Iceland,0,0,1802,"rgb(248, 156, 116)"
13468,2020-05-17,Iceland,0,0,1802,"rgb(248, 156, 116)"
13469,2020-05-18,Iceland,0,0,1802,"rgb(248, 156, 116)"
13470,2020-05-19,Iceland,0,0,1802,"rgb(248, 156, 116)"
13471,2020-05-20,Iceland,0,0,1802,"rgb(248, 156, 116)"
13472,2020-05-21,Iceland,0,1,1803,"rgb(248, 156, 116)"
13473,2020-05-22,Iceland,0,0,1803,"rgb(248, 156, 116)"
13474,2020-05-23,Iceland,0,0,1803,"rgb(248, 156, 116)"
13475,2020-05-24,Iceland,0,1,1804,"rgb(248, 156, 116)"
13476,2020-05-25,Iceland,0,0,1804,"rgb(248, 156, 116)"
13477,2020-05-26,Iceland,0,0,1804,"rgb(248, 156, 116)"
13478,2020-05-27,Iceland,0,0,1804,"rgb(248, 156, 116)"
13479,2020-05-28,Iceland,0,1,1805,"rgb(248, 156, 116)"
13480,2020-05-29,Iceland,0,0,1805,"rgb(248, 156, 116)"
13481,2020-05-30,Iceland,0,0,1805,"rgb(248, 156, 116)"
13482,2020-05-31,Iceland,0,1,1806,"rgb(248, 156, 116)"
13483,2020-06-01,Iceland,0,0,1806,"rgb(248, 156, 116)"
13484,2020-06-02,Iceland,0,0,1806,"rgb(248, 156, 116)"
13485,2020-06-03,Iceland,0,0,1806,"rgb(248, 156, 116)"
13486,2020-06-04,Iceland,0,0,1806,"rgb(248, 156, 116)"
13487,2020-06-05,Iceland,0,0,1806,"rgb(248, 156, 116)"
13488,2020-06-06,Iceland,0,0,1806,"rgb(248, 156, 116)"
13489,2020-06-07,Iceland,0,0,1806,"rgb(248, 156, 116)"
13490,2020-06-08,Iceland,0,1,1807,"rgb(248, 156, 116)"
13491,2020-06-09,Iceland,0,0,1807,"rgb(248, 156, 116)"
13492,2020-06-10,Iceland,0,0,1807,"rgb(248, 156, 116)"
13493,2020-06-11,Iceland,0,0,1807,"rgb(248, 156, 116)"
13494,2020-06-12,Iceland,0,0,1807,"rgb(248, 156, 116)"
13495,2020-06-13,Iceland,0,0,1807,"rgb(248, 156, 116)"
13496,2020-06-14,Iceland,0,1,1808,"rgb(248, 156, 116)"
13497,2020-06-15,Iceland,0,2,1810,"rgb(248, 156, 116)"
13498,2020-06-16,Iceland,0,0,1810,"rgb(248, 156, 116)"
13499,2020-06-17,Iceland,0,2,1812,"rgb(248, 156, 116)"
13500,2020-06-18,Iceland,0,3,1815,"rgb(248, 156, 116)"
13501,2020-06-19,Iceland,0,1,1816,"rgb(248, 156, 116)"
13502,2020-06-20,Iceland,0,3,1819,"rgb(248, 156, 116)"
13503,2020-06-21,Iceland,0,3,1822,"rgb(248, 156, 116)"
13504,2020-06-22,Iceland,0,1,1823,"rgb(248, 156, 116)"
13505,2020-06-23,Iceland,0,0,1823,"rgb(248, 156, 116)"
13506,2020-06-24,Iceland,0,1,1824,"rgb(248, 156, 116)"
13507,2020-06-25,Iceland,0,3,1827,"rgb(248, 156, 116)"
13508,2020-06-26,Iceland,0,3,1830,"rgb(248, 156, 116)"
13509,2020-06-27,Iceland,0,2,1832,"rgb(248, 156, 116)"
13510,2020-06-28,Iceland,0,4,1836,"rgb(248, 156, 116)"
13511,2020-06-29,Iceland,0,2,1838,"rgb(248, 156, 116)"
13512,2020-06-30,Iceland,0,2,1840,"rgb(248, 156, 116)"
13513,2020-07-01,Iceland,0,2,1842,"rgb(248, 156, 116)"
13514,2020-07-02,Iceland,0,5,1847,"rgb(248, 156, 116)"
13515,2020-07-03,Iceland,0,3,1850,"rgb(248, 156, 116)"
13516,2020-07-04,Iceland,0,5,1855,"rgb(248, 156, 116)"
13517,2020-07-05,Iceland,0,5,1860,"rgb(248, 156, 116)"
13518,2020-07-06,Iceland,0,3,1863,"rgb(248, 156, 116)"
13519,2020-07-07,Iceland,0,3,1866,"rgb(248, 156, 116)"
13520,2020-07-08,Iceland,0,7,1873,"rgb(248, 156, 116)"
13521,2020-07-09,Iceland,0,7,1880,"rgb(248, 156, 116)"
13522,2020-07-10,Iceland,0,2,1882,"rgb(248, 156, 116)"
13523,2020-07-11,Iceland,0,4,1886,"rgb(248, 156, 116)"
13524,2020-07-12,Iceland,0,2,1888,"rgb(248, 156, 116)"
13525,2020-07-13,Iceland,0,8,1896,"rgb(248, 156, 116)"
13526,2019-12-31,Italy,0,0,0,"rgb(220, 176, 242)"
13527,2020-01-01,Italy,0,0,0,"rgb(220, 176, 242)"
13528,2020-01-02,Italy,0,0,0,"rgb(220, 176, 242)"
13529,2020-01-03,Italy,0,0,0,"rgb(220, 176, 242)"
13530,2020-01-04,Italy,0,0,0,"rgb(220, 176, 242)"
13531,2020-01-05,Italy,0,0,0,"rgb(220, 176, 242)"
13532,2020-01-06,Italy,0,0,0,"rgb(220, 176, 242)"
13533,2020-01-07,Italy,0,0,0,"rgb(220, 176, 242)"
13534,2020-01-08,Italy,0,0,0,"rgb(220, 176, 242)"
13535,2020-01-09,Italy,0,0,0,"rgb(220, 176, 242)"
13536,2020-01-10,Italy,0,0,0,"rgb(220, 176, 242)"
13537,2020-01-11,Italy,0,0,0,"rgb(220, 176, 242)"
13538,2020-01-12,Italy,0,0,0,"rgb(220, 176, 242)"
13539,2020-01-13,Italy,0,0,0,"rgb(220, 176, 242)"
13540,2020-01-14,Italy,0,0,0,"rgb(220, 176, 242)"
13541,2020-01-15,Italy,0,0,0,"rgb(220, 176, 242)"
13542,2020-01-16,Italy,0,0,0,"rgb(220, 176, 242)"
13543,2020-01-17,Italy,0,0,0,"rgb(220, 176, 242)"
13544,2020-01-18,Italy,0,0,0,"rgb(220, 176, 242)"
13545,2020-01-19,Italy,0,0,0,"rgb(220, 176, 242)"
13546,2020-01-20,Italy,0,0,0,"rgb(220, 176, 242)"
13547,2020-01-21,Italy,0,0,0,"rgb(220, 176, 242)"
13548,2020-01-22,Italy,0,0,0,"rgb(220, 176, 242)"
13549,2020-01-23,Italy,0,0,0,"rgb(220, 176, 242)"
13550,2020-01-24,Italy,0,0,0,"rgb(220, 176, 242)"
13551,2020-01-25,Italy,0,0,0,"rgb(220, 176, 242)"
13552,2020-01-26,Italy,0,0,0,"rgb(220, 176, 242)"
13553,2020-01-27,Italy,0,0,0,"rgb(220, 176, 242)"
13554,2020-01-28,Italy,0,0,0,"rgb(220, 176, 242)"
13555,2020-01-29,Italy,0,0,0,"rgb(220, 176, 242)"
13556,2020-01-30,Italy,0,0,0,"rgb(220, 176, 242)"
13557,2020-01-31,Italy,0,3,3,"rgb(220, 176, 242)"
13558,2020-02-01,Italy,0,0,3,"rgb(220, 176, 242)"
13559,2020-02-02,Italy,0,0,3,"rgb(220, 176, 242)"
13560,2020-02-03,Italy,0,0,3,"rgb(220, 176, 242)"
13561,2020-02-04,Italy,0,0,3,"rgb(220, 176, 242)"
13562,2020-02-05,Italy,0,0,3,"rgb(220, 176, 242)"
13563,2020-02-06,Italy,0,0,3,"rgb(220, 176, 242)"
13564,2020-02-07,Italy,0,0,3,"rgb(220, 176, 242)"
13565,2020-02-08,Italy,0,0,3,"rgb(220, 176, 242)"
13566,2020-02-09,Italy,0,0,3,"rgb(220, 176, 242)"
13567,2020-02-10,Italy,0,0,3,"rgb(220, 176, 242)"
13568,2020-02-11,Italy,0,0,3,"rgb(220, 176, 242)"
13569,2020-02-12,Italy,0,0,3,"rgb(220, 176, 242)"
13570,2020-02-13,Italy,0,0,3,"rgb(220, 176, 242)"
13571,2020-02-14,Italy,0,0,3,"rgb(220, 176, 242)"
13572,2020-02-15,Italy,0,0,3,"rgb(220, 176, 242)"
13573,2020-02-16,Italy,0,0,3,"rgb(220, 176, 242)"
13574,2020-02-17,Italy,0,0,3,"rgb(220, 176, 242)"
13575,2020-02-18,Italy,0,0,3,"rgb(220, 176, 242)"
13576,2020-02-19,Italy,0,0,3,"rgb(220, 176, 242)"
13577,2020-02-20,Italy,0,0,3,"rgb(220, 176, 242)"
13578,2020-02-21,Italy,0,0,3,"rgb(220, 176, 242)"
13579,2020-02-22,Italy,0,14,17,"rgb(220, 176, 242)"
13580,2020-02-23,Italy,2,62,79,"rgb(220, 176, 242)"
13581,2020-02-24,Italy,0,53,132,"rgb(220, 176, 242)"
13582,2020-02-25,Italy,4,97,229,"rgb(220, 176, 242)"
13583,2020-02-26,Italy,5,93,322,"rgb(220, 176, 242)"
13584,2020-02-27,Italy,1,78,400,"rgb(220, 176, 242)"
13585,2020-02-28,Italy,5,250,650,"rgb(220, 176, 242)"
13586,2020-02-29,Italy,4,238,888,"rgb(220, 176, 242)"
13587,2020-03-01,Italy,8,240,1128,"rgb(220, 176, 242)"
13588,2020-03-02,Italy,6,561,1689,"rgb(220, 176, 242)"
13589,2020-03-03,Italy,17,347,2036,"rgb(220, 176, 242)"
13590,2020-03-04,Italy,28,466,2502,"rgb(220, 176, 242)"
13591,2020-03-05,Italy,27,587,3089,"rgb(220, 176, 242)"
13592,2020-03-06,Italy,41,769,3858,"rgb(220, 176, 242)"
13593,2020-03-07,Italy,49,778,4636,"rgb(220, 176, 242)"
13594,2020-03-08,Italy,36,1247,5883,"rgb(220, 176, 242)"
13595,2020-03-09,Italy,133,1492,7375,"rgb(220, 176, 242)"
13596,2020-03-10,Italy,98,1797,9172,"rgb(220, 176, 242)"
13597,2020-03-11,Italy,167,977,10149,"rgb(220, 176, 242)"
13598,2020-03-12,Italy,196,2313,12462,"rgb(220, 176, 242)"
13599,2020-03-13,Italy,189,2651,15113,"rgb(220, 176, 242)"
13600,2020-03-14,Italy,252,2547,17660,"rgb(220, 176, 242)"
13601,2020-03-15,Italy,173,3497,21157,"rgb(220, 176, 242)"
13602,2020-03-16,Italy,370,2823,23980,"rgb(220, 176, 242)"
13603,2020-03-17,Italy,347,4000,27980,"rgb(220, 176, 242)"
13604,2020-03-18,Italy,347,3526,31506,"rgb(220, 176, 242)"
13605,2020-03-19,Italy,473,4207,35713,"rgb(220, 176, 242)"
13606,2020-03-20,Italy,429,5322,41035,"rgb(220, 176, 242)"
13607,2020-03-21,Italy,625,5986,47021,"rgb(220, 176, 242)"
13608,2020-03-22,Italy,795,6557,53578,"rgb(220, 176, 242)"
13609,2020-03-23,Italy,649,5560,59138,"rgb(220, 176, 242)"
13610,2020-03-24,Italy,601,4789,63927,"rgb(220, 176, 242)"
13611,2020-03-25,Italy,743,5249,69176,"rgb(220, 176, 242)"
13612,2020-03-26,Italy,685,5210,74386,"rgb(220, 176, 242)"
13613,2020-03-27,Italy,660,6153,80539,"rgb(220, 176, 242)"
13614,2020-03-28,Italy,971,5959,86498,"rgb(220, 176, 242)"
13615,2020-03-29,Italy,887,5974,92472,"rgb(220, 176, 242)"
13616,2020-03-30,Italy,758,5217,97689,"rgb(220, 176, 242)"
13617,2020-03-31,Italy,810,4050,101739,"rgb(220, 176, 242)"
13618,2020-04-01,Italy,839,4053,105792,"rgb(220, 176, 242)"
13619,2020-04-02,Italy,727,4782,110574,"rgb(220, 176, 242)"
13620,2020-04-03,Italy,760,4668,115242,"rgb(220, 176, 242)"
13621,2020-04-04,Italy,764,4585,119827,"rgb(220, 176, 242)"
13622,2020-04-05,Italy,681,4805,124632,"rgb(220, 176, 242)"
13623,2020-04-06,Italy,527,4316,128948,"rgb(220, 176, 242)"
13624,2020-04-07,Italy,636,3599,132547,"rgb(220, 176, 242)"
13625,2020-04-08,Italy,604,3039,135586,"rgb(220, 176, 242)"
13626,2020-04-09,Italy,540,3836,139422,"rgb(220, 176, 242)"
13627,2020-04-10,Italy,612,4204,143626,"rgb(220, 176, 242)"
13628,2020-04-11,Italy,570,3951,147577,"rgb(220, 176, 242)"
13629,2020-04-12,Italy,619,4694,152271,"rgb(220, 176, 242)"
13630,2020-04-13,Italy,431,4092,156363,"rgb(220, 176, 242)"
13631,2020-04-14,Italy,564,3153,159516,"rgb(220, 176, 242)"
13632,2020-04-15,Italy,604,2972,162488,"rgb(220, 176, 242)"
13633,2020-04-16,Italy,578,2667,165155,"rgb(220, 176, 242)"
13634,2020-04-17,Italy,525,3786,168941,"rgb(220, 176, 242)"
13635,2020-04-18,Italy,575,3493,172434,"rgb(220, 176, 242)"
13636,2020-04-19,Italy,480,3491,175925,"rgb(220, 176, 242)"
13637,2020-04-20,Italy,433,3047,178972,"rgb(220, 176, 242)"
13638,2020-04-21,Italy,454,2256,181228,"rgb(220, 176, 242)"
13639,2020-04-22,Italy,534,2729,183957,"rgb(220, 176, 242)"
13640,2020-04-23,Italy,437,3370,187327,"rgb(220, 176, 242)"
13641,2020-04-24,Italy,464,2646,189973,"rgb(220, 176, 242)"
13642,2020-04-25,Italy,420,3021,192994,"rgb(220, 176, 242)"
13643,2020-04-26,Italy,415,2357,195351,"rgb(220, 176, 242)"
13644,2020-04-27,Italy,260,2324,197675,"rgb(220, 176, 242)"
13645,2020-04-28,Italy,333,1739,199414,"rgb(220, 176, 242)"
13646,2020-04-29,Italy,382,2091,201505,"rgb(220, 176, 242)"
13647,2020-04-30,Italy,323,2086,203591,"rgb(220, 176, 242)"
13648,2020-05-01,Italy,285,1872,205463,"rgb(220, 176, 242)"
13649,2020-05-02,Italy,269,1965,207428,"rgb(220, 176, 242)"
13650,2020-05-03,Italy,474,1900,209328,"rgb(220, 176, 242)"
13651,2020-05-04,Italy,174,1389,210717,"rgb(220, 176, 242)"
13652,2020-05-05,Italy,195,1221,211938,"rgb(220, 176, 242)"
13653,2020-05-06,Italy,236,1075,213013,"rgb(220, 176, 242)"
13654,2020-05-07,Italy,369,1444,214457,"rgb(220, 176, 242)"
13655,2020-05-08,Italy,274,1401,215858,"rgb(220, 176, 242)"
13656,2020-05-09,Italy,243,1327,217185,"rgb(220, 176, 242)"
13657,2020-05-10,Italy,194,1083,218268,"rgb(220, 176, 242)"
13658,2020-05-11,Italy,165,802,219070,"rgb(220, 176, 242)"
13659,2020-05-12,Italy,179,744,219814,"rgb(220, 176, 242)"
13660,2020-05-13,Italy,172,1402,221216,"rgb(220, 176, 242)"
13661,2020-05-14,Italy,195,888,222104,"rgb(220, 176, 242)"
13662,2020-05-15,Italy,262,992,223096,"rgb(220, 176, 242)"
13663,2020-05-16,Italy,242,789,223885,"rgb(220, 176, 242)"
13664,2020-05-17,Italy,153,875,224760,"rgb(220, 176, 242)"
13665,2020-05-18,Italy,145,675,225435,"rgb(220, 176, 242)"
13666,2020-05-19,Italy,99,451,225886,"rgb(220, 176, 242)"
13667,2020-05-20,Italy,162,813,226699,"rgb(220, 176, 242)"
13668,2020-05-21,Italy,161,665,227364,"rgb(220, 176, 242)"
13669,2020-05-22,Italy,156,642,228006,"rgb(220, 176, 242)"
13670,2020-05-23,Italy,130,652,228658,"rgb(220, 176, 242)"
13671,2020-05-24,Italy,119,669,229327,"rgb(220, 176, 242)"
13672,2020-05-25,Italy,50,531,229858,"rgb(220, 176, 242)"
13673,2020-05-26,Italy,92,300,230158,"rgb(220, 176, 242)"
13674,2020-05-27,Italy,78,397,230555,"rgb(220, 176, 242)"
13675,2020-05-28,Italy,117,584,231139,"rgb(220, 176, 242)"
13676,2020-05-29,Italy,70,593,231732,"rgb(220, 176, 242)"
13677,2020-05-30,Italy,87,516,232248,"rgb(220, 176, 242)"
13678,2020-05-31,Italy,111,416,232664,"rgb(220, 176, 242)"
13679,2020-06-01,Italy,75,355,233019,"rgb(220, 176, 242)"
13680,2020-06-02,Italy,60,178,233197,"rgb(220, 176, 242)"
13681,2020-06-03,Italy,55,318,233515,"rgb(220, 176, 242)"
13682,2020-06-04,Italy,71,321,233836,"rgb(220, 176, 242)"
13683,2020-06-05,Italy,88,177,234013,"rgb(220, 176, 242)"
13684,2020-06-06,Italy,85,518,234531,"rgb(220, 176, 242)"
13685,2020-06-07,Italy,72,270,234801,"rgb(220, 176, 242)"
13686,2020-06-08,Italy,53,197,234998,"rgb(220, 176, 242)"
13687,2020-06-09,Italy,65,280,235278,"rgb(220, 176, 242)"
13688,2020-06-10,Italy,79,283,235561,"rgb(220, 176, 242)"
13689,2020-06-11,Italy,71,202,235763,"rgb(220, 176, 242)"
13690,2020-06-12,Italy,53,379,236142,"rgb(220, 176, 242)"
13691,2020-06-13,Italy,56,163,236305,"rgb(220, 176, 242)"
13692,2020-06-14,Italy,78,346,236651,"rgb(220, 176, 242)"
13693,2020-06-15,Italy,44,338,236989,"rgb(220, 176, 242)"
13694,2020-06-16,Italy,26,301,237290,"rgb(220, 176, 242)"
13695,2020-06-17,Italy,34,210,237500,"rgb(220, 176, 242)"
13696,2020-06-18,Italy,43,328,237828,"rgb(220, 176, 242)"
13697,2020-06-19,Italy,66,331,238159,"rgb(220, 176, 242)"
13698,2020-06-20,Italy,47,-148,238011,"rgb(220, 176, 242)"
13699,2020-06-21,Italy,49,264,238275,"rgb(220, 176, 242)"
13700,2020-06-22,Italy,24,224,238499,"rgb(220, 176, 242)"
13701,2020-06-23,Italy,23,221,238720,"rgb(220, 176, 242)"
13702,2020-06-24,Italy,18,113,238833,"rgb(220, 176, 242)"
13703,2020-06-25,Italy,-31,577,239410,"rgb(220, 176, 242)"
13704,2020-06-26,Italy,34,296,239706,"rgb(220, 176, 242)"
13705,2020-06-27,Italy,30,255,239961,"rgb(220, 176, 242)"
13706,2020-06-28,Italy,8,175,240136,"rgb(220, 176, 242)"
13707,2020-06-29,Italy,22,174,240310,"rgb(220, 176, 242)"
13708,2020-06-30,Italy,6,126,240436,"rgb(220, 176, 242)"
13709,2020-07-01,Italy,23,142,240578,"rgb(220, 176, 242)"
13710,2020-07-02,Italy,21,182,240760,"rgb(220, 176, 242)"
13711,2020-07-03,Italy,30,201,240961,"rgb(220, 176, 242)"
13712,2020-07-04,Italy,15,223,241184,"rgb(220, 176, 242)"
13713,2020-07-05,Italy,21,235,241419,"rgb(220, 176, 242)"
13714,2020-07-06,Italy,7,192,241611,"rgb(220, 176, 242)"
13715,2020-07-07,Italy,8,208,241819,"rgb(220, 176, 242)"
13716,2020-07-08,Italy,30,137,241956,"rgb(220, 176, 242)"
13717,2020-07-09,Italy,15,193,242149,"rgb(220, 176, 242)"
13718,2020-07-10,Italy,12,214,242363,"rgb(220, 176, 242)"
13719,2020-07-11,Italy,12,276,242639,"rgb(220, 176, 242)"
13720,2020-07-12,Italy,7,188,242827,"rgb(220, 176, 242)"
13721,2020-07-13,Italy,9,234,243061,"rgb(220, 176, 242)"
13722,2020-03-20,Jersey,0,5,5,"rgb(135, 197, 95)"
13723,2020-03-21,Jersey,0,7,12,"rgb(135, 197, 95)"
13724,2020-03-22,Jersey,0,0,12,"rgb(135, 197, 95)"
13725,2020-03-23,Jersey,0,3,15,"rgb(135, 197, 95)"
13726,2020-03-24,Jersey,0,3,18,"rgb(135, 197, 95)"
13727,2020-03-25,Jersey,0,0,18,"rgb(135, 197, 95)"
13728,2020-03-26,Jersey,0,0,18,"rgb(135, 197, 95)"
13729,2020-03-27,Jersey,1,14,32,"rgb(135, 197, 95)"
13730,2020-03-28,Jersey,0,20,52,"rgb(135, 197, 95)"
13731,2020-03-29,Jersey,0,9,61,"rgb(135, 197, 95)"
13732,2020-03-30,Jersey,1,2,63,"rgb(135, 197, 95)"
13733,2020-03-31,Jersey,0,0,63,"rgb(135, 197, 95)"
13734,2020-04-01,Jersey,0,18,81,"rgb(135, 197, 95)"
13735,2020-04-02,Jersey,0,0,81,"rgb(135, 197, 95)"
13736,2020-04-03,Jersey,0,0,81,"rgb(135, 197, 95)"
13737,2020-04-04,Jersey,0,37,118,"rgb(135, 197, 95)"
13738,2020-04-05,Jersey,1,5,123,"rgb(135, 197, 95)"
13739,2020-04-06,Jersey,0,32,155,"rgb(135, 197, 95)"
13740,2020-04-07,Jersey,0,14,169,"rgb(135, 197, 95)"
13741,2020-04-08,Jersey,0,1,170,"rgb(135, 197, 95)"
13742,2020-04-09,Jersey,0,0,170,"rgb(135, 197, 95)"
13743,2020-04-10,Jersey,0,13,183,"rgb(135, 197, 95)"
13744,2020-04-11,Jersey,1,15,198,"rgb(135, 197, 95)"
13745,2020-04-12,Jersey,0,0,198,"rgb(135, 197, 95)"
13746,2020-04-13,Jersey,0,15,213,"rgb(135, 197, 95)"
13747,2020-04-14,Jersey,0,4,217,"rgb(135, 197, 95)"
13748,2020-04-15,Jersey,0,0,217,"rgb(135, 197, 95)"
13749,2020-04-16,Jersey,2,0,217,"rgb(135, 197, 95)"
13750,2020-04-17,Jersey,4,6,223,"rgb(135, 197, 95)"
13751,2020-04-18,Jersey,1,1,224,"rgb(135, 197, 95)"
13752,2020-04-19,Jersey,1,21,245,"rgb(135, 197, 95)"
13753,2020-04-20,Jersey,0,4,249,"rgb(135, 197, 95)"
13754,2020-04-21,Jersey,2,0,249,"rgb(135, 197, 95)"
13755,2020-04-22,Jersey,0,6,255,"rgb(135, 197, 95)"
13756,2020-04-23,Jersey,4,0,255,"rgb(135, 197, 95)"
13757,2020-04-24,Jersey,1,21,276,"rgb(135, 197, 95)"
13758,2020-04-25,Jersey,0,2,278,"rgb(135, 197, 95)"
13759,2020-04-26,Jersey,0,2,280,"rgb(135, 197, 95)"
13760,2020-04-27,Jersey,0,1,281,"rgb(135, 197, 95)"
13761,2020-04-28,Jersey,0,2,283,"rgb(135, 197, 95)"
13762,2020-04-29,Jersey,1,1,284,"rgb(135, 197, 95)"
13763,2020-04-30,Jersey,1,2,286,"rgb(135, 197, 95)"
13764,2020-05-01,Jersey,2,0,286,"rgb(135, 197, 95)"
13765,2020-05-02,Jersey,1,0,286,"rgb(135, 197, 95)"
13766,2020-05-03,Jersey,0,5,291,"rgb(135, 197, 95)"
13767,2020-05-04,Jersey,0,1,292,"rgb(135, 197, 95)"
13768,2020-05-05,Jersey,0,1,293,"rgb(135, 197, 95)"
13769,2020-05-06,Jersey,0,0,293,"rgb(135, 197, 95)"
13770,2020-05-07,Jersey,1,0,293,"rgb(135, 197, 95)"
13771,2020-05-08,Jersey,0,0,293,"rgb(135, 197, 95)"
13772,2020-05-09,Jersey,0,0,293,"rgb(135, 197, 95)"
13773,2020-05-10,Jersey,0,0,293,"rgb(135, 197, 95)"
13774,2020-05-11,Jersey,0,1,294,"rgb(135, 197, 95)"
13775,2020-05-12,Jersey,0,0,294,"rgb(135, 197, 95)"
13776,2020-05-13,Jersey,1,1,295,"rgb(135, 197, 95)"
13777,2020-05-14,Jersey,1,1,296,"rgb(135, 197, 95)"
13778,2020-05-15,Jersey,0,1,297,"rgb(135, 197, 95)"
13779,2020-05-16,Jersey,0,0,297,"rgb(135, 197, 95)"
13780,2020-05-17,Jersey,0,5,302,"rgb(135, 197, 95)"
13781,2020-05-18,Jersey,0,0,302,"rgb(135, 197, 95)"
13782,2020-05-19,Jersey,0,1,303,"rgb(135, 197, 95)"
13783,2020-05-20,Jersey,1,0,303,"rgb(135, 197, 95)"
13784,2020-05-21,Jersey,1,3,306,"rgb(135, 197, 95)"
13785,2020-05-22,Jersey,0,0,306,"rgb(135, 197, 95)"
13786,2020-05-23,Jersey,0,0,306,"rgb(135, 197, 95)"
13787,2020-05-24,Jersey,0,0,306,"rgb(135, 197, 95)"
13788,2020-05-25,Jersey,0,0,306,"rgb(135, 197, 95)"
13789,2020-05-26,Jersey,0,1,307,"rgb(135, 197, 95)"
13790,2020-05-27,Jersey,0,0,307,"rgb(135, 197, 95)"
13791,2020-05-28,Jersey,0,1,308,"rgb(135, 197, 95)"
13792,2020-05-29,Jersey,0,0,308,"rgb(135, 197, 95)"
13793,2020-05-30,Jersey,0,0,308,"rgb(135, 197, 95)"
13794,2020-05-31,Jersey,0,0,308,"rgb(135, 197, 95)"
13795,2020-06-01,Jersey,0,0,308,"rgb(135, 197, 95)"
13796,2020-06-02,Jersey,0,0,308,"rgb(135, 197, 95)"
13797,2020-06-03,Jersey,1,0,308,"rgb(135, 197, 95)"
13798,2020-06-04,Jersey,0,1,309,"rgb(135, 197, 95)"
13799,2020-06-05,Jersey,0,0,309,"rgb(135, 197, 95)"
13800,2020-06-06,Jersey,0,0,309,"rgb(135, 197, 95)"
13801,2020-06-07,Jersey,0,2,311,"rgb(135, 197, 95)"
13802,2020-06-08,Jersey,0,0,311,"rgb(135, 197, 95)"
13803,2020-06-09,Jersey,0,1,312,"rgb(135, 197, 95)"
13804,2020-06-10,Jersey,0,1,313,"rgb(135, 197, 95)"
13805,2020-06-11,Jersey,0,0,313,"rgb(135, 197, 95)"
13806,2020-06-12,Jersey,0,0,313,"rgb(135, 197, 95)"
13807,2020-06-13,Jersey,0,0,313,"rgb(135, 197, 95)"
13808,2020-06-14,Jersey,0,0,313,"rgb(135, 197, 95)"
13809,2020-06-15,Jersey,0,0,313,"rgb(135, 197, 95)"
13810,2020-06-16,Jersey,0,3,316,"rgb(135, 197, 95)"
13811,2020-06-17,Jersey,0,0,316,"rgb(135, 197, 95)"
13812,2020-06-18,Jersey,0,2,318,"rgb(135, 197, 95)"
13813,2020-06-19,Jersey,0,0,318,"rgb(135, 197, 95)"
13814,2020-06-20,Jersey,1,0,318,"rgb(135, 197, 95)"
13815,2020-06-21,Jersey,0,0,318,"rgb(135, 197, 95)"
13816,2020-06-22,Jersey,0,0,318,"rgb(135, 197, 95)"
13817,2020-06-23,Jersey,0,0,318,"rgb(135, 197, 95)"
13818,2020-06-24,Jersey,0,0,318,"rgb(135, 197, 95)"
13819,2020-06-25,Jersey,0,1,319,"rgb(135, 197, 95)"
13820,2020-06-26,Jersey,0,0,319,"rgb(135, 197, 95)"
13821,2020-06-27,Jersey,0,0,319,"rgb(135, 197, 95)"
13822,2020-06-28,Jersey,0,0,319,"rgb(135, 197, 95)"
13823,2020-06-29,Jersey,0,0,319,"rgb(135, 197, 95)"
13824,2020-06-30,Jersey,0,0,319,"rgb(135, 197, 95)"
13825,2020-07-01,Jersey,0,0,319,"rgb(135, 197, 95)"
13826,2020-07-02,Jersey,0,0,319,"rgb(135, 197, 95)"
13827,2020-07-03,Jersey,0,1,320,"rgb(135, 197, 95)"
13828,2020-07-04,Jersey,0,0,320,"rgb(135, 197, 95)"
13829,2020-07-05,Jersey,0,0,320,"rgb(135, 197, 95)"
13830,2020-07-06,Jersey,0,0,320,"rgb(135, 197, 95)"
13831,2020-07-07,Jersey,0,5,325,"rgb(135, 197, 95)"
13832,2020-07-08,Jersey,0,0,325,"rgb(135, 197, 95)"
13833,2020-07-09,Jersey,0,0,325,"rgb(135, 197, 95)"
13834,2020-07-10,Jersey,0,0,325,"rgb(135, 197, 95)"
13835,2020-07-11,Jersey,0,0,325,"rgb(135, 197, 95)"
13836,2020-07-12,Jersey,0,0,325,"rgb(135, 197, 95)"
13837,2020-07-13,Jersey,0,0,325,"rgb(135, 197, 95)"
13838,2020-03-12,Jamaica,0,2,2,"rgb(158, 185, 243)"
13839,2020-03-13,Jamaica,0,4,6,"rgb(158, 185, 243)"
13840,2020-03-14,Jamaica,0,2,8,"rgb(158, 185, 243)"
13841,2020-03-16,Jamaica,0,2,10,"rgb(158, 185, 243)"
13842,2020-03-17,Jamaica,0,0,10,"rgb(158, 185, 243)"
13843,2020-03-18,Jamaica,0,3,13,"rgb(158, 185, 243)"
13844,2020-03-19,Jamaica,0,2,15,"rgb(158, 185, 243)"
13845,2020-03-20,Jamaica,0,1,16,"rgb(158, 185, 243)"
13846,2020-03-21,Jamaica,0,3,19,"rgb(158, 185, 243)"
13847,2020-03-22,Jamaica,0,0,19,"rgb(158, 185, 243)"
13848,2020-03-23,Jamaica,0,0,19,"rgb(158, 185, 243)"
13849,2020-03-24,Jamaica,0,0,19,"rgb(158, 185, 243)"
13850,2020-03-25,Jamaica,1,2,21,"rgb(158, 185, 243)"
13851,2020-03-26,Jamaica,0,4,25,"rgb(158, 185, 243)"
13852,2020-03-27,Jamaica,0,1,26,"rgb(158, 185, 243)"
13853,2020-03-28,Jamaica,0,0,26,"rgb(158, 185, 243)"
13854,2020-03-29,Jamaica,0,6,32,"rgb(158, 185, 243)"
13855,2020-03-30,Jamaica,0,2,34,"rgb(158, 185, 243)"
13856,2020-03-31,Jamaica,0,4,38,"rgb(158, 185, 243)"
13857,2020-04-01,Jamaica,0,0,38,"rgb(158, 185, 243)"
13858,2020-04-02,Jamaica,2,6,44,"rgb(158, 185, 243)"
13859,2020-04-03,Jamaica,0,3,47,"rgb(158, 185, 243)"
13860,2020-04-04,Jamaica,0,6,53,"rgb(158, 185, 243)"
13861,2020-04-05,Jamaica,0,2,55,"rgb(158, 185, 243)"
13862,2020-04-06,Jamaica,0,3,58,"rgb(158, 185, 243)"
13863,2020-04-07,Jamaica,0,1,59,"rgb(158, 185, 243)"
13864,2020-04-08,Jamaica,0,4,63,"rgb(158, 185, 243)"
13865,2020-04-09,Jamaica,1,0,63,"rgb(158, 185, 243)"
13866,2020-04-10,Jamaica,0,0,63,"rgb(158, 185, 243)"
13867,2020-04-11,Jamaica,0,2,65,"rgb(158, 185, 243)"
13868,2020-04-12,Jamaica,0,4,69,"rgb(158, 185, 243)"
13869,2020-04-13,Jamaica,0,3,72,"rgb(158, 185, 243)"
13870,2020-04-14,Jamaica,0,1,73,"rgb(158, 185, 243)"
13871,2020-04-15,Jamaica,1,32,105,"rgb(158, 185, 243)"
13872,2020-04-16,Jamaica,0,20,125,"rgb(158, 185, 243)"
13873,2020-04-17,Jamaica,0,18,143,"rgb(158, 185, 243)"
13874,2020-04-18,Jamaica,0,20,163,"rgb(158, 185, 243)"
13875,2020-04-19,Jamaica,0,10,173,"rgb(158, 185, 243)"
13876,2020-04-20,Jamaica,0,23,196,"rgb(158, 185, 243)"
13877,2020-04-21,Jamaica,1,27,223,"rgb(158, 185, 243)"
13878,2020-04-22,Jamaica,0,10,233,"rgb(158, 185, 243)"
13879,2020-04-23,Jamaica,0,19,252,"rgb(158, 185, 243)"
13880,2020-04-24,Jamaica,0,0,252,"rgb(158, 185, 243)"
13881,2020-04-25,Jamaica,1,36,288,"rgb(158, 185, 243)"
13882,2020-04-26,Jamaica,0,17,305,"rgb(158, 185, 243)"
13883,2020-04-27,Jamaica,0,45,350,"rgb(158, 185, 243)"
13884,2020-04-28,Jamaica,0,14,364,"rgb(158, 185, 243)"
13885,2020-04-29,Jamaica,0,17,381,"rgb(158, 185, 243)"
13886,2020-04-30,Jamaica,0,15,396,"rgb(158, 185, 243)"
13887,2020-05-01,Jamaica,1,26,422,"rgb(158, 185, 243)"
13888,2020-05-02,Jamaica,0,10,432,"rgb(158, 185, 243)"
13889,2020-05-03,Jamaica,0,31,463,"rgb(158, 185, 243)"
13890,2020-05-04,Jamaica,1,6,469,"rgb(158, 185, 243)"
13891,2020-05-05,Jamaica,0,2,471,"rgb(158, 185, 243)"
13892,2020-05-06,Jamaica,0,2,473,"rgb(158, 185, 243)"
13893,2020-05-07,Jamaica,0,5,478,"rgb(158, 185, 243)"
13894,2020-05-08,Jamaica,0,10,488,"rgb(158, 185, 243)"
13895,2020-05-09,Jamaica,0,2,490,"rgb(158, 185, 243)"
13896,2020-05-10,Jamaica,0,8,498,"rgb(158, 185, 243)"
13897,2020-05-11,Jamaica,0,4,502,"rgb(158, 185, 243)"
13898,2020-05-12,Jamaica,0,3,505,"rgb(158, 185, 243)"
13899,2020-05-13,Jamaica,0,2,507,"rgb(158, 185, 243)"
13900,2020-05-14,Jamaica,0,2,509,"rgb(158, 185, 243)"
13901,2020-05-15,Jamaica,0,0,509,"rgb(158, 185, 243)"
13902,2020-05-16,Jamaica,0,2,511,"rgb(158, 185, 243)"
13903,2020-05-17,Jamaica,0,6,517,"rgb(158, 185, 243)"
13904,2020-05-18,Jamaica,0,3,520,"rgb(158, 185, 243)"
13905,2020-05-19,Jamaica,0,0,520,"rgb(158, 185, 243)"
13906,2020-05-20,Jamaica,0,0,520,"rgb(158, 185, 243)"
13907,2020-05-21,Jamaica,0,9,529,"rgb(158, 185, 243)"
13908,2020-05-22,Jamaica,0,5,534,"rgb(158, 185, 243)"
13909,2020-05-23,Jamaica,0,10,544,"rgb(158, 185, 243)"
13910,2020-05-24,Jamaica,0,6,550,"rgb(158, 185, 243)"
13911,2020-05-25,Jamaica,0,2,552,"rgb(158, 185, 243)"
13912,2020-05-26,Jamaica,0,4,556,"rgb(158, 185, 243)"
13913,2020-05-27,Jamaica,0,8,564,"rgb(158, 185, 243)"
13914,2020-05-28,Jamaica,0,5,569,"rgb(158, 185, 243)"
13915,2020-05-29,Jamaica,0,0,569,"rgb(158, 185, 243)"
13916,2020-05-30,Jamaica,0,6,575,"rgb(158, 185, 243)"
13917,2020-05-31,Jamaica,0,6,581,"rgb(158, 185, 243)"
13918,2020-06-01,Jamaica,0,5,586,"rgb(158, 185, 243)"
13919,2020-06-02,Jamaica,0,2,588,"rgb(158, 185, 243)"
13920,2020-06-03,Jamaica,0,2,590,"rgb(158, 185, 243)"
13921,2020-06-04,Jamaica,0,0,590,"rgb(158, 185, 243)"
13922,2020-06-05,Jamaica,1,1,591,"rgb(158, 185, 243)"
13923,2020-06-06,Jamaica,0,4,595,"rgb(158, 185, 243)"
13924,2020-06-07,Jamaica,0,1,596,"rgb(158, 185, 243)"
13925,2020-06-08,Jamaica,0,2,598,"rgb(158, 185, 243)"
13926,2020-06-09,Jamaica,0,1,599,"rgb(158, 185, 243)"
13927,2020-06-10,Jamaica,0,6,605,"rgb(158, 185, 243)"
13928,2020-06-11,Jamaica,0,0,605,"rgb(158, 185, 243)"
13929,2020-06-12,Jamaica,0,6,611,"rgb(158, 185, 243)"
13930,2020-06-13,Jamaica,0,3,614,"rgb(158, 185, 243)"
13931,2020-06-14,Jamaica,0,1,615,"rgb(158, 185, 243)"
13932,2020-06-15,Jamaica,0,2,617,"rgb(158, 185, 243)"
13933,2020-06-16,Jamaica,0,4,621,"rgb(158, 185, 243)"
13934,2020-06-17,Jamaica,0,0,621,"rgb(158, 185, 243)"
13935,2020-06-18,Jamaica,0,5,626,"rgb(158, 185, 243)"
13936,2020-06-19,Jamaica,0,0,626,"rgb(158, 185, 243)"
13937,2020-06-20,Jamaica,0,26,652,"rgb(158, 185, 243)"
13938,2020-06-21,Jamaica,0,5,657,"rgb(158, 185, 243)"
13939,2020-06-22,Jamaica,0,2,659,"rgb(158, 185, 243)"
13940,2020-06-23,Jamaica,0,6,665,"rgb(158, 185, 243)"
13941,2020-06-24,Jamaica,0,5,670,"rgb(158, 185, 243)"
13942,2020-06-25,Jamaica,0,8,678,"rgb(158, 185, 243)"
13943,2020-06-26,Jamaica,0,6,684,"rgb(158, 185, 243)"
13944,2020-06-27,Jamaica,0,2,686,"rgb(158, 185, 243)"
13945,2020-06-28,Jamaica,0,4,690,"rgb(158, 185, 243)"
13946,2020-06-29,Jamaica,0,6,696,"rgb(158, 185, 243)"
13947,2020-06-30,Jamaica,0,2,698,"rgb(158, 185, 243)"
13948,2020-07-01,Jamaica,0,4,702,"rgb(158, 185, 243)"
13949,2020-07-02,Jamaica,0,5,707,"rgb(158, 185, 243)"
13950,2020-07-03,Jamaica,0,8,715,"rgb(158, 185, 243)"
13951,2020-07-04,Jamaica,0,6,721,"rgb(158, 185, 243)"
13952,2020-07-05,Jamaica,0,7,728,"rgb(158, 185, 243)"
13953,2020-07-06,Jamaica,0,4,732,"rgb(158, 185, 243)"
13954,2020-07-07,Jamaica,0,5,737,"rgb(158, 185, 243)"
13955,2020-07-08,Jamaica,0,8,745,"rgb(158, 185, 243)"
13956,2020-07-09,Jamaica,0,6,751,"rgb(158, 185, 243)"
13957,2020-07-10,Jamaica,0,2,753,"rgb(158, 185, 243)"
13958,2020-07-11,Jamaica,0,0,753,"rgb(158, 185, 243)"
13959,2020-07-12,Jamaica,0,5,758,"rgb(158, 185, 243)"
13960,2020-07-13,Jamaica,0,0,758,"rgb(158, 185, 243)"
13961,2020-03-03,Jordan,0,1,1,"rgb(254, 136, 177)"
13962,2020-03-08,Jordan,0,0,1,"rgb(254, 136, 177)"
13963,2020-03-15,Jordan,0,0,1,"rgb(254, 136, 177)"
13964,2020-03-16,Jordan,0,14,15,"rgb(254, 136, 177)"
13965,2020-03-17,Jordan,0,1,16,"rgb(254, 136, 177)"
13966,2020-03-18,Jordan,0,19,35,"rgb(254, 136, 177)"
13967,2020-03-19,Jordan,0,17,52,"rgb(254, 136, 177)"
13968,2020-03-20,Jordan,0,4,56,"rgb(254, 136, 177)"
13969,2020-03-21,Jordan,0,13,69,"rgb(254, 136, 177)"
13970,2020-03-22,Jordan,0,15,84,"rgb(254, 136, 177)"
13971,2020-03-23,Jordan,0,15,99,"rgb(254, 136, 177)"
13972,2020-03-24,Jordan,0,13,112,"rgb(254, 136, 177)"
13973,2020-03-25,Jordan,0,15,127,"rgb(254, 136, 177)"
13974,2020-03-26,Jordan,0,26,153,"rgb(254, 136, 177)"
13975,2020-03-27,Jordan,0,19,172,"rgb(254, 136, 177)"
13976,2020-03-28,Jordan,0,40,212,"rgb(254, 136, 177)"
13977,2020-03-29,Jordan,1,23,235,"rgb(254, 136, 177)"
13978,2020-03-30,Jordan,0,24,259,"rgb(254, 136, 177)"
13979,2020-03-31,Jordan,4,9,268,"rgb(254, 136, 177)"
13980,2020-04-01,Jordan,0,6,274,"rgb(254, 136, 177)"
13981,2020-04-02,Jordan,0,4,278,"rgb(254, 136, 177)"
13982,2020-04-03,Jordan,0,21,299,"rgb(254, 136, 177)"
13983,2020-04-04,Jordan,0,0,299,"rgb(254, 136, 177)"
13984,2020-04-05,Jordan,0,24,323,"rgb(254, 136, 177)"
13985,2020-04-06,Jordan,0,22,345,"rgb(254, 136, 177)"
13986,2020-04-07,Jordan,1,4,349,"rgb(254, 136, 177)"
13987,2020-04-08,Jordan,0,0,349,"rgb(254, 136, 177)"
13988,2020-04-09,Jordan,0,9,358,"rgb(254, 136, 177)"
13989,2020-04-10,Jordan,1,14,372,"rgb(254, 136, 177)"
13990,2020-04-11,Jordan,0,0,372,"rgb(254, 136, 177)"
13991,2020-04-12,Jordan,0,9,381,"rgb(254, 136, 177)"
13992,2020-04-13,Jordan,0,8,389,"rgb(254, 136, 177)"
13993,2020-04-14,Jordan,0,2,391,"rgb(254, 136, 177)"
13994,2020-04-15,Jordan,0,6,397,"rgb(254, 136, 177)"
13995,2020-04-16,Jordan,0,4,401,"rgb(254, 136, 177)"
13996,2020-04-17,Jordan,0,1,402,"rgb(254, 136, 177)"
13997,2020-04-18,Jordan,0,5,407,"rgb(254, 136, 177)"
13998,2020-04-19,Jordan,0,6,413,"rgb(254, 136, 177)"
13999,2020-04-20,Jordan,0,4,417,"rgb(254, 136, 177)"
14000,2020-04-21,Jordan,0,8,425,"rgb(254, 136, 177)"
14001,2020-04-22,Jordan,0,0,425,"rgb(254, 136, 177)"
14002,2020-04-23,Jordan,0,3,428,"rgb(254, 136, 177)"
14003,2020-04-24,Jordan,0,9,437,"rgb(254, 136, 177)"
14004,2020-04-25,Jordan,0,4,441,"rgb(254, 136, 177)"
14005,2020-04-26,Jordan,0,3,444,"rgb(254, 136, 177)"
14006,2020-04-27,Jordan,0,3,447,"rgb(254, 136, 177)"
14007,2020-04-28,Jordan,0,2,449,"rgb(254, 136, 177)"
14008,2020-04-29,Jordan,1,0,449,"rgb(254, 136, 177)"
14009,2020-04-30,Jordan,0,2,451,"rgb(254, 136, 177)"
14010,2020-05-01,Jordan,0,2,453,"rgb(254, 136, 177)"
14011,2020-05-02,Jordan,0,6,459,"rgb(254, 136, 177)"
14012,2020-05-03,Jordan,1,1,460,"rgb(254, 136, 177)"
14013,2020-05-04,Jordan,0,1,461,"rgb(254, 136, 177)"
14014,2020-05-05,Jordan,0,4,465,"rgb(254, 136, 177)"
14015,2020-05-06,Jordan,0,6,471,"rgb(254, 136, 177)"
14016,2020-05-07,Jordan,0,2,473,"rgb(254, 136, 177)"
14017,2020-05-08,Jordan,0,21,494,"rgb(254, 136, 177)"
14018,2020-05-09,Jordan,0,14,508,"rgb(254, 136, 177)"
14019,2020-05-10,Jordan,0,14,522,"rgb(254, 136, 177)"
14020,2020-05-11,Jordan,0,18,540,"rgb(254, 136, 177)"
14021,2020-05-12,Jordan,0,22,562,"rgb(254, 136, 177)"
14022,2020-05-13,Jordan,0,14,576,"rgb(254, 136, 177)"
14023,2020-05-14,Jordan,0,6,582,"rgb(254, 136, 177)"
14024,2020-05-15,Jordan,0,4,586,"rgb(254, 136, 177)"
14025,2020-05-16,Jordan,0,10,596,"rgb(254, 136, 177)"
14026,2020-05-17,Jordan,0,11,607,"rgb(254, 136, 177)"
14027,2020-05-18,Jordan,0,6,613,"rgb(254, 136, 177)"
14028,2020-05-19,Jordan,0,16,629,"rgb(254, 136, 177)"
14029,2020-05-20,Jordan,0,20,649,"rgb(254, 136, 177)"
14030,2020-05-21,Jordan,0,23,672,"rgb(254, 136, 177)"
14031,2020-05-22,Jordan,0,12,684,"rgb(254, 136, 177)"
14032,2020-05-23,Jordan,0,16,700,"rgb(254, 136, 177)"
14033,2020-05-24,Jordan,0,4,704,"rgb(254, 136, 177)"
14034,2020-05-25,Jordan,0,4,708,"rgb(254, 136, 177)"
14035,2020-05-26,Jordan,0,3,711,"rgb(254, 136, 177)"
14036,2020-05-27,Jordan,0,7,718,"rgb(254, 136, 177)"
14037,2020-05-28,Jordan,0,2,720,"rgb(254, 136, 177)"
14038,2020-05-29,Jordan,0,8,728,"rgb(254, 136, 177)"
14039,2020-05-30,Jordan,0,2,730,"rgb(254, 136, 177)"
14040,2020-05-31,Jordan,0,4,734,"rgb(254, 136, 177)"
14041,2020-06-01,Jordan,0,5,739,"rgb(254, 136, 177)"
14042,2020-06-02,Jordan,0,7,746,"rgb(254, 136, 177)"
14043,2020-06-03,Jordan,0,9,755,"rgb(254, 136, 177)"
14044,2020-06-04,Jordan,0,2,757,"rgb(254, 136, 177)"
14045,2020-06-05,Jordan,0,8,765,"rgb(254, 136, 177)"
14046,2020-06-06,Jordan,0,19,784,"rgb(254, 136, 177)"
14047,2020-06-07,Jordan,0,11,795,"rgb(254, 136, 177)"
14048,2020-06-08,Jordan,0,13,808,"rgb(254, 136, 177)"
14049,2020-06-09,Jordan,0,23,831,"rgb(254, 136, 177)"
14050,2020-06-10,Jordan,0,14,845,"rgb(254, 136, 177)"
14051,2020-06-11,Jordan,0,18,863,"rgb(254, 136, 177)"
14052,2020-06-12,Jordan,0,27,890,"rgb(254, 136, 177)"
14053,2020-06-13,Jordan,0,25,915,"rgb(254, 136, 177)"
14054,2020-06-14,Jordan,0,38,953,"rgb(254, 136, 177)"
14055,2020-06-15,Jordan,0,8,961,"rgb(254, 136, 177)"
14056,2020-06-16,Jordan,0,18,979,"rgb(254, 136, 177)"
14057,2020-06-17,Jordan,0,2,981,"rgb(254, 136, 177)"
14058,2020-06-18,Jordan,0,6,987,"rgb(254, 136, 177)"
14059,2020-06-19,Jordan,0,14,1001,"rgb(254, 136, 177)"
14060,2020-06-20,Jordan,0,7,1008,"rgb(254, 136, 177)"
14061,2020-06-21,Jordan,0,7,1015,"rgb(254, 136, 177)"
14062,2020-06-22,Jordan,0,18,1033,"rgb(254, 136, 177)"
14063,2020-06-23,Jordan,0,9,1042,"rgb(254, 136, 177)"
14064,2020-06-24,Jordan,0,5,1047,"rgb(254, 136, 177)"
14065,2020-06-25,Jordan,0,24,1071,"rgb(254, 136, 177)"
14066,2020-06-26,Jordan,0,15,1086,"rgb(254, 136, 177)"
14067,2020-06-27,Jordan,0,18,1104,"rgb(254, 136, 177)"
14068,2020-06-28,Jordan,0,7,1111,"rgb(254, 136, 177)"
14069,2020-06-29,Jordan,0,10,1121,"rgb(254, 136, 177)"
14070,2020-06-30,Jordan,0,7,1128,"rgb(254, 136, 177)"
14071,2020-07-01,Jordan,0,4,1132,"rgb(254, 136, 177)"
14072,2020-07-02,Jordan,0,1,1133,"rgb(254, 136, 177)"
14073,2020-07-03,Jordan,0,3,1136,"rgb(254, 136, 177)"
14074,2020-07-04,Jordan,1,11,1147,"rgb(254, 136, 177)"
14075,2020-07-05,Jordan,0,3,1150,"rgb(254, 136, 177)"
14076,2020-07-06,Jordan,0,14,1164,"rgb(254, 136, 177)"
14077,2020-07-07,Jordan,0,3,1167,"rgb(254, 136, 177)"
14078,2020-07-08,Jordan,0,2,1169,"rgb(254, 136, 177)"
14079,2020-07-09,Jordan,0,0,1169,"rgb(254, 136, 177)"
14080,2020-07-10,Jordan,0,0,1169,"rgb(254, 136, 177)"
14081,2020-07-11,Jordan,0,4,1173,"rgb(254, 136, 177)"
14082,2020-07-12,Jordan,0,3,1176,"rgb(254, 136, 177)"
14083,2020-07-13,Jordan,0,3,1179,"rgb(254, 136, 177)"
14084,2019-12-31,Japan,0,0,0,"rgb(201, 219, 116)"
14085,2020-01-01,Japan,0,0,0,"rgb(201, 219, 116)"
14086,2020-01-02,Japan,0,0,0,"rgb(201, 219, 116)"
14087,2020-01-03,Japan,0,0,0,"rgb(201, 219, 116)"
14088,2020-01-04,Japan,0,0,0,"rgb(201, 219, 116)"
14089,2020-01-05,Japan,0,0,0,"rgb(201, 219, 116)"
14090,2020-01-06,Japan,0,0,0,"rgb(201, 219, 116)"
14091,2020-01-07,Japan,0,0,0,"rgb(201, 219, 116)"
14092,2020-01-08,Japan,0,0,0,"rgb(201, 219, 116)"
14093,2020-01-09,Japan,0,0,0,"rgb(201, 219, 116)"
14094,2020-01-10,Japan,0,0,0,"rgb(201, 219, 116)"
14095,2020-01-11,Japan,0,0,0,"rgb(201, 219, 116)"
14096,2020-01-12,Japan,0,0,0,"rgb(201, 219, 116)"
14097,2020-01-13,Japan,0,0,0,"rgb(201, 219, 116)"
14098,2020-01-14,Japan,0,0,0,"rgb(201, 219, 116)"
14099,2020-01-15,Japan,0,1,1,"rgb(201, 219, 116)"
14100,2020-01-16,Japan,0,0,1,"rgb(201, 219, 116)"
14101,2020-01-17,Japan,0,0,1,"rgb(201, 219, 116)"
14102,2020-01-18,Japan,0,0,1,"rgb(201, 219, 116)"
14103,2020-01-19,Japan,0,0,1,"rgb(201, 219, 116)"
14104,2020-01-20,Japan,0,0,1,"rgb(201, 219, 116)"
14105,2020-01-21,Japan,0,0,1,"rgb(201, 219, 116)"
14106,2020-01-22,Japan,0,0,1,"rgb(201, 219, 116)"
14107,2020-01-23,Japan,0,0,1,"rgb(201, 219, 116)"
14108,2020-01-24,Japan,0,1,2,"rgb(201, 219, 116)"
14109,2020-01-25,Japan,0,0,2,"rgb(201, 219, 116)"
14110,2020-01-26,Japan,0,1,3,"rgb(201, 219, 116)"
14111,2020-01-27,Japan,0,0,3,"rgb(201, 219, 116)"
14112,2020-01-28,Japan,0,1,4,"rgb(201, 219, 116)"
14113,2020-01-29,Japan,0,3,7,"rgb(201, 219, 116)"
14114,2020-01-30,Japan,0,4,11,"rgb(201, 219, 116)"
14115,2020-01-31,Japan,0,3,14,"rgb(201, 219, 116)"
14116,2020-02-01,Japan,0,1,15,"rgb(201, 219, 116)"
14117,2020-02-02,Japan,0,4,19,"rgb(201, 219, 116)"
14118,2020-02-03,Japan,0,1,20,"rgb(201, 219, 116)"
14119,2020-02-04,Japan,0,0,20,"rgb(201, 219, 116)"
14120,2020-02-05,Japan,0,5,25,"rgb(201, 219, 116)"
14121,2020-02-06,Japan,0,0,25,"rgb(201, 219, 116)"
14122,2020-02-07,Japan,0,0,25,"rgb(201, 219, 116)"
14123,2020-02-08,Japan,0,0,25,"rgb(201, 219, 116)"
14124,2020-02-09,Japan,0,0,25,"rgb(201, 219, 116)"
14125,2020-02-10,Japan,0,0,25,"rgb(201, 219, 116)"
14126,2020-02-11,Japan,0,0,25,"rgb(201, 219, 116)"
14127,2020-02-12,Japan,0,0,25,"rgb(201, 219, 116)"
14128,2020-02-13,Japan,1,4,29,"rgb(201, 219, 116)"
14129,2020-02-14,Japan,0,1,30,"rgb(201, 219, 116)"
14130,2020-02-15,Japan,0,8,38,"rgb(201, 219, 116)"
14131,2020-02-16,Japan,0,14,52,"rgb(201, 219, 116)"
14132,2020-02-17,Japan,0,7,59,"rgb(201, 219, 116)"
14133,2020-02-18,Japan,0,0,59,"rgb(201, 219, 116)"
14134,2020-02-19,Japan,0,7,66,"rgb(201, 219, 116)"
14135,2020-02-20,Japan,0,18,84,"rgb(201, 219, 116)"
14136,2020-02-21,Japan,0,9,93,"rgb(201, 219, 116)"
14137,2020-02-22,Japan,0,12,105,"rgb(201, 219, 116)"
14138,2020-02-23,Japan,0,27,132,"rgb(201, 219, 116)"
14139,2020-02-24,Japan,0,12,144,"rgb(201, 219, 116)"
14140,2020-02-25,Japan,0,0,144,"rgb(201, 219, 116)"
14141,2020-02-26,Japan,0,20,164,"rgb(201, 219, 116)"
14142,2020-02-27,Japan,2,22,186,"rgb(201, 219, 116)"
14143,2020-02-28,Japan,0,24,210,"rgb(201, 219, 116)"
14144,2020-02-29,Japan,0,20,230,"rgb(201, 219, 116)"
14145,2020-03-01,Japan,2,9,239,"rgb(201, 219, 116)"
14146,2020-03-02,Japan,1,15,254,"rgb(201, 219, 116)"
14147,2020-03-03,Japan,0,0,254,"rgb(201, 219, 116)"
14148,2020-03-04,Japan,0,14,268,"rgb(201, 219, 116)"
14149,2020-03-05,Japan,0,49,317,"rgb(201, 219, 116)"
14150,2020-03-06,Japan,0,32,349,"rgb(201, 219, 116)"
14151,2020-03-07,Japan,0,59,408,"rgb(201, 219, 116)"
14152,2020-03-08,Japan,0,47,455,"rgb(201, 219, 116)"
14153,2020-03-09,Japan,1,33,488,"rgb(201, 219, 116)"
14154,2020-03-10,Japan,2,26,514,"rgb(201, 219, 116)"
14155,2020-03-11,Japan,3,54,568,"rgb(201, 219, 116)"
14156,2020-03-12,Japan,3,51,619,"rgb(201, 219, 116)"
14157,2020-03-13,Japan,4,56,675,"rgb(201, 219, 116)"
14158,2020-03-14,Japan,2,62,737,"rgb(201, 219, 116)"
14159,2020-03-15,Japan,1,43,780,"rgb(201, 219, 116)"
14160,2020-03-16,Japan,2,34,814,"rgb(201, 219, 116)"
14161,2020-03-17,Japan,4,10,824,"rgb(201, 219, 116)"
14162,2020-03-18,Japan,0,5,829,"rgb(201, 219, 116)"
14163,2020-03-19,Japan,1,44,873,"rgb(201, 219, 116)"
14164,2020-03-20,Japan,4,77,950,"rgb(201, 219, 116)"
14165,2020-03-21,Japan,2,57,1007,"rgb(201, 219, 116)"
14166,2020-03-22,Japan,1,39,1046,"rgb(201, 219, 116)"
14167,2020-03-23,Japan,5,43,1089,"rgb(201, 219, 116)"
14168,2020-03-24,Japan,1,39,1128,"rgb(201, 219, 116)"
14169,2020-03-25,Japan,1,65,1193,"rgb(201, 219, 116)"
14170,2020-03-26,Japan,2,75,1268,"rgb(201, 219, 116)"
14171,2020-03-27,Japan,1,96,1364,"rgb(201, 219, 116)"
14172,2020-03-28,Japan,3,135,1499,"rgb(201, 219, 116)"
14173,2020-03-29,Japan,3,194,1693,"rgb(201, 219, 116)"
14174,2020-03-30,Japan,2,173,1866,"rgb(201, 219, 116)"
14175,2020-03-31,Japan,2,87,1953,"rgb(201, 219, 116)"
14176,2020-04-01,Japan,0,0,1953,"rgb(201, 219, 116)"
14177,2020-04-02,Japan,1,225,2178,"rgb(201, 219, 116)"
14178,2020-04-03,Japan,6,439,2617,"rgb(201, 219, 116)"
14179,2020-04-04,Japan,6,318,2935,"rgb(201, 219, 116)"
14180,2020-04-05,Japan,1,336,3271,"rgb(201, 219, 116)"
14181,2020-04-06,Japan,3,383,3654,"rgb(201, 219, 116)"
14182,2020-04-07,Japan,7,163,3817,"rgb(201, 219, 116)"
14183,2020-04-08,Japan,0,89,3906,"rgb(201, 219, 116)"
14184,2020-04-09,Japan,1,351,4257,"rgb(201, 219, 116)"
14185,2020-04-10,Japan,4,410,4667,"rgb(201, 219, 116)"
14186,2020-04-11,Japan,3,680,5347,"rgb(201, 219, 116)"
14187,2020-04-12,Japan,10,1401,6748,"rgb(201, 219, 116)"
14188,2020-04-13,Japan,4,507,7255,"rgb(201, 219, 116)"
14189,2020-04-14,Japan,7,390,7645,"rgb(201, 219, 116)"
14190,2020-04-15,Japan,10,455,8100,"rgb(201, 219, 116)"
14191,2020-04-16,Japan,17,482,8582,"rgb(201, 219, 116)"
14192,2020-04-17,Japan,12,585,9167,"rgb(201, 219, 116)"
14193,2020-04-18,Japan,6,628,9795,"rgb(201, 219, 116)"
14194,2020-04-19,Japan,7,566,10361,"rgb(201, 219, 116)"
14195,2020-04-20,Japan,10,390,10751,"rgb(201, 219, 116)"
14196,2020-04-21,Japan,15,367,11118,"rgb(201, 219, 116)"
14197,2020-04-22,Japan,0,378,11496,"rgb(201, 219, 116)"
14198,2020-04-23,Japan,101,276,11772,"rgb(201, 219, 116)"
14199,2020-04-24,Japan,30,468,12240,"rgb(201, 219, 116)"
14200,2020-04-25,Japan,17,652,12892,"rgb(201, 219, 116)"
14201,2020-04-26,Japan,14,290,13182,"rgb(201, 219, 116)"
14202,2020-04-27,Japan,3,203,13385,"rgb(201, 219, 116)"
14203,2020-04-28,Japan,25,191,13576,"rgb(201, 219, 116)"
14204,2020-04-29,Japan,13,276,13852,"rgb(201, 219, 116)"
14205,2020-04-30,Japan,26,236,14088,"rgb(201, 219, 116)"
14206,2020-05-01,Japan,17,193,14281,"rgb(201, 219, 116)"
14207,2020-05-02,Japan,26,263,14544,"rgb(201, 219, 116)"
14208,2020-05-03,Japan,34,295,14839,"rgb(201, 219, 116)"
14209,2020-05-04,Japan,18,218,15057,"rgb(201, 219, 116)"
14210,2020-05-05,Japan,11,174,15231,"rgb(201, 219, 116)"
14211,2020-05-06,Japan,22,123,15354,"rgb(201, 219, 116)"
14212,2020-05-07,Japan,8,109,15463,"rgb(201, 219, 116)"
14213,2020-05-08,Japan,6,84,15547,"rgb(201, 219, 116)"
14214,2020-05-09,Japan,44,81,15628,"rgb(201, 219, 116)"
14215,2020-05-10,Japan,12,119,15747,"rgb(201, 219, 116)"
14216,2020-05-11,Japan,8,51,15798,"rgb(201, 219, 116)"
14217,2020-05-12,Japan,22,76,15874,"rgb(201, 219, 116)"
14218,2020-05-13,Japan,25,150,16024,"rgb(201, 219, 116)"
14219,2020-05-14,Japan,19,55,16079,"rgb(201, 219, 116)"
14220,2020-05-15,Japan,23,114,16193,"rgb(201, 219, 116)"
14221,2020-05-16,Japan,15,44,16237,"rgb(201, 219, 116)"
14222,2020-05-17,Japan,19,48,16285,"rgb(201, 219, 116)"
14223,2020-05-18,Japan,5,20,16305,"rgb(201, 219, 116)"
14224,2020-05-19,Japan,14,60,16365,"rgb(201, 219, 116)"
14225,2020-05-20,Japan,8,20,16385,"rgb(201, 219, 116)"
14226,2020-05-21,Japan,6,39,16424,"rgb(201, 219, 116)"
14227,2020-05-22,Japan,19,89,16513,"rgb(201, 219, 116)"
14228,2020-05-23,Japan,12,23,16536,"rgb(201, 219, 116)"
14229,2020-05-24,Japan,12,14,16550,"rgb(201, 219, 116)"
14230,2020-05-25,Japan,10,31,16581,"rgb(201, 219, 116)"
14231,2020-05-26,Japan,16,42,16623,"rgb(201, 219, 116)"
14232,2020-05-27,Japan,12,28,16651,"rgb(201, 219, 116)"
14233,2020-05-28,Japan,0,0,16651,"rgb(201, 219, 116)"
14234,2020-05-29,Japan,16,68,16719,"rgb(201, 219, 116)"
14235,2020-05-30,Japan,12,85,16804,"rgb(201, 219, 116)"
14236,2020-05-31,Japan,5,47,16851,"rgb(201, 219, 116)"
14237,2020-06-01,Japan,1,33,16884,"rgb(201, 219, 116)"
14238,2020-06-02,Japan,2,46,16930,"rgb(201, 219, 116)"
14239,2020-06-03,Japan,6,56,16986,"rgb(201, 219, 116)"
14240,2020-06-04,Japan,3,32,17018,"rgb(201, 219, 116)"
14241,2020-06-05,Japan,4,46,17064,"rgb(201, 219, 116)"
14242,2020-06-06,Japan,7,39,17103,"rgb(201, 219, 116)"
14243,2020-06-07,Japan,2,38,17141,"rgb(201, 219, 116)"
14244,2020-06-08,Japan,0,33,17174,"rgb(201, 219, 116)"
14245,2020-06-09,Japan,0,36,17210,"rgb(201, 219, 116)"
14246,2020-06-10,Japan,3,41,17251,"rgb(201, 219, 116)"
14247,2020-06-11,Japan,1,41,17292,"rgb(201, 219, 116)"
14248,2020-06-12,Japan,2,40,17332,"rgb(201, 219, 116)"
14249,2020-06-13,Japan,2,50,17382,"rgb(201, 219, 116)"
14250,2020-06-14,Japan,1,47,17429,"rgb(201, 219, 116)"
14251,2020-06-15,Japan,0,73,17502,"rgb(201, 219, 116)"
14252,2020-06-16,Japan,2,85,17587,"rgb(201, 219, 116)"
14253,2020-06-17,Japan,4,41,17628,"rgb(201, 219, 116)"
14254,2020-06-18,Japan,4,40,17668,"rgb(201, 219, 116)"
14255,2020-06-19,Japan,0,72,17740,"rgb(201, 219, 116)"
14256,2020-06-20,Japan,17,59,17799,"rgb(201, 219, 116)"
14257,2020-06-21,Japan,0,0,17799,"rgb(201, 219, 116)"
14258,2020-06-22,Japan,1,117,17916,"rgb(201, 219, 116)"
14259,2020-06-23,Japan,2,52,17968,"rgb(201, 219, 116)"
14260,2020-06-24,Japan,8,59,18027,"rgb(201, 219, 116)"
14261,2020-06-25,Japan,5,83,18110,"rgb(201, 219, 116)"
14262,2020-06-26,Japan,1,87,18197,"rgb(201, 219, 116)"
14263,2020-06-27,Japan,2,100,18297,"rgb(201, 219, 116)"
14264,2020-06-28,Japan,0,93,18390,"rgb(201, 219, 116)"
14265,2020-06-29,Japan,1,86,18476,"rgb(201, 219, 116)"
14266,2020-06-30,Japan,0,117,18593,"rgb(201, 219, 116)"
14267,2020-07-01,Japan,2,130,18723,"rgb(201, 219, 116)"
14268,2020-07-02,Japan,1,151,18874,"rgb(201, 219, 116)"
14269,2020-07-03,Japan,1,194,19068,"rgb(201, 219, 116)"
14270,2020-07-04,Japan,1,214,19282,"rgb(201, 219, 116)"
14271,2020-07-05,Japan,0,240,19522,"rgb(201, 219, 116)"
14272,2020-07-06,Japan,0,0,19522,"rgb(201, 219, 116)"
14273,2020-07-07,Japan,0,106,19628,"rgb(201, 219, 116)"
14274,2020-07-08,Japan,1,353,19981,"rgb(201, 219, 116)"
14275,2020-07-09,Japan,2,193,20174,"rgb(201, 219, 116)"
14276,2020-07-10,Japan,1,197,20371,"rgb(201, 219, 116)"
14277,2020-07-11,Japan,1,348,20719,"rgb(201, 219, 116)"
14278,2020-07-12,Japan,0,410,21129,"rgb(201, 219, 116)"
14279,2020-07-13,Japan,0,373,21502,"rgb(201, 219, 116)"
14280,2020-03-14,Kenya,0,1,1,"rgb(139, 224, 164)"
14281,2020-03-15,Kenya,0,0,1,"rgb(139, 224, 164)"
14282,2020-03-16,Kenya,0,2,3,"rgb(139, 224, 164)"
14283,2020-03-17,Kenya,0,0,3,"rgb(139, 224, 164)"
14284,2020-03-18,Kenya,0,1,4,"rgb(139, 224, 164)"
14285,2020-03-19,Kenya,0,3,7,"rgb(139, 224, 164)"
14286,2020-03-20,Kenya,0,0,7,"rgb(139, 224, 164)"
14287,2020-03-21,Kenya,0,0,7,"rgb(139, 224, 164)"
14288,2020-03-22,Kenya,0,0,7,"rgb(139, 224, 164)"
14289,2020-03-23,Kenya,0,8,15,"rgb(139, 224, 164)"
14290,2020-03-24,Kenya,0,1,16,"rgb(139, 224, 164)"
14291,2020-03-25,Kenya,0,9,25,"rgb(139, 224, 164)"
14292,2020-03-26,Kenya,0,0,25,"rgb(139, 224, 164)"
14293,2020-03-27,Kenya,1,6,31,"rgb(139, 224, 164)"
14294,2020-03-28,Kenya,0,0,31,"rgb(139, 224, 164)"
14295,2020-03-29,Kenya,0,7,38,"rgb(139, 224, 164)"
14296,2020-03-30,Kenya,0,4,42,"rgb(139, 224, 164)"
14297,2020-03-31,Kenya,0,8,50,"rgb(139, 224, 164)"
14298,2020-04-01,Kenya,0,9,59,"rgb(139, 224, 164)"
14299,2020-04-02,Kenya,0,22,81,"rgb(139, 224, 164)"
14300,2020-04-03,Kenya,2,29,110,"rgb(139, 224, 164)"
14301,2020-04-04,Kenya,1,12,122,"rgb(139, 224, 164)"
14302,2020-04-05,Kenya,0,4,126,"rgb(139, 224, 164)"
14303,2020-04-06,Kenya,0,16,142,"rgb(139, 224, 164)"
14304,2020-04-07,Kenya,0,16,158,"rgb(139, 224, 164)"
14305,2020-04-08,Kenya,2,14,172,"rgb(139, 224, 164)"
14306,2020-04-09,Kenya,0,7,179,"rgb(139, 224, 164)"
14307,2020-04-10,Kenya,1,5,184,"rgb(139, 224, 164)"
14308,2020-04-11,Kenya,0,5,189,"rgb(139, 224, 164)"
14309,2020-04-12,Kenya,0,2,191,"rgb(139, 224, 164)"
14310,2020-04-13,Kenya,1,6,197,"rgb(139, 224, 164)"
14311,2020-04-14,Kenya,1,11,208,"rgb(139, 224, 164)"
14312,2020-04-15,Kenya,0,8,216,"rgb(139, 224, 164)"
14313,2020-04-16,Kenya,1,9,225,"rgb(139, 224, 164)"
14314,2020-04-17,Kenya,1,9,234,"rgb(139, 224, 164)"
14315,2020-04-18,Kenya,0,12,246,"rgb(139, 224, 164)"
14316,2020-04-19,Kenya,1,16,262,"rgb(139, 224, 164)"
14317,2020-04-20,Kenya,2,8,270,"rgb(139, 224, 164)"
14318,2020-04-21,Kenya,0,11,281,"rgb(139, 224, 164)"
14319,2020-04-22,Kenya,0,0,281,"rgb(139, 224, 164)"
14320,2020-04-23,Kenya,0,22,303,"rgb(139, 224, 164)"
14321,2020-04-24,Kenya,0,17,320,"rgb(139, 224, 164)"
14322,2020-04-25,Kenya,0,16,336,"rgb(139, 224, 164)"
14323,2020-04-26,Kenya,0,7,343,"rgb(139, 224, 164)"
14324,2020-04-27,Kenya,0,12,355,"rgb(139, 224, 164)"
14325,2020-04-28,Kenya,0,8,363,"rgb(139, 224, 164)"
14326,2020-04-29,Kenya,0,11,374,"rgb(139, 224, 164)"
14327,2020-04-30,Kenya,1,10,384,"rgb(139, 224, 164)"
14328,2020-05-01,Kenya,2,12,396,"rgb(139, 224, 164)"
14329,2020-05-02,Kenya,4,15,411,"rgb(139, 224, 164)"
14330,2020-05-03,Kenya,1,24,435,"rgb(139, 224, 164)"
14331,2020-05-04,Kenya,2,30,465,"rgb(139, 224, 164)"
14332,2020-05-05,Kenya,0,25,490,"rgb(139, 224, 164)"
14333,2020-05-06,Kenya,0,45,535,"rgb(139, 224, 164)"
14334,2020-05-07,Kenya,2,47,582,"rgb(139, 224, 164)"
14335,2020-05-08,Kenya,3,25,607,"rgb(139, 224, 164)"
14336,2020-05-09,Kenya,0,14,621,"rgb(139, 224, 164)"
14337,2020-05-10,Kenya,1,28,649,"rgb(139, 224, 164)"
14338,2020-05-11,Kenya,2,23,672,"rgb(139, 224, 164)"
14339,2020-05-12,Kenya,1,28,700,"rgb(139, 224, 164)"
14340,2020-05-13,Kenya,3,15,715,"rgb(139, 224, 164)"
14341,2020-05-14,Kenya,4,22,737,"rgb(139, 224, 164)"
14342,2020-05-15,Kenya,2,21,758,"rgb(139, 224, 164)"
14343,2020-05-16,Kenya,3,23,781,"rgb(139, 224, 164)"
14344,2020-05-17,Kenya,5,49,830,"rgb(139, 224, 164)"
14345,2020-05-18,Kenya,0,57,887,"rgb(139, 224, 164)"
14346,2020-05-19,Kenya,0,25,912,"rgb(139, 224, 164)"
14347,2020-05-20,Kenya,0,51,963,"rgb(139, 224, 164)"
14348,2020-05-21,Kenya,0,66,1029,"rgb(139, 224, 164)"
14349,2020-05-22,Kenya,0,80,1109,"rgb(139, 224, 164)"
14350,2020-05-23,Kenya,0,52,1161,"rgb(139, 224, 164)"
14351,2020-05-24,Kenya,0,31,1192,"rgb(139, 224, 164)"
14352,2020-05-25,Kenya,1,22,1214,"rgb(139, 224, 164)"
14353,2020-05-26,Kenya,1,72,1286,"rgb(139, 224, 164)"
14354,2020-05-27,Kenya,0,62,1348,"rgb(139, 224, 164)"
14355,2020-05-28,Kenya,3,123,1471,"rgb(139, 224, 164)"
14356,2020-05-29,Kenya,3,147,1618,"rgb(139, 224, 164)"
14357,2020-05-30,Kenya,4,127,1745,"rgb(139, 224, 164)"
14358,2020-05-31,Kenya,1,143,1888,"rgb(139, 224, 164)"
14359,2020-06-01,Kenya,1,74,1962,"rgb(139, 224, 164)"
14360,2020-06-02,Kenya,5,59,2021,"rgb(139, 224, 164)"
14361,2020-06-03,Kenya,2,72,2093,"rgb(139, 224, 164)"
14362,2020-06-04,Kenya,3,123,2216,"rgb(139, 224, 164)"
14363,2020-06-05,Kenya,4,124,2340,"rgb(139, 224, 164)"
14364,2020-06-06,Kenya,1,134,2474,"rgb(139, 224, 164)"
14365,2020-06-07,Kenya,4,126,2600,"rgb(139, 224, 164)"
14366,2020-06-08,Kenya,1,167,2767,"rgb(139, 224, 164)"
14367,2020-06-09,Kenya,1,95,2862,"rgb(139, 224, 164)"
14368,2020-06-10,Kenya,3,127,2989,"rgb(139, 224, 164)"
14369,2020-06-11,Kenya,1,105,3094,"rgb(139, 224, 164)"
14370,2020-06-12,Kenya,3,121,3215,"rgb(139, 224, 164)"
14371,2020-06-13,Kenya,4,90,3305,"rgb(139, 224, 164)"
14372,2020-06-14,Kenya,4,152,3457,"rgb(139, 224, 164)"
14373,2020-06-15,Kenya,3,137,3594,"rgb(139, 224, 164)"
14374,2020-06-16,Kenya,1,133,3727,"rgb(139, 224, 164)"
14375,2020-06-17,Kenya,1,133,3860,"rgb(139, 224, 164)"
14376,2020-06-18,Kenya,2,184,4044,"rgb(139, 224, 164)"
14377,2020-06-19,Kenya,10,213,4257,"rgb(139, 224, 164)"
14378,2020-06-20,Kenya,2,117,4374,"rgb(139, 224, 164)"
14379,2020-06-21,Kenya,2,104,4478,"rgb(139, 224, 164)"
14380,2020-06-22,Kenya,2,260,4738,"rgb(139, 224, 164)"
14381,2020-06-23,Kenya,2,59,4797,"rgb(139, 224, 164)"
14382,2020-06-24,Kenya,3,155,4952,"rgb(139, 224, 164)"
14383,2020-06-25,Kenya,2,254,5206,"rgb(139, 224, 164)"
14384,2020-06-26,Kenya,2,178,5384,"rgb(139, 224, 164)"
14385,2020-06-27,Kenya,5,149,5533,"rgb(139, 224, 164)"
14386,2020-06-28,Kenya,4,278,5811,"rgb(139, 224, 164)"
14387,2020-06-29,Kenya,2,259,6070,"rgb(139, 224, 164)"
14388,2020-06-30,Kenya,1,120,6190,"rgb(139, 224, 164)"
14389,2020-07-01,Kenya,4,176,6366,"rgb(139, 224, 164)"
14390,2020-07-02,Kenya,1,307,6673,"rgb(139, 224, 164)"
14391,2020-07-03,Kenya,3,268,6941,"rgb(139, 224, 164)"
14392,2020-07-04,Kenya,2,247,7188,"rgb(139, 224, 164)"
14393,2020-07-05,Kenya,5,389,7577,"rgb(139, 224, 164)"
14394,2020-07-06,Kenya,1,309,7886,"rgb(139, 224, 164)"
14395,2020-07-07,Kenya,4,181,8067,"rgb(139, 224, 164)"
14396,2020-07-08,Kenya,3,183,8250,"rgb(139, 224, 164)"
14397,2020-07-09,Kenya,2,278,8528,"rgb(139, 224, 164)"
14398,2020-07-10,Kenya,4,447,8975,"rgb(139, 224, 164)"
14399,2020-07-11,Kenya,8,473,9448,"rgb(139, 224, 164)"
14400,2020-07-12,Kenya,3,278,9726,"rgb(139, 224, 164)"
14401,2020-07-13,Kenya,1,379,10105,"rgb(139, 224, 164)"
14402,2020-03-19,Kyrgyzstan,0,3,3,"rgb(180, 151, 231)"
14403,2020-03-20,Kyrgyzstan,0,3,6,"rgb(180, 151, 231)"
14404,2020-03-21,Kyrgyzstan,0,0,6,"rgb(180, 151, 231)"
14405,2020-03-22,Kyrgyzstan,0,8,14,"rgb(180, 151, 231)"
14406,2020-03-23,Kyrgyzstan,0,0,14,"rgb(180, 151, 231)"
14407,2020-03-24,Kyrgyzstan,0,2,16,"rgb(180, 151, 231)"
14408,2020-03-25,Kyrgyzstan,0,26,42,"rgb(180, 151, 231)"
14409,2020-03-26,Kyrgyzstan,0,2,44,"rgb(180, 151, 231)"
14410,2020-03-27,Kyrgyzstan,0,0,44,"rgb(180, 151, 231)"
14411,2020-03-28,Kyrgyzstan,0,14,58,"rgb(180, 151, 231)"
14412,2020-03-29,Kyrgyzstan,0,26,84,"rgb(180, 151, 231)"
14413,2020-03-30,Kyrgyzstan,0,0,84,"rgb(180, 151, 231)"
14414,2020-03-31,Kyrgyzstan,0,0,84,"rgb(180, 151, 231)"
14415,2020-04-01,Kyrgyzstan,0,23,107,"rgb(180, 151, 231)"
14416,2020-04-02,Kyrgyzstan,1,5,112,"rgb(180, 151, 231)"
14417,2020-04-03,Kyrgyzstan,0,13,125,"rgb(180, 151, 231)"
14418,2020-04-04,Kyrgyzstan,0,19,144,"rgb(180, 151, 231)"
14419,2020-04-05,Kyrgyzstan,0,0,144,"rgb(180, 151, 231)"
14420,2020-04-06,Kyrgyzstan,3,72,216,"rgb(180, 151, 231)"
14421,2020-04-07,Kyrgyzstan,0,12,228,"rgb(180, 151, 231)"
14422,2020-04-08,Kyrgyzstan,0,42,270,"rgb(180, 151, 231)"
14423,2020-04-09,Kyrgyzstan,0,10,280,"rgb(180, 151, 231)"
14424,2020-04-10,Kyrgyzstan,1,18,298,"rgb(180, 151, 231)"
14425,2020-04-11,Kyrgyzstan,0,41,339,"rgb(180, 151, 231)"
14426,2020-04-12,Kyrgyzstan,0,38,377,"rgb(180, 151, 231)"
14427,2020-04-13,Kyrgyzstan,0,42,419,"rgb(180, 151, 231)"
14428,2020-04-14,Kyrgyzstan,0,11,430,"rgb(180, 151, 231)"
14429,2020-04-15,Kyrgyzstan,0,19,449,"rgb(180, 151, 231)"
14430,2020-04-16,Kyrgyzstan,0,17,466,"rgb(180, 151, 231)"
14431,2020-04-17,Kyrgyzstan,0,23,489,"rgb(180, 151, 231)"
14432,2020-04-18,Kyrgyzstan,0,17,506,"rgb(180, 151, 231)"
14433,2020-04-19,Kyrgyzstan,0,48,554,"rgb(180, 151, 231)"
14434,2020-04-20,Kyrgyzstan,2,14,568,"rgb(180, 151, 231)"
14435,2020-04-21,Kyrgyzstan,0,22,590,"rgb(180, 151, 231)"
14436,2020-04-22,Kyrgyzstan,0,22,612,"rgb(180, 151, 231)"
14437,2020-04-23,Kyrgyzstan,1,19,631,"rgb(180, 151, 231)"
14438,2020-04-24,Kyrgyzstan,0,25,656,"rgb(180, 151, 231)"
14439,2020-04-25,Kyrgyzstan,0,9,665,"rgb(180, 151, 231)"
14440,2020-04-26,Kyrgyzstan,0,17,682,"rgb(180, 151, 231)"
14441,2020-04-27,Kyrgyzstan,0,13,695,"rgb(180, 151, 231)"
14442,2020-04-28,Kyrgyzstan,0,13,708,"rgb(180, 151, 231)"
14443,2020-04-29,Kyrgyzstan,0,21,729,"rgb(180, 151, 231)"
14444,2020-04-30,Kyrgyzstan,0,17,746,"rgb(180, 151, 231)"
14445,2020-05-01,Kyrgyzstan,0,0,746,"rgb(180, 151, 231)"
14446,2020-05-02,Kyrgyzstan,0,23,769,"rgb(180, 151, 231)"
14447,2020-05-03,Kyrgyzstan,2,26,795,"rgb(180, 151, 231)"
14448,2020-05-04,Kyrgyzstan,0,35,830,"rgb(180, 151, 231)"
14449,2020-05-05,Kyrgyzstan,1,13,843,"rgb(180, 151, 231)"
14450,2020-05-06,Kyrgyzstan,1,28,871,"rgb(180, 151, 231)"
14451,2020-05-07,Kyrgyzstan,0,24,895,"rgb(180, 151, 231)"
14452,2020-05-08,Kyrgyzstan,0,11,906,"rgb(180, 151, 231)"
14453,2020-05-09,Kyrgyzstan,0,25,931,"rgb(180, 151, 231)"
14454,2020-05-10,Kyrgyzstan,0,71,1002,"rgb(180, 151, 231)"
14455,2020-05-11,Kyrgyzstan,0,14,1016,"rgb(180, 151, 231)"
14456,2020-05-12,Kyrgyzstan,0,21,1037,"rgb(180, 151, 231)"
14457,2020-05-13,Kyrgyzstan,0,7,1044,"rgb(180, 151, 231)"
14458,2020-05-14,Kyrgyzstan,0,38,1082,"rgb(180, 151, 231)"
14459,2020-05-15,Kyrgyzstan,2,29,1111,"rgb(180, 151, 231)"
14460,2020-05-16,Kyrgyzstan,0,6,1117,"rgb(180, 151, 231)"
14461,2020-05-17,Kyrgyzstan,0,21,1138,"rgb(180, 151, 231)"
14462,2020-05-18,Kyrgyzstan,0,78,1216,"rgb(180, 151, 231)"
14463,2020-05-19,Kyrgyzstan,0,27,1243,"rgb(180, 151, 231)"
14464,2020-05-20,Kyrgyzstan,0,27,1270,"rgb(180, 151, 231)"
14465,2020-05-21,Kyrgyzstan,0,43,1313,"rgb(180, 151, 231)"
14466,2020-05-22,Kyrgyzstan,0,37,1350,"rgb(180, 151, 231)"
14467,2020-05-23,Kyrgyzstan,0,14,1364,"rgb(180, 151, 231)"
14468,2020-05-24,Kyrgyzstan,0,39,1403,"rgb(180, 151, 231)"
14469,2020-05-25,Kyrgyzstan,2,30,1433,"rgb(180, 151, 231)"
14470,2020-05-26,Kyrgyzstan,0,35,1468,"rgb(180, 151, 231)"
14471,2020-05-27,Kyrgyzstan,0,52,1520,"rgb(180, 151, 231)"
14472,2020-05-28,Kyrgyzstan,0,74,1594,"rgb(180, 151, 231)"
14473,2020-05-29,Kyrgyzstan,0,68,1662,"rgb(180, 151, 231)"
14474,2020-05-30,Kyrgyzstan,0,60,1722,"rgb(180, 151, 231)"
14475,2020-05-31,Kyrgyzstan,0,26,1748,"rgb(180, 151, 231)"
14476,2020-06-01,Kyrgyzstan,0,69,1817,"rgb(180, 151, 231)"
14477,2020-06-02,Kyrgyzstan,1,28,1845,"rgb(180, 151, 231)"
14478,2020-06-03,Kyrgyzstan,3,26,1871,"rgb(180, 151, 231)"
14479,2020-06-04,Kyrgyzstan,0,28,1899,"rgb(180, 151, 231)"
14480,2020-06-05,Kyrgyzstan,2,37,1936,"rgb(180, 151, 231)"
14481,2020-06-06,Kyrgyzstan,0,38,1974,"rgb(180, 151, 231)"
14482,2020-06-07,Kyrgyzstan,0,33,2007,"rgb(180, 151, 231)"
14483,2020-06-08,Kyrgyzstan,1,25,2032,"rgb(180, 151, 231)"
14484,2020-06-09,Kyrgyzstan,1,23,2055,"rgb(180, 151, 231)"
14485,2020-06-10,Kyrgyzstan,2,38,2093,"rgb(180, 151, 231)"
14486,2020-06-11,Kyrgyzstan,0,36,2129,"rgb(180, 151, 231)"
14487,2020-06-12,Kyrgyzstan,0,37,2166,"rgb(180, 151, 231)"
14488,2020-06-13,Kyrgyzstan,1,41,2207,"rgb(180, 151, 231)"
14489,2020-06-14,Kyrgyzstan,0,78,2285,"rgb(180, 151, 231)"
14490,2020-06-15,Kyrgyzstan,0,87,2372,"rgb(180, 151, 231)"
14491,2020-06-16,Kyrgyzstan,1,100,2472,"rgb(180, 151, 231)"
14492,2020-06-17,Kyrgyzstan,2,90,2562,"rgb(180, 151, 231)"
14493,2020-06-18,Kyrgyzstan,1,95,2657,"rgb(180, 151, 231)"
14494,2020-06-19,Kyrgyzstan,1,132,2789,"rgb(180, 151, 231)"
14495,2020-06-20,Kyrgyzstan,3,192,2981,"rgb(180, 151, 231)"
14496,2020-06-21,Kyrgyzstan,2,170,3151,"rgb(180, 151, 231)"
14497,2020-06-22,Kyrgyzstan,3,205,3356,"rgb(180, 151, 231)"
14498,2020-06-23,Kyrgyzstan,1,163,3519,"rgb(180, 151, 231)"
14499,2020-06-24,Kyrgyzstan,1,207,3726,"rgb(180, 151, 231)"
14500,2020-06-25,Kyrgyzstan,1,228,3954,"rgb(180, 151, 231)"
14501,2020-06-26,Kyrgyzstan,0,250,4204,"rgb(180, 151, 231)"
14502,2020-06-27,Kyrgyzstan,3,309,4513,"rgb(180, 151, 231)"
14503,2020-06-28,Kyrgyzstan,1,235,4748,"rgb(180, 151, 231)"
14504,2020-06-29,Kyrgyzstan,3,269,5017,"rgb(180, 151, 231)"
14505,2020-06-30,Kyrgyzstan,7,279,5296,"rgb(180, 151, 231)"
14506,2020-07-01,Kyrgyzstan,5,439,5735,"rgb(180, 151, 231)"
14507,2020-07-02,Kyrgyzstan,0,0,5735,"rgb(180, 151, 231)"
14508,2020-07-03,Kyrgyzstan,14,1032,6767,"rgb(180, 151, 231)"
14509,2020-07-04,Kyrgyzstan,2,327,7094,"rgb(180, 151, 231)"
14510,2020-07-05,Kyrgyzstan,10,283,7377,"rgb(180, 151, 231)"
14511,2020-07-06,Kyrgyzstan,4,314,7691,"rgb(180, 151, 231)"
14512,2020-07-07,Kyrgyzstan,7,450,8141,"rgb(180, 151, 231)"
14513,2020-07-08,Kyrgyzstan,13,345,8486,"rgb(180, 151, 231)"
14514,2020-07-09,Kyrgyzstan,4,361,8847,"rgb(180, 151, 231)"
14515,2020-07-10,Kyrgyzstan,6,511,9358,"rgb(180, 151, 231)"
14516,2020-07-11,Kyrgyzstan,3,552,9910,"rgb(180, 151, 231)"
14517,2020-07-12,Kyrgyzstan,7,719,10629,"rgb(180, 151, 231)"
14518,2020-07-13,Kyrgyzstan,15,488,11117,"rgb(180, 151, 231)"
14519,2019-12-31,Cambodia,0,0,0,"rgb(179, 179, 179)"
14520,2020-01-01,Cambodia,0,0,0,"rgb(179, 179, 179)"
14521,2020-01-02,Cambodia,0,0,0,"rgb(179, 179, 179)"
14522,2020-01-03,Cambodia,0,0,0,"rgb(179, 179, 179)"
14523,2020-01-04,Cambodia,0,0,0,"rgb(179, 179, 179)"
14524,2020-01-05,Cambodia,0,0,0,"rgb(179, 179, 179)"
14525,2020-01-06,Cambodia,0,0,0,"rgb(179, 179, 179)"
14526,2020-01-07,Cambodia,0,0,0,"rgb(179, 179, 179)"
14527,2020-01-08,Cambodia,0,0,0,"rgb(179, 179, 179)"
14528,2020-01-09,Cambodia,0,0,0,"rgb(179, 179, 179)"
14529,2020-01-10,Cambodia,0,0,0,"rgb(179, 179, 179)"
14530,2020-01-11,Cambodia,0,0,0,"rgb(179, 179, 179)"
14531,2020-01-12,Cambodia,0,0,0,"rgb(179, 179, 179)"
14532,2020-01-13,Cambodia,0,0,0,"rgb(179, 179, 179)"
14533,2020-01-14,Cambodia,0,0,0,"rgb(179, 179, 179)"
14534,2020-01-15,Cambodia,0,0,0,"rgb(179, 179, 179)"
14535,2020-01-16,Cambodia,0,0,0,"rgb(179, 179, 179)"
14536,2020-01-17,Cambodia,0,0,0,"rgb(179, 179, 179)"
14537,2020-01-18,Cambodia,0,0,0,"rgb(179, 179, 179)"
14538,2020-01-19,Cambodia,0,0,0,"rgb(179, 179, 179)"
14539,2020-01-20,Cambodia,0,0,0,"rgb(179, 179, 179)"
14540,2020-01-21,Cambodia,0,0,0,"rgb(179, 179, 179)"
14541,2020-01-22,Cambodia,0,0,0,"rgb(179, 179, 179)"
14542,2020-01-23,Cambodia,0,0,0,"rgb(179, 179, 179)"
14543,2020-01-24,Cambodia,0,0,0,"rgb(179, 179, 179)"
14544,2020-01-25,Cambodia,0,0,0,"rgb(179, 179, 179)"
14545,2020-01-26,Cambodia,0,0,0,"rgb(179, 179, 179)"
14546,2020-01-27,Cambodia,0,0,0,"rgb(179, 179, 179)"
14547,2020-01-28,Cambodia,0,1,1,"rgb(179, 179, 179)"
14548,2020-01-29,Cambodia,0,0,1,"rgb(179, 179, 179)"
14549,2020-01-30,Cambodia,0,0,1,"rgb(179, 179, 179)"
14550,2020-01-31,Cambodia,0,0,1,"rgb(179, 179, 179)"
14551,2020-02-01,Cambodia,0,0,1,"rgb(179, 179, 179)"
14552,2020-02-02,Cambodia,0,0,1,"rgb(179, 179, 179)"
14553,2020-02-03,Cambodia,0,0,1,"rgb(179, 179, 179)"
14554,2020-02-04,Cambodia,0,0,1,"rgb(179, 179, 179)"
14555,2020-02-05,Cambodia,0,0,1,"rgb(179, 179, 179)"
14556,2020-02-06,Cambodia,0,0,1,"rgb(179, 179, 179)"
14557,2020-02-07,Cambodia,0,0,1,"rgb(179, 179, 179)"
14558,2020-02-08,Cambodia,0,0,1,"rgb(179, 179, 179)"
14559,2020-02-09,Cambodia,0,0,1,"rgb(179, 179, 179)"
14560,2020-02-10,Cambodia,0,0,1,"rgb(179, 179, 179)"
14561,2020-02-11,Cambodia,0,0,1,"rgb(179, 179, 179)"
14562,2020-02-12,Cambodia,0,0,1,"rgb(179, 179, 179)"
14563,2020-02-13,Cambodia,0,0,1,"rgb(179, 179, 179)"
14564,2020-02-14,Cambodia,0,0,1,"rgb(179, 179, 179)"
14565,2020-02-15,Cambodia,0,0,1,"rgb(179, 179, 179)"
14566,2020-02-16,Cambodia,0,0,1,"rgb(179, 179, 179)"
14567,2020-02-17,Cambodia,0,0,1,"rgb(179, 179, 179)"
14568,2020-02-18,Cambodia,0,0,1,"rgb(179, 179, 179)"
14569,2020-02-19,Cambodia,0,0,1,"rgb(179, 179, 179)"
14570,2020-02-20,Cambodia,0,0,1,"rgb(179, 179, 179)"
14571,2020-02-21,Cambodia,0,0,1,"rgb(179, 179, 179)"
14572,2020-02-22,Cambodia,0,0,1,"rgb(179, 179, 179)"
14573,2020-02-23,Cambodia,0,0,1,"rgb(179, 179, 179)"
14574,2020-02-24,Cambodia,0,0,1,"rgb(179, 179, 179)"
14575,2020-02-25,Cambodia,0,0,1,"rgb(179, 179, 179)"
14576,2020-02-26,Cambodia,0,0,1,"rgb(179, 179, 179)"
14577,2020-02-27,Cambodia,0,0,1,"rgb(179, 179, 179)"
14578,2020-02-28,Cambodia,0,0,1,"rgb(179, 179, 179)"
14579,2020-02-29,Cambodia,0,0,1,"rgb(179, 179, 179)"
14580,2020-03-01,Cambodia,0,0,1,"rgb(179, 179, 179)"
14581,2020-03-02,Cambodia,0,0,1,"rgb(179, 179, 179)"
14582,2020-03-08,Cambodia,0,1,2,"rgb(179, 179, 179)"
14583,2020-03-12,Cambodia,0,1,3,"rgb(179, 179, 179)"
14584,2020-03-13,Cambodia,0,2,5,"rgb(179, 179, 179)"
14585,2020-03-15,Cambodia,0,2,7,"rgb(179, 179, 179)"
14586,2020-03-16,Cambodia,0,5,12,"rgb(179, 179, 179)"
14587,2020-03-17,Cambodia,0,12,24,"rgb(179, 179, 179)"
14588,2020-03-18,Cambodia,0,0,24,"rgb(179, 179, 179)"
14589,2020-03-19,Cambodia,0,0,24,"rgb(179, 179, 179)"
14590,2020-03-20,Cambodia,0,0,24,"rgb(179, 179, 179)"
14591,2020-03-21,Cambodia,0,23,47,"rgb(179, 179, 179)"
14592,2020-03-22,Cambodia,0,4,51,"rgb(179, 179, 179)"
14593,2020-03-23,Cambodia,0,35,86,"rgb(179, 179, 179)"
14594,2020-03-24,Cambodia,0,1,87,"rgb(179, 179, 179)"
14595,2020-03-25,Cambodia,0,4,91,"rgb(179, 179, 179)"
14596,2020-03-26,Cambodia,0,5,96,"rgb(179, 179, 179)"
14597,2020-03-27,Cambodia,0,2,98,"rgb(179, 179, 179)"
14598,2020-03-28,Cambodia,0,4,102,"rgb(179, 179, 179)"
14599,2020-03-29,Cambodia,0,1,103,"rgb(179, 179, 179)"
14600,2020-03-30,Cambodia,0,4,107,"rgb(179, 179, 179)"
14601,2020-03-31,Cambodia,0,2,109,"rgb(179, 179, 179)"
14602,2020-04-01,Cambodia,0,0,109,"rgb(179, 179, 179)"
14603,2020-04-02,Cambodia,0,1,110,"rgb(179, 179, 179)"
14604,2020-04-03,Cambodia,0,4,114,"rgb(179, 179, 179)"
14605,2020-04-04,Cambodia,0,0,114,"rgb(179, 179, 179)"
14606,2020-04-05,Cambodia,0,0,114,"rgb(179, 179, 179)"
14607,2020-04-06,Cambodia,0,0,114,"rgb(179, 179, 179)"
14608,2020-04-07,Cambodia,0,1,115,"rgb(179, 179, 179)"
14609,2020-04-08,Cambodia,0,2,117,"rgb(179, 179, 179)"
14610,2020-04-09,Cambodia,0,1,118,"rgb(179, 179, 179)"
14611,2020-04-10,Cambodia,0,1,119,"rgb(179, 179, 179)"
14612,2020-04-11,Cambodia,0,1,120,"rgb(179, 179, 179)"
14613,2020-04-12,Cambodia,0,2,122,"rgb(179, 179, 179)"
14614,2020-04-13,Cambodia,0,0,122,"rgb(179, 179, 179)"
14615,2020-04-14,Cambodia,0,0,122,"rgb(179, 179, 179)"
14616,2020-04-15,Cambodia,0,0,122,"rgb(179, 179, 179)"
14617,2020-04-16,Cambodia,0,0,122,"rgb(179, 179, 179)"
14618,2020-04-17,Cambodia,0,0,122,"rgb(179, 179, 179)"
14619,2020-04-18,Cambodia,0,0,122,"rgb(179, 179, 179)"
14620,2020-04-19,Cambodia,0,0,122,"rgb(179, 179, 179)"
14621,2020-04-20,Cambodia,0,0,122,"rgb(179, 179, 179)"
14622,2020-04-21,Cambodia,0,0,122,"rgb(179, 179, 179)"
14623,2020-04-22,Cambodia,0,0,122,"rgb(179, 179, 179)"
14624,2020-04-23,Cambodia,0,0,122,"rgb(179, 179, 179)"
14625,2020-04-24,Cambodia,0,0,122,"rgb(179, 179, 179)"
14626,2020-04-25,Cambodia,0,0,122,"rgb(179, 179, 179)"
14627,2020-04-26,Cambodia,0,0,122,"rgb(179, 179, 179)"
14628,2020-04-27,Cambodia,0,0,122,"rgb(179, 179, 179)"
14629,2020-04-28,Cambodia,0,0,122,"rgb(179, 179, 179)"
14630,2020-04-29,Cambodia,0,0,122,"rgb(179, 179, 179)"
14631,2020-04-30,Cambodia,0,0,122,"rgb(179, 179, 179)"
14632,2020-05-01,Cambodia,0,0,122,"rgb(179, 179, 179)"
14633,2020-05-02,Cambodia,0,0,122,"rgb(179, 179, 179)"
14634,2020-05-03,Cambodia,0,0,122,"rgb(179, 179, 179)"
14635,2020-05-04,Cambodia,0,0,122,"rgb(179, 179, 179)"
14636,2020-05-05,Cambodia,0,0,122,"rgb(179, 179, 179)"
14637,2020-05-06,Cambodia,0,0,122,"rgb(179, 179, 179)"
14638,2020-05-07,Cambodia,0,0,122,"rgb(179, 179, 179)"
14639,2020-05-08,Cambodia,0,0,122,"rgb(179, 179, 179)"
14640,2020-05-09,Cambodia,0,0,122,"rgb(179, 179, 179)"
14641,2020-05-10,Cambodia,0,0,122,"rgb(179, 179, 179)"
14642,2020-05-11,Cambodia,0,0,122,"rgb(179, 179, 179)"
14643,2020-05-12,Cambodia,0,0,122,"rgb(179, 179, 179)"
14644,2020-05-13,Cambodia,0,0,122,"rgb(179, 179, 179)"
14645,2020-05-14,Cambodia,0,0,122,"rgb(179, 179, 179)"
14646,2020-05-15,Cambodia,0,0,122,"rgb(179, 179, 179)"
14647,2020-05-16,Cambodia,0,0,122,"rgb(179, 179, 179)"
14648,2020-05-17,Cambodia,0,0,122,"rgb(179, 179, 179)"
14649,2020-05-18,Cambodia,0,0,122,"rgb(179, 179, 179)"
14650,2020-05-19,Cambodia,0,0,122,"rgb(179, 179, 179)"
14651,2020-05-20,Cambodia,0,0,122,"rgb(179, 179, 179)"
14652,2020-05-21,Cambodia,0,0,122,"rgb(179, 179, 179)"
14653,2020-05-22,Cambodia,0,1,123,"rgb(179, 179, 179)"
14654,2020-05-23,Cambodia,0,1,124,"rgb(179, 179, 179)"
14655,2020-05-24,Cambodia,0,0,124,"rgb(179, 179, 179)"
14656,2020-05-25,Cambodia,0,0,124,"rgb(179, 179, 179)"
14657,2020-05-26,Cambodia,0,0,124,"rgb(179, 179, 179)"
14658,2020-05-27,Cambodia,0,0,124,"rgb(179, 179, 179)"
14659,2020-05-28,Cambodia,0,0,124,"rgb(179, 179, 179)"
14660,2020-05-29,Cambodia,0,0,124,"rgb(179, 179, 179)"
14661,2020-05-30,Cambodia,0,1,125,"rgb(179, 179, 179)"
14662,2020-05-31,Cambodia,0,0,125,"rgb(179, 179, 179)"
14663,2020-06-01,Cambodia,0,0,125,"rgb(179, 179, 179)"
14664,2020-06-02,Cambodia,0,0,125,"rgb(179, 179, 179)"
14665,2020-06-03,Cambodia,0,0,125,"rgb(179, 179, 179)"
14666,2020-06-04,Cambodia,0,0,125,"rgb(179, 179, 179)"
14667,2020-06-05,Cambodia,0,0,125,"rgb(179, 179, 179)"
14668,2020-06-06,Cambodia,0,0,125,"rgb(179, 179, 179)"
14669,2020-06-07,Cambodia,0,0,125,"rgb(179, 179, 179)"
14670,2020-06-08,Cambodia,0,1,126,"rgb(179, 179, 179)"
14671,2020-06-09,Cambodia,0,0,126,"rgb(179, 179, 179)"
14672,2020-06-10,Cambodia,0,0,126,"rgb(179, 179, 179)"
14673,2020-06-11,Cambodia,0,0,126,"rgb(179, 179, 179)"
14674,2020-06-12,Cambodia,0,0,126,"rgb(179, 179, 179)"
14675,2020-06-13,Cambodia,0,0,126,"rgb(179, 179, 179)"
14676,2020-06-14,Cambodia,0,2,128,"rgb(179, 179, 179)"
14677,2020-06-15,Cambodia,0,0,128,"rgb(179, 179, 179)"
14678,2020-06-16,Cambodia,0,0,128,"rgb(179, 179, 179)"
14679,2020-06-17,Cambodia,0,0,128,"rgb(179, 179, 179)"
14680,2020-06-18,Cambodia,0,1,129,"rgb(179, 179, 179)"
14681,2020-06-19,Cambodia,0,0,129,"rgb(179, 179, 179)"
14682,2020-06-20,Cambodia,0,0,129,"rgb(179, 179, 179)"
14683,2020-06-21,Cambodia,0,0,129,"rgb(179, 179, 179)"
14684,2020-06-22,Cambodia,0,0,129,"rgb(179, 179, 179)"
14685,2020-06-23,Cambodia,0,1,130,"rgb(179, 179, 179)"
14686,2020-06-24,Cambodia,0,0,130,"rgb(179, 179, 179)"
14687,2020-06-25,Cambodia,0,0,130,"rgb(179, 179, 179)"
14688,2020-06-26,Cambodia,0,0,130,"rgb(179, 179, 179)"
14689,2020-06-27,Cambodia,0,9,139,"rgb(179, 179, 179)"
14690,2020-06-28,Cambodia,0,2,141,"rgb(179, 179, 179)"
14691,2020-06-29,Cambodia,0,0,141,"rgb(179, 179, 179)"
14692,2020-06-30,Cambodia,0,0,141,"rgb(179, 179, 179)"
14693,2020-07-01,Cambodia,0,0,141,"rgb(179, 179, 179)"
14694,2020-07-02,Cambodia,0,0,141,"rgb(179, 179, 179)"
14695,2020-07-03,Cambodia,0,0,141,"rgb(179, 179, 179)"
14696,2020-07-04,Cambodia,0,0,141,"rgb(179, 179, 179)"
14697,2020-07-05,Cambodia,0,0,141,"rgb(179, 179, 179)"
14698,2020-07-06,Cambodia,0,0,141,"rgb(179, 179, 179)"
14699,2020-07-07,Cambodia,0,0,141,"rgb(179, 179, 179)"
14700,2020-07-08,Cambodia,0,0,141,"rgb(179, 179, 179)"
14701,2020-07-09,Cambodia,0,0,141,"rgb(179, 179, 179)"
14702,2020-07-10,Cambodia,0,0,141,"rgb(179, 179, 179)"
14703,2020-07-11,Cambodia,0,0,141,"rgb(179, 179, 179)"
14704,2020-07-12,Cambodia,0,15,156,"rgb(179, 179, 179)"
14705,2020-07-13,Cambodia,0,0,156,"rgb(179, 179, 179)"
14706,2020-05-02,Comoros,0,1,1,"rgb(229, 134, 6)"
14707,2020-05-03,Comoros,0,0,1,"rgb(229, 134, 6)"
14708,2020-05-04,Comoros,0,2,3,"rgb(229, 134, 6)"
14709,2020-05-05,Comoros,1,1,4,"rgb(229, 134, 6)"
14710,2020-05-06,Comoros,0,0,4,"rgb(229, 134, 6)"
14711,2020-05-07,Comoros,0,4,8,"rgb(229, 134, 6)"
14712,2020-05-08,Comoros,0,0,8,"rgb(229, 134, 6)"
14713,2020-05-09,Comoros,0,0,8,"rgb(229, 134, 6)"
14714,2020-05-10,Comoros,0,3,11,"rgb(229, 134, 6)"
14715,2020-05-11,Comoros,0,0,11,"rgb(229, 134, 6)"
14716,2020-05-12,Comoros,0,0,11,"rgb(229, 134, 6)"
14717,2020-05-13,Comoros,0,0,11,"rgb(229, 134, 6)"
14718,2020-05-14,Comoros,0,0,11,"rgb(229, 134, 6)"
14719,2020-05-15,Comoros,0,0,11,"rgb(229, 134, 6)"
14720,2020-05-16,Comoros,0,0,11,"rgb(229, 134, 6)"
14721,2020-05-17,Comoros,0,0,11,"rgb(229, 134, 6)"
14722,2020-05-18,Comoros,0,0,11,"rgb(229, 134, 6)"
14723,2020-05-19,Comoros,0,0,11,"rgb(229, 134, 6)"
14724,2020-05-20,Comoros,0,23,34,"rgb(229, 134, 6)"
14725,2020-05-21,Comoros,0,0,34,"rgb(229, 134, 6)"
14726,2020-05-22,Comoros,0,0,34,"rgb(229, 134, 6)"
14727,2020-05-23,Comoros,0,44,78,"rgb(229, 134, 6)"
14728,2020-05-24,Comoros,0,0,78,"rgb(229, 134, 6)"
14729,2020-05-25,Comoros,0,9,87,"rgb(229, 134, 6)"
14730,2020-05-26,Comoros,0,0,87,"rgb(229, 134, 6)"
14731,2020-05-27,Comoros,0,0,87,"rgb(229, 134, 6)"
14732,2020-05-28,Comoros,1,0,87,"rgb(229, 134, 6)"
14733,2020-05-29,Comoros,0,0,87,"rgb(229, 134, 6)"
14734,2020-05-30,Comoros,0,0,87,"rgb(229, 134, 6)"
14735,2020-05-31,Comoros,0,19,106,"rgb(229, 134, 6)"
14736,2020-06-01,Comoros,0,0,106,"rgb(229, 134, 6)"
14737,2020-06-02,Comoros,0,0,106,"rgb(229, 134, 6)"
14738,2020-06-03,Comoros,0,26,132,"rgb(229, 134, 6)"
14739,2020-06-04,Comoros,0,0,132,"rgb(229, 134, 6)"
14740,2020-06-05,Comoros,0,0,132,"rgb(229, 134, 6)"
14741,2020-06-06,Comoros,0,0,132,"rgb(229, 134, 6)"
14742,2020-06-07,Comoros,0,9,141,"rgb(229, 134, 6)"
14743,2020-06-08,Comoros,0,0,141,"rgb(229, 134, 6)"
14744,2020-06-09,Comoros,0,0,141,"rgb(229, 134, 6)"
14745,2020-06-10,Comoros,0,21,162,"rgb(229, 134, 6)"
14746,2020-06-11,Comoros,0,0,162,"rgb(229, 134, 6)"
14747,2020-06-12,Comoros,0,0,162,"rgb(229, 134, 6)"
14748,2020-06-13,Comoros,0,0,162,"rgb(229, 134, 6)"
14749,2020-06-14,Comoros,0,14,176,"rgb(229, 134, 6)"
14750,2020-06-15,Comoros,0,0,176,"rgb(229, 134, 6)"
14751,2020-06-16,Comoros,0,0,176,"rgb(229, 134, 6)"
14752,2020-06-17,Comoros,1,21,197,"rgb(229, 134, 6)"
14753,2020-06-18,Comoros,0,0,197,"rgb(229, 134, 6)"
14754,2020-06-19,Comoros,2,13,210,"rgb(229, 134, 6)"
14755,2020-06-20,Comoros,0,0,210,"rgb(229, 134, 6)"
14756,2020-06-21,Comoros,0,37,247,"rgb(229, 134, 6)"
14757,2020-06-22,Comoros,0,0,247,"rgb(229, 134, 6)"
14758,2020-06-23,Comoros,0,0,247,"rgb(229, 134, 6)"
14759,2020-06-24,Comoros,2,0,247,"rgb(229, 134, 6)"
14760,2020-06-25,Comoros,0,0,247,"rgb(229, 134, 6)"
14761,2020-06-26,Comoros,0,0,247,"rgb(229, 134, 6)"
14762,2020-06-27,Comoros,0,0,247,"rgb(229, 134, 6)"
14763,2020-06-28,Comoros,0,0,247,"rgb(229, 134, 6)"
14764,2020-06-29,Comoros,0,25,272,"rgb(229, 134, 6)"
14765,2020-06-30,Comoros,0,0,272,"rgb(229, 134, 6)"
14766,2020-07-01,Comoros,0,31,303,"rgb(229, 134, 6)"
14767,2020-07-02,Comoros,0,0,303,"rgb(229, 134, 6)"
14768,2020-07-03,Comoros,0,0,303,"rgb(229, 134, 6)"
14769,2020-07-04,Comoros,0,6,309,"rgb(229, 134, 6)"
14770,2020-07-05,Comoros,0,0,309,"rgb(229, 134, 6)"
14771,2020-07-06,Comoros,0,2,311,"rgb(229, 134, 6)"
14772,2020-07-07,Comoros,0,0,311,"rgb(229, 134, 6)"
14773,2020-07-08,Comoros,0,2,313,"rgb(229, 134, 6)"
14774,2020-07-09,Comoros,0,0,313,"rgb(229, 134, 6)"
14775,2020-07-10,Comoros,0,0,313,"rgb(229, 134, 6)"
14776,2020-07-11,Comoros,0,0,313,"rgb(229, 134, 6)"
14777,2020-07-12,Comoros,0,4,317,"rgb(229, 134, 6)"
14778,2020-07-13,Comoros,0,0,317,"rgb(229, 134, 6)"
14779,2020-03-26,Saint Kitts and Nevis,0,2,2,"rgb(93, 105, 177)"
14780,2020-03-27,Saint Kitts and Nevis,0,0,2,"rgb(93, 105, 177)"
14781,2020-03-28,Saint Kitts and Nevis,0,0,2,"rgb(93, 105, 177)"
14782,2020-03-29,Saint Kitts and Nevis,0,0,2,"rgb(93, 105, 177)"
14783,2020-03-30,Saint Kitts and Nevis,0,5,7,"rgb(93, 105, 177)"
14784,2020-03-31,Saint Kitts and Nevis,0,0,7,"rgb(93, 105, 177)"
14785,2020-04-01,Saint Kitts and Nevis,0,1,8,"rgb(93, 105, 177)"
14786,2020-04-02,Saint Kitts and Nevis,0,0,8,"rgb(93, 105, 177)"
14787,2020-04-03,Saint Kitts and Nevis,0,0,8,"rgb(93, 105, 177)"
14788,2020-04-04,Saint Kitts and Nevis,0,1,9,"rgb(93, 105, 177)"
14789,2020-04-05,Saint Kitts and Nevis,0,1,10,"rgb(93, 105, 177)"
14790,2020-04-06,Saint Kitts and Nevis,0,0,10,"rgb(93, 105, 177)"
14791,2020-04-07,Saint Kitts and Nevis,0,1,11,"rgb(93, 105, 177)"
14792,2020-04-08,Saint Kitts and Nevis,0,0,11,"rgb(93, 105, 177)"
14793,2020-04-09,Saint Kitts and Nevis,0,0,11,"rgb(93, 105, 177)"
14794,2020-04-10,Saint Kitts and Nevis,0,0,11,"rgb(93, 105, 177)"
14795,2020-04-11,Saint Kitts and Nevis,0,1,12,"rgb(93, 105, 177)"
14796,2020-04-12,Saint Kitts and Nevis,0,0,12,"rgb(93, 105, 177)"
14797,2020-04-13,Saint Kitts and Nevis,0,0,12,"rgb(93, 105, 177)"
14798,2020-04-14,Saint Kitts and Nevis,0,0,12,"rgb(93, 105, 177)"
14799,2020-04-15,Saint Kitts and Nevis,0,2,14,"rgb(93, 105, 177)"
14800,2020-04-16,Saint Kitts and Nevis,0,0,14,"rgb(93, 105, 177)"
14801,2020-04-17,Saint Kitts and Nevis,0,0,14,"rgb(93, 105, 177)"
14802,2020-04-18,Saint Kitts and Nevis,0,0,14,"rgb(93, 105, 177)"
14803,2020-04-19,Saint Kitts and Nevis,0,0,14,"rgb(93, 105, 177)"
14804,2020-04-20,Saint Kitts and Nevis,0,1,15,"rgb(93, 105, 177)"
14805,2020-04-21,Saint Kitts and Nevis,0,0,15,"rgb(93, 105, 177)"
14806,2020-04-22,Saint Kitts and Nevis,0,0,15,"rgb(93, 105, 177)"
14807,2020-04-23,Saint Kitts and Nevis,0,0,15,"rgb(93, 105, 177)"
14808,2020-04-24,Saint Kitts and Nevis,0,0,15,"rgb(93, 105, 177)"
14809,2020-04-25,Saint Kitts and Nevis,0,0,15,"rgb(93, 105, 177)"
14810,2020-04-26,Saint Kitts and Nevis,0,0,15,"rgb(93, 105, 177)"
14811,2020-04-27,Saint Kitts and Nevis,0,0,15,"rgb(93, 105, 177)"
14812,2020-04-28,Saint Kitts and Nevis,0,0,15,"rgb(93, 105, 177)"
14813,2020-04-29,Saint Kitts and Nevis,0,0,15,"rgb(93, 105, 177)"
14814,2020-04-30,Saint Kitts and Nevis,0,0,15,"rgb(93, 105, 177)"
14815,2020-05-01,Saint Kitts and Nevis,0,0,15,"rgb(93, 105, 177)"
14816,2020-05-02,Saint Kitts and Nevis,0,0,15,"rgb(93, 105, 177)"
14817,2020-05-03,Saint Kitts and Nevis,0,0,15,"rgb(93, 105, 177)"
14818,2020-05-04,Saint Kitts and Nevis,0,0,15,"rgb(93, 105, 177)"
14819,2020-05-05,Saint Kitts and Nevis,0,0,15,"rgb(93, 105, 177)"
14820,2020-05-06,Saint Kitts and Nevis,0,0,15,"rgb(93, 105, 177)"
14821,2020-05-07,Saint Kitts and Nevis,0,0,15,"rgb(93, 105, 177)"
14822,2020-05-08,Saint Kitts and Nevis,0,0,15,"rgb(93, 105, 177)"
14823,2020-05-09,Saint Kitts and Nevis,0,0,15,"rgb(93, 105, 177)"
14824,2020-05-10,Saint Kitts and Nevis,0,0,15,"rgb(93, 105, 177)"
14825,2020-05-11,Saint Kitts and Nevis,0,0,15,"rgb(93, 105, 177)"
14826,2020-05-12,Saint Kitts and Nevis,0,0,15,"rgb(93, 105, 177)"
14827,2020-05-13,Saint Kitts and Nevis,0,0,15,"rgb(93, 105, 177)"
14828,2020-05-14,Saint Kitts and Nevis,0,0,15,"rgb(93, 105, 177)"
14829,2020-05-15,Saint Kitts and Nevis,0,0,15,"rgb(93, 105, 177)"
14830,2020-05-16,Saint Kitts and Nevis,0,0,15,"rgb(93, 105, 177)"
14831,2020-05-17,Saint Kitts and Nevis,0,0,15,"rgb(93, 105, 177)"
14832,2020-05-18,Saint Kitts and Nevis,0,0,15,"rgb(93, 105, 177)"
14833,2020-05-19,Saint Kitts and Nevis,0,0,15,"rgb(93, 105, 177)"
14834,2020-05-20,Saint Kitts and Nevis,0,0,15,"rgb(93, 105, 177)"
14835,2020-05-21,Saint Kitts and Nevis,0,0,15,"rgb(93, 105, 177)"
14836,2020-05-22,Saint Kitts and Nevis,0,0,15,"rgb(93, 105, 177)"
14837,2020-05-23,Saint Kitts and Nevis,0,0,15,"rgb(93, 105, 177)"
14838,2020-05-24,Saint Kitts and Nevis,0,0,15,"rgb(93, 105, 177)"
14839,2020-05-25,Saint Kitts and Nevis,0,0,15,"rgb(93, 105, 177)"
14840,2020-05-26,Saint Kitts and Nevis,0,0,15,"rgb(93, 105, 177)"
14841,2020-05-27,Saint Kitts and Nevis,0,0,15,"rgb(93, 105, 177)"
14842,2020-05-28,Saint Kitts and Nevis,0,0,15,"rgb(93, 105, 177)"
14843,2020-05-29,Saint Kitts and Nevis,0,0,15,"rgb(93, 105, 177)"
14844,2020-05-30,Saint Kitts and Nevis,0,0,15,"rgb(93, 105, 177)"
14845,2020-05-31,Saint Kitts and Nevis,0,0,15,"rgb(93, 105, 177)"
14846,2020-06-01,Saint Kitts and Nevis,0,0,15,"rgb(93, 105, 177)"
14847,2020-06-02,Saint Kitts and Nevis,0,0,15,"rgb(93, 105, 177)"
14848,2020-06-03,Saint Kitts and Nevis,0,0,15,"rgb(93, 105, 177)"
14849,2020-06-04,Saint Kitts and Nevis,0,0,15,"rgb(93, 105, 177)"
14850,2020-06-05,Saint Kitts and Nevis,0,0,15,"rgb(93, 105, 177)"
14851,2020-06-06,Saint Kitts and Nevis,0,0,15,"rgb(93, 105, 177)"
14852,2020-06-07,Saint Kitts and Nevis,0,0,15,"rgb(93, 105, 177)"
14853,2020-06-08,Saint Kitts and Nevis,0,0,15,"rgb(93, 105, 177)"
14854,2020-06-09,Saint Kitts and Nevis,0,0,15,"rgb(93, 105, 177)"
14855,2020-06-10,Saint Kitts and Nevis,0,0,15,"rgb(93, 105, 177)"
14856,2020-06-11,Saint Kitts and Nevis,0,0,15,"rgb(93, 105, 177)"
14857,2020-06-12,Saint Kitts and Nevis,0,0,15,"rgb(93, 105, 177)"
14858,2020-06-13,Saint Kitts and Nevis,0,0,15,"rgb(93, 105, 177)"
14859,2020-06-14,Saint Kitts and Nevis,0,0,15,"rgb(93, 105, 177)"
14860,2020-06-15,Saint Kitts and Nevis,0,0,15,"rgb(93, 105, 177)"
14861,2020-06-16,Saint Kitts and Nevis,0,0,15,"rgb(93, 105, 177)"
14862,2020-06-17,Saint Kitts and Nevis,0,0,15,"rgb(93, 105, 177)"
14863,2020-06-18,Saint Kitts and Nevis,0,0,15,"rgb(93, 105, 177)"
14864,2020-06-19,Saint Kitts and Nevis,0,0,15,"rgb(93, 105, 177)"
14865,2020-06-20,Saint Kitts and Nevis,0,0,15,"rgb(93, 105, 177)"
14866,2020-06-21,Saint Kitts and Nevis,0,0,15,"rgb(93, 105, 177)"
14867,2020-06-22,Saint Kitts and Nevis,0,0,15,"rgb(93, 105, 177)"
14868,2020-06-23,Saint Kitts and Nevis,0,0,15,"rgb(93, 105, 177)"
14869,2020-06-24,Saint Kitts and Nevis,0,0,15,"rgb(93, 105, 177)"
14870,2020-06-25,Saint Kitts and Nevis,0,0,15,"rgb(93, 105, 177)"
14871,2020-06-26,Saint Kitts and Nevis,0,0,15,"rgb(93, 105, 177)"
14872,2020-06-27,Saint Kitts and Nevis,0,0,15,"rgb(93, 105, 177)"
14873,2020-06-28,Saint Kitts and Nevis,0,0,15,"rgb(93, 105, 177)"
14874,2020-06-29,Saint Kitts and Nevis,0,0,15,"rgb(93, 105, 177)"
14875,2020-06-30,Saint Kitts and Nevis,0,0,15,"rgb(93, 105, 177)"
14876,2020-07-01,Saint Kitts and Nevis,0,0,15,"rgb(93, 105, 177)"
14877,2020-07-02,Saint Kitts and Nevis,0,0,15,"rgb(93, 105, 177)"
14878,2020-07-03,Saint Kitts and Nevis,0,0,15,"rgb(93, 105, 177)"
14879,2020-07-04,Saint Kitts and Nevis,0,0,15,"rgb(93, 105, 177)"
14880,2020-07-05,Saint Kitts and Nevis,0,1,16,"rgb(93, 105, 177)"
14881,2020-07-06,Saint Kitts and Nevis,0,0,16,"rgb(93, 105, 177)"
14882,2020-07-07,Saint Kitts and Nevis,0,0,16,"rgb(93, 105, 177)"
14883,2020-07-08,Saint Kitts and Nevis,0,0,16,"rgb(93, 105, 177)"
14884,2020-07-09,Saint Kitts and Nevis,0,0,16,"rgb(93, 105, 177)"
14885,2020-07-10,Saint Kitts and Nevis,0,0,16,"rgb(93, 105, 177)"
14886,2020-07-11,Saint Kitts and Nevis,0,1,17,"rgb(93, 105, 177)"
14887,2020-07-12,Saint Kitts and Nevis,0,0,17,"rgb(93, 105, 177)"
14888,2020-07-13,Saint Kitts and Nevis,0,0,17,"rgb(93, 105, 177)"
14889,2019-12-31,South Korea,0,0,0,"rgb(82, 188, 163)"
14890,2020-01-01,South Korea,0,0,0,"rgb(82, 188, 163)"
14891,2020-01-02,South Korea,0,0,0,"rgb(82, 188, 163)"
14892,2020-01-03,South Korea,0,0,0,"rgb(82, 188, 163)"
14893,2020-01-04,South Korea,0,0,0,"rgb(82, 188, 163)"
14894,2020-01-05,South Korea,0,0,0,"rgb(82, 188, 163)"
14895,2020-01-06,South Korea,0,0,0,"rgb(82, 188, 163)"
14896,2020-01-07,South Korea,0,0,0,"rgb(82, 188, 163)"
14897,2020-01-08,South Korea,0,0,0,"rgb(82, 188, 163)"
14898,2020-01-09,South Korea,0,0,0,"rgb(82, 188, 163)"
14899,2020-01-10,South Korea,0,0,0,"rgb(82, 188, 163)"
14900,2020-01-11,South Korea,0,0,0,"rgb(82, 188, 163)"
14901,2020-01-12,South Korea,0,0,0,"rgb(82, 188, 163)"
14902,2020-01-13,South Korea,0,0,0,"rgb(82, 188, 163)"
14903,2020-01-14,South Korea,0,0,0,"rgb(82, 188, 163)"
14904,2020-01-15,South Korea,0,0,0,"rgb(82, 188, 163)"
14905,2020-01-16,South Korea,0,0,0,"rgb(82, 188, 163)"
14906,2020-01-17,South Korea,0,0,0,"rgb(82, 188, 163)"
14907,2020-01-18,South Korea,0,0,0,"rgb(82, 188, 163)"
14908,2020-01-19,South Korea,0,0,0,"rgb(82, 188, 163)"
14909,2020-01-20,South Korea,0,1,1,"rgb(82, 188, 163)"
14910,2020-01-21,South Korea,0,0,1,"rgb(82, 188, 163)"
14911,2020-01-22,South Korea,0,0,1,"rgb(82, 188, 163)"
14912,2020-01-23,South Korea,0,0,1,"rgb(82, 188, 163)"
14913,2020-01-24,South Korea,0,1,2,"rgb(82, 188, 163)"
14914,2020-01-25,South Korea,0,0,2,"rgb(82, 188, 163)"
14915,2020-01-26,South Korea,0,1,3,"rgb(82, 188, 163)"
14916,2020-01-27,South Korea,0,1,4,"rgb(82, 188, 163)"
14917,2020-01-28,South Korea,0,0,4,"rgb(82, 188, 163)"
14918,2020-01-29,South Korea,0,0,4,"rgb(82, 188, 163)"
14919,2020-01-30,South Korea,0,0,4,"rgb(82, 188, 163)"
14920,2020-01-31,South Korea,0,3,7,"rgb(82, 188, 163)"
14921,2020-02-01,South Korea,0,5,12,"rgb(82, 188, 163)"
14922,2020-02-02,South Korea,0,3,15,"rgb(82, 188, 163)"
14923,2020-02-03,South Korea,0,0,15,"rgb(82, 188, 163)"
14924,2020-02-04,South Korea,0,1,16,"rgb(82, 188, 163)"
14925,2020-02-05,South Korea,0,2,18,"rgb(82, 188, 163)"
14926,2020-02-06,South Korea,0,5,23,"rgb(82, 188, 163)"
14927,2020-02-07,South Korea,0,1,24,"rgb(82, 188, 163)"
14928,2020-02-08,South Korea,0,0,24,"rgb(82, 188, 163)"
14929,2020-02-09,South Korea,0,1,25,"rgb(82, 188, 163)"
14930,2020-02-10,South Korea,0,2,27,"rgb(82, 188, 163)"
14931,2020-02-11,South Korea,0,1,28,"rgb(82, 188, 163)"
14932,2020-02-12,South Korea,0,0,28,"rgb(82, 188, 163)"
14933,2020-02-13,South Korea,0,0,28,"rgb(82, 188, 163)"
14934,2020-02-14,South Korea,0,0,28,"rgb(82, 188, 163)"
14935,2020-02-15,South Korea,0,0,28,"rgb(82, 188, 163)"
14936,2020-02-16,South Korea,0,1,29,"rgb(82, 188, 163)"
14937,2020-02-17,South Korea,0,1,30,"rgb(82, 188, 163)"
14938,2020-02-18,South Korea,0,1,31,"rgb(82, 188, 163)"
14939,2020-02-19,South Korea,0,15,46,"rgb(82, 188, 163)"
14940,2020-02-20,South Korea,0,34,80,"rgb(82, 188, 163)"
14941,2020-02-21,South Korea,1,75,155,"rgb(82, 188, 163)"
14942,2020-02-22,South Korea,1,190,345,"rgb(82, 188, 163)"
14943,2020-02-23,South Korea,3,256,601,"rgb(82, 188, 163)"
14944,2020-02-24,South Korea,2,161,762,"rgb(82, 188, 163)"
14945,2020-02-25,South Korea,1,130,892,"rgb(82, 188, 163)"
14946,2020-02-26,South Korea,3,254,1146,"rgb(82, 188, 163)"
14947,2020-02-27,South Korea,1,449,1595,"rgb(82, 188, 163)"
14948,2020-02-28,South Korea,1,427,2022,"rgb(82, 188, 163)"
14949,2020-02-29,South Korea,3,909,2931,"rgb(82, 188, 163)"
14950,2020-03-01,South Korea,1,595,3526,"rgb(82, 188, 163)"
14951,2020-03-02,South Korea,5,686,4212,"rgb(82, 188, 163)"
14952,2020-03-03,South Korea,6,600,4812,"rgb(82, 188, 163)"
14953,2020-03-04,South Korea,4,516,5328,"rgb(82, 188, 163)"
14954,2020-03-05,South Korea,3,438,5766,"rgb(82, 188, 163)"
14955,2020-03-06,South Korea,7,518,6284,"rgb(82, 188, 163)"
14956,2020-03-07,South Korea,2,483,6767,"rgb(82, 188, 163)"
14957,2020-03-08,South Korea,6,367,7134,"rgb(82, 188, 163)"
14958,2020-03-09,South Korea,1,248,7382,"rgb(82, 188, 163)"
14959,2020-03-10,South Korea,3,131,7513,"rgb(82, 188, 163)"
14960,2020-03-11,South Korea,6,242,7755,"rgb(82, 188, 163)"
14961,2020-03-12,South Korea,6,114,7869,"rgb(82, 188, 163)"
14962,2020-03-13,South Korea,1,110,7979,"rgb(82, 188, 163)"
14963,2020-03-14,South Korea,5,107,8086,"rgb(82, 188, 163)"
14964,2020-03-15,South Korea,3,76,8162,"rgb(82, 188, 163)"
14965,2020-03-16,South Korea,0,74,8236,"rgb(82, 188, 163)"
14966,2020-03-17,South Korea,6,84,8320,"rgb(82, 188, 163)"
14967,2020-03-18,South Korea,5,93,8413,"rgb(82, 188, 163)"
14968,2020-03-19,South Korea,5,152,8565,"rgb(82, 188, 163)"
14969,2020-03-20,South Korea,9,87,8652,"rgb(82, 188, 163)"
14970,2020-03-21,South Korea,3,147,8799,"rgb(82, 188, 163)"
14971,2020-03-22,South Korea,1,98,8897,"rgb(82, 188, 163)"
14972,2020-03-23,South Korea,9,64,8961,"rgb(82, 188, 163)"
14973,2020-03-24,South Korea,7,76,9037,"rgb(82, 188, 163)"
14974,2020-03-25,South Korea,6,100,9137,"rgb(82, 188, 163)"
14975,2020-03-26,South Korea,5,104,9241,"rgb(82, 188, 163)"
14976,2020-03-27,South Korea,8,91,9332,"rgb(82, 188, 163)"
14977,2020-03-28,South Korea,5,146,9478,"rgb(82, 188, 163)"
14978,2020-03-29,South Korea,8,105,9583,"rgb(82, 188, 163)"
14979,2020-03-30,South Korea,6,78,9661,"rgb(82, 188, 163)"
14980,2020-03-31,South Korea,5,125,9786,"rgb(82, 188, 163)"
14981,2020-04-01,South Korea,0,0,9786,"rgb(82, 188, 163)"
14982,2020-04-02,South Korea,6,190,9976,"rgb(82, 188, 163)"
14983,2020-04-03,South Korea,5,86,10062,"rgb(82, 188, 163)"
14984,2020-04-04,South Korea,3,94,10156,"rgb(82, 188, 163)"
14985,2020-04-05,South Korea,6,81,10237,"rgb(82, 188, 163)"
14986,2020-04-06,South Korea,3,47,10284,"rgb(82, 188, 163)"
14987,2020-04-07,South Korea,6,47,10331,"rgb(82, 188, 163)"
14988,2020-04-08,South Korea,8,53,10384,"rgb(82, 188, 163)"
14989,2020-04-09,South Korea,4,39,10423,"rgb(82, 188, 163)"
14990,2020-04-10,South Korea,4,27,10450,"rgb(82, 188, 163)"
14991,2020-04-11,South Korea,0,0,10450,"rgb(82, 188, 163)"
14992,2020-04-12,South Korea,6,62,10512,"rgb(82, 188, 163)"
14993,2020-04-13,South Korea,3,25,10537,"rgb(82, 188, 163)"
14994,2020-04-14,South Korea,5,27,10564,"rgb(82, 188, 163)"
14995,2020-04-15,South Korea,3,27,10591,"rgb(82, 188, 163)"
14996,2020-04-16,South Korea,4,22,10613,"rgb(82, 188, 163)"
14997,2020-04-17,South Korea,1,22,10635,"rgb(82, 188, 163)"
14998,2020-04-18,South Korea,2,18,10653,"rgb(82, 188, 163)"
14999,2020-04-19,South Korea,2,8,10661,"rgb(82, 188, 163)"
15000,2020-04-20,South Korea,2,13,10674,"rgb(82, 188, 163)"
15001,2020-04-21,South Korea,1,9,10683,"rgb(82, 188, 163)"
15002,2020-04-22,South Korea,1,11,10694,"rgb(82, 188, 163)"
15003,2020-04-23,South Korea,2,8,10702,"rgb(82, 188, 163)"
15004,2020-04-24,South Korea,0,6,10708,"rgb(82, 188, 163)"
15005,2020-04-25,South Korea,0,10,10718,"rgb(82, 188, 163)"
15006,2020-04-26,South Korea,2,10,10728,"rgb(82, 188, 163)"
15007,2020-04-27,South Korea,1,10,10738,"rgb(82, 188, 163)"
15008,2020-04-28,South Korea,1,14,10752,"rgb(82, 188, 163)"
15009,2020-04-29,South Korea,2,9,10761,"rgb(82, 188, 163)"
15010,2020-04-30,South Korea,1,4,10765,"rgb(82, 188, 163)"
15011,2020-05-01,South Korea,1,9,10774,"rgb(82, 188, 163)"
15012,2020-05-02,South Korea,2,6,10780,"rgb(82, 188, 163)"
15013,2020-05-03,South Korea,0,13,10793,"rgb(82, 188, 163)"
15014,2020-05-04,South Korea,2,8,10801,"rgb(82, 188, 163)"
15015,2020-05-05,South Korea,2,3,10804,"rgb(82, 188, 163)"
15016,2020-05-06,South Korea,1,2,10806,"rgb(82, 188, 163)"
15017,2020-05-07,South Korea,1,4,10810,"rgb(82, 188, 163)"
15018,2020-05-08,South Korea,0,12,10822,"rgb(82, 188, 163)"
15019,2020-05-09,South Korea,0,18,10840,"rgb(82, 188, 163)"
15020,2020-05-10,South Korea,0,34,10874,"rgb(82, 188, 163)"
15021,2020-05-11,South Korea,0,35,10909,"rgb(82, 188, 163)"
15022,2020-05-12,South Korea,2,27,10936,"rgb(82, 188, 163)"
15023,2020-05-13,South Korea,1,26,10962,"rgb(82, 188, 163)"
15024,2020-05-14,South Korea,1,29,10991,"rgb(82, 188, 163)"
15025,2020-05-15,South Korea,0,27,11018,"rgb(82, 188, 163)"
15026,2020-05-16,South Korea,2,19,11037,"rgb(82, 188, 163)"
15027,2020-05-17,South Korea,0,13,11050,"rgb(82, 188, 163)"
15028,2020-05-18,South Korea,1,15,11065,"rgb(82, 188, 163)"
15029,2020-05-19,South Korea,0,13,11078,"rgb(82, 188, 163)"
15030,2020-05-20,South Korea,0,32,11110,"rgb(82, 188, 163)"
15031,2020-05-21,South Korea,1,12,11122,"rgb(82, 188, 163)"
15032,2020-05-22,South Korea,0,20,11142,"rgb(82, 188, 163)"
15033,2020-05-23,South Korea,2,23,11165,"rgb(82, 188, 163)"
15034,2020-05-24,South Korea,0,25,11190,"rgb(82, 188, 163)"
15035,2020-05-25,South Korea,1,16,11206,"rgb(82, 188, 163)"
15036,2020-05-26,South Korea,2,19,11225,"rgb(82, 188, 163)"
15037,2020-05-27,South Korea,0,40,11265,"rgb(82, 188, 163)"
15038,2020-05-28,South Korea,0,79,11344,"rgb(82, 188, 163)"
15039,2020-05-29,South Korea,0,58,11402,"rgb(82, 188, 163)"
15040,2020-05-30,South Korea,0,39,11441,"rgb(82, 188, 163)"
15041,2020-05-31,South Korea,1,27,11468,"rgb(82, 188, 163)"
15042,2020-06-01,South Korea,1,35,11503,"rgb(82, 188, 163)"
15043,2020-06-02,South Korea,1,38,11541,"rgb(82, 188, 163)"
15044,2020-06-03,South Korea,1,49,11590,"rgb(82, 188, 163)"
15045,2020-06-04,South Korea,0,39,11629,"rgb(82, 188, 163)"
15046,2020-06-05,South Korea,0,39,11668,"rgb(82, 188, 163)"
15047,2020-06-06,South Korea,0,51,11719,"rgb(82, 188, 163)"
15048,2020-06-07,South Korea,0,57,11776,"rgb(82, 188, 163)"
15049,2020-06-08,South Korea,0,38,11814,"rgb(82, 188, 163)"
15050,2020-06-09,South Korea,1,38,11852,"rgb(82, 188, 163)"
15051,2020-06-10,South Korea,2,50,11902,"rgb(82, 188, 163)"
15052,2020-06-11,South Korea,0,45,11947,"rgb(82, 188, 163)"
15053,2020-06-12,South Korea,1,56,12003,"rgb(82, 188, 163)"
15054,2020-06-13,South Korea,0,48,12051,"rgb(82, 188, 163)"
15055,2020-06-14,South Korea,0,33,12084,"rgb(82, 188, 163)"
15056,2020-06-15,South Korea,0,37,12121,"rgb(82, 188, 163)"
15057,2020-06-16,South Korea,1,34,12155,"rgb(82, 188, 163)"
15058,2020-06-17,South Korea,1,43,12198,"rgb(82, 188, 163)"
15059,2020-06-18,South Korea,1,59,12257,"rgb(82, 188, 163)"
15060,2020-06-19,South Korea,0,49,12306,"rgb(82, 188, 163)"
15061,2020-06-20,South Korea,0,67,12373,"rgb(82, 188, 163)"
15062,2020-06-21,South Korea,0,48,12421,"rgb(82, 188, 163)"
15063,2020-06-22,South Korea,0,17,12438,"rgb(82, 188, 163)"
15064,2020-06-23,South Korea,1,46,12484,"rgb(82, 188, 163)"
15065,2020-06-24,South Korea,0,51,12535,"rgb(82, 188, 163)"
15066,2020-06-25,South Korea,1,28,12563,"rgb(82, 188, 163)"
15067,2020-06-26,South Korea,0,39,12602,"rgb(82, 188, 163)"
15068,2020-06-27,South Korea,0,51,12653,"rgb(82, 188, 163)"
15069,2020-06-28,South Korea,0,62,12715,"rgb(82, 188, 163)"
15070,2020-06-29,South Korea,0,42,12757,"rgb(82, 188, 163)"
15071,2020-06-30,South Korea,0,43,12800,"rgb(82, 188, 163)"
15072,2020-07-01,South Korea,0,50,12850,"rgb(82, 188, 163)"
15073,2020-07-02,South Korea,0,54,12904,"rgb(82, 188, 163)"
15074,2020-07-03,South Korea,0,63,12967,"rgb(82, 188, 163)"
15075,2020-07-04,South Korea,1,63,13030,"rgb(82, 188, 163)"
15076,2020-07-05,South Korea,0,61,13091,"rgb(82, 188, 163)"
15077,2020-07-06,South Korea,0,0,13091,"rgb(82, 188, 163)"
15078,2020-07-07,South Korea,2,90,13181,"rgb(82, 188, 163)"
15079,2020-07-08,South Korea,0,63,13244,"rgb(82, 188, 163)"
15080,2020-07-09,South Korea,2,49,13293,"rgb(82, 188, 163)"
15081,2020-07-10,South Korea,1,45,13338,"rgb(82, 188, 163)"
15082,2020-07-11,South Korea,0,35,13373,"rgb(82, 188, 163)"
15083,2020-07-12,South Korea,1,44,13417,"rgb(82, 188, 163)"
15084,2020-07-13,South Korea,0,62,13479,"rgb(82, 188, 163)"
15085,2019-12-31,Kuwait,0,0,0,"rgb(153, 201, 69)"
15086,2020-01-01,Kuwait,0,0,0,"rgb(153, 201, 69)"
15087,2020-01-02,Kuwait,0,0,0,"rgb(153, 201, 69)"
15088,2020-01-03,Kuwait,0,0,0,"rgb(153, 201, 69)"
15089,2020-01-04,Kuwait,0,0,0,"rgb(153, 201, 69)"
15090,2020-01-05,Kuwait,0,0,0,"rgb(153, 201, 69)"
15091,2020-01-06,Kuwait,0,0,0,"rgb(153, 201, 69)"
15092,2020-01-07,Kuwait,0,0,0,"rgb(153, 201, 69)"
15093,2020-01-08,Kuwait,0,0,0,"rgb(153, 201, 69)"
15094,2020-01-09,Kuwait,0,0,0,"rgb(153, 201, 69)"
15095,2020-01-10,Kuwait,0,0,0,"rgb(153, 201, 69)"
15096,2020-01-11,Kuwait,0,0,0,"rgb(153, 201, 69)"
15097,2020-01-12,Kuwait,0,0,0,"rgb(153, 201, 69)"
15098,2020-01-13,Kuwait,0,0,0,"rgb(153, 201, 69)"
15099,2020-01-14,Kuwait,0,0,0,"rgb(153, 201, 69)"
15100,2020-01-15,Kuwait,0,0,0,"rgb(153, 201, 69)"
15101,2020-01-16,Kuwait,0,0,0,"rgb(153, 201, 69)"
15102,2020-01-17,Kuwait,0,0,0,"rgb(153, 201, 69)"
15103,2020-01-18,Kuwait,0,0,0,"rgb(153, 201, 69)"
15104,2020-01-19,Kuwait,0,0,0,"rgb(153, 201, 69)"
15105,2020-01-20,Kuwait,0,0,0,"rgb(153, 201, 69)"
15106,2020-01-21,Kuwait,0,0,0,"rgb(153, 201, 69)"
15107,2020-01-22,Kuwait,0,0,0,"rgb(153, 201, 69)"
15108,2020-01-23,Kuwait,0,0,0,"rgb(153, 201, 69)"
15109,2020-01-24,Kuwait,0,0,0,"rgb(153, 201, 69)"
15110,2020-01-25,Kuwait,0,0,0,"rgb(153, 201, 69)"
15111,2020-01-26,Kuwait,0,0,0,"rgb(153, 201, 69)"
15112,2020-01-27,Kuwait,0,0,0,"rgb(153, 201, 69)"
15113,2020-01-28,Kuwait,0,0,0,"rgb(153, 201, 69)"
15114,2020-01-29,Kuwait,0,0,0,"rgb(153, 201, 69)"
15115,2020-01-30,Kuwait,0,0,0,"rgb(153, 201, 69)"
15116,2020-01-31,Kuwait,0,0,0,"rgb(153, 201, 69)"
15117,2020-02-01,Kuwait,0,0,0,"rgb(153, 201, 69)"
15118,2020-02-02,Kuwait,0,0,0,"rgb(153, 201, 69)"
15119,2020-02-03,Kuwait,0,0,0,"rgb(153, 201, 69)"
15120,2020-02-04,Kuwait,0,0,0,"rgb(153, 201, 69)"
15121,2020-02-05,Kuwait,0,0,0,"rgb(153, 201, 69)"
15122,2020-02-06,Kuwait,0,0,0,"rgb(153, 201, 69)"
15123,2020-02-07,Kuwait,0,0,0,"rgb(153, 201, 69)"
15124,2020-02-08,Kuwait,0,0,0,"rgb(153, 201, 69)"
15125,2020-02-09,Kuwait,0,0,0,"rgb(153, 201, 69)"
15126,2020-02-10,Kuwait,0,0,0,"rgb(153, 201, 69)"
15127,2020-02-11,Kuwait,0,0,0,"rgb(153, 201, 69)"
15128,2020-02-12,Kuwait,0,0,0,"rgb(153, 201, 69)"
15129,2020-02-13,Kuwait,0,0,0,"rgb(153, 201, 69)"
15130,2020-02-14,Kuwait,0,0,0,"rgb(153, 201, 69)"
15131,2020-02-15,Kuwait,0,0,0,"rgb(153, 201, 69)"
15132,2020-02-16,Kuwait,0,0,0,"rgb(153, 201, 69)"
15133,2020-02-17,Kuwait,0,0,0,"rgb(153, 201, 69)"
15134,2020-02-18,Kuwait,0,0,0,"rgb(153, 201, 69)"
15135,2020-02-19,Kuwait,0,0,0,"rgb(153, 201, 69)"
15136,2020-02-20,Kuwait,0,0,0,"rgb(153, 201, 69)"
15137,2020-02-21,Kuwait,0,0,0,"rgb(153, 201, 69)"
15138,2020-02-22,Kuwait,0,0,0,"rgb(153, 201, 69)"
15139,2020-02-23,Kuwait,0,0,0,"rgb(153, 201, 69)"
15140,2020-02-24,Kuwait,0,3,3,"rgb(153, 201, 69)"
15141,2020-02-25,Kuwait,0,2,5,"rgb(153, 201, 69)"
15142,2020-02-26,Kuwait,0,6,11,"rgb(153, 201, 69)"
15143,2020-02-27,Kuwait,0,15,26,"rgb(153, 201, 69)"
15144,2020-02-28,Kuwait,0,17,43,"rgb(153, 201, 69)"
15145,2020-02-29,Kuwait,0,2,45,"rgb(153, 201, 69)"
15146,2020-03-01,Kuwait,0,0,45,"rgb(153, 201, 69)"
15147,2020-03-02,Kuwait,0,1,46,"rgb(153, 201, 69)"
15148,2020-03-03,Kuwait,0,10,56,"rgb(153, 201, 69)"
15149,2020-03-06,Kuwait,0,2,58,"rgb(153, 201, 69)"
15150,2020-03-08,Kuwait,0,3,61,"rgb(153, 201, 69)"
15151,2020-03-09,Kuwait,0,3,64,"rgb(153, 201, 69)"
15152,2020-03-10,Kuwait,0,1,65,"rgb(153, 201, 69)"
15153,2020-03-11,Kuwait,0,4,69,"rgb(153, 201, 69)"
15154,2020-03-12,Kuwait,0,3,72,"rgb(153, 201, 69)"
15155,2020-03-13,Kuwait,0,8,80,"rgb(153, 201, 69)"
15156,2020-03-14,Kuwait,0,20,100,"rgb(153, 201, 69)"
15157,2020-03-15,Kuwait,0,4,104,"rgb(153, 201, 69)"
15158,2020-03-16,Kuwait,0,8,112,"rgb(153, 201, 69)"
15159,2020-03-17,Kuwait,0,11,123,"rgb(153, 201, 69)"
15160,2020-03-18,Kuwait,0,7,130,"rgb(153, 201, 69)"
15161,2020-03-19,Kuwait,0,12,142,"rgb(153, 201, 69)"
15162,2020-03-20,Kuwait,0,6,148,"rgb(153, 201, 69)"
15163,2020-03-21,Kuwait,0,11,159,"rgb(153, 201, 69)"
15164,2020-03-22,Kuwait,0,17,176,"rgb(153, 201, 69)"
15165,2020-03-23,Kuwait,0,12,188,"rgb(153, 201, 69)"
15166,2020-03-24,Kuwait,0,1,189,"rgb(153, 201, 69)"
15167,2020-03-25,Kuwait,0,2,191,"rgb(153, 201, 69)"
15168,2020-03-26,Kuwait,0,4,195,"rgb(153, 201, 69)"
15169,2020-03-27,Kuwait,0,13,208,"rgb(153, 201, 69)"
15170,2020-03-28,Kuwait,0,17,225,"rgb(153, 201, 69)"
15171,2020-03-29,Kuwait,0,10,235,"rgb(153, 201, 69)"
15172,2020-03-30,Kuwait,0,20,255,"rgb(153, 201, 69)"
15173,2020-03-31,Kuwait,0,11,266,"rgb(153, 201, 69)"
15174,2020-04-01,Kuwait,0,23,289,"rgb(153, 201, 69)"
15175,2020-04-02,Kuwait,0,28,317,"rgb(153, 201, 69)"
15176,2020-04-03,Kuwait,0,25,342,"rgb(153, 201, 69)"
15177,2020-04-04,Kuwait,0,0,342,"rgb(153, 201, 69)"
15178,2020-04-05,Kuwait,1,137,479,"rgb(153, 201, 69)"
15179,2020-04-06,Kuwait,0,77,556,"rgb(153, 201, 69)"
15180,2020-04-07,Kuwait,0,109,665,"rgb(153, 201, 69)"
15181,2020-04-08,Kuwait,0,78,743,"rgb(153, 201, 69)"
15182,2020-04-09,Kuwait,0,112,855,"rgb(153, 201, 69)"
15183,2020-04-10,Kuwait,0,55,910,"rgb(153, 201, 69)"
15184,2020-04-11,Kuwait,0,83,993,"rgb(153, 201, 69)"
15185,2020-04-12,Kuwait,0,161,1154,"rgb(153, 201, 69)"
15186,2020-04-13,Kuwait,0,80,1234,"rgb(153, 201, 69)"
15187,2020-04-14,Kuwait,1,66,1300,"rgb(153, 201, 69)"
15188,2020-04-15,Kuwait,1,55,1355,"rgb(153, 201, 69)"
15189,2020-04-16,Kuwait,0,50,1405,"rgb(153, 201, 69)"
15190,2020-04-17,Kuwait,0,119,1524,"rgb(153, 201, 69)"
15191,2020-04-18,Kuwait,2,134,1658,"rgb(153, 201, 69)"
15192,2020-04-19,Kuwait,1,94,1752,"rgb(153, 201, 69)"
15193,2020-04-20,Kuwait,1,163,1915,"rgb(153, 201, 69)"
15194,2020-04-21,Kuwait,2,80,1995,"rgb(153, 201, 69)"
15195,2020-04-22,Kuwait,2,85,2080,"rgb(153, 201, 69)"
15196,2020-04-23,Kuwait,2,168,2248,"rgb(153, 201, 69)"
15197,2020-04-24,Kuwait,1,151,2399,"rgb(153, 201, 69)"
15198,2020-04-25,Kuwait,1,215,2614,"rgb(153, 201, 69)"
15199,2020-04-26,Kuwait,4,278,2892,"rgb(153, 201, 69)"
15200,2020-04-27,Kuwait,1,183,3075,"rgb(153, 201, 69)"
15201,2020-04-28,Kuwait,2,213,3288,"rgb(153, 201, 69)"
15202,2020-04-29,Kuwait,1,152,3440,"rgb(153, 201, 69)"
15203,2020-04-30,Kuwait,1,300,3740,"rgb(153, 201, 69)"
15204,2020-05-01,Kuwait,2,284,4024,"rgb(153, 201, 69)"
15205,2020-05-02,Kuwait,4,353,4377,"rgb(153, 201, 69)"
15206,2020-05-03,Kuwait,3,242,4619,"rgb(153, 201, 69)"
15207,2020-05-04,Kuwait,5,364,4983,"rgb(153, 201, 69)"
15208,2020-05-05,Kuwait,2,295,5278,"rgb(153, 201, 69)"
15209,2020-05-06,Kuwait,0,526,5804,"rgb(153, 201, 69)"
15210,2020-05-07,Kuwait,2,485,6289,"rgb(153, 201, 69)"
15211,2020-05-08,Kuwait,2,278,6567,"rgb(153, 201, 69)"
15212,2020-05-09,Kuwait,3,641,7208,"rgb(153, 201, 69)"
15213,2020-05-10,Kuwait,2,415,7623,"rgb(153, 201, 69)"
15214,2020-05-11,Kuwait,9,1065,8688,"rgb(153, 201, 69)"
15215,2020-05-12,Kuwait,7,598,9286,"rgb(153, 201, 69)"
15216,2020-05-13,Kuwait,10,991,10277,"rgb(153, 201, 69)"
15217,2020-05-14,Kuwait,7,751,11028,"rgb(153, 201, 69)"
15218,2020-05-15,Kuwait,6,947,11975,"rgb(153, 201, 69)"
15219,2020-05-16,Kuwait,8,885,12860,"rgb(153, 201, 69)"
15220,2020-05-17,Kuwait,11,942,13802,"rgb(153, 201, 69)"
15221,2020-05-18,Kuwait,5,1048,14850,"rgb(153, 201, 69)"
15222,2020-05-19,Kuwait,6,841,15691,"rgb(153, 201, 69)"
15223,2020-05-20,Kuwait,3,1073,16764,"rgb(153, 201, 69)"
15224,2020-05-21,Kuwait,3,804,17568,"rgb(153, 201, 69)"
15225,2020-05-22,Kuwait,5,1041,18609,"rgb(153, 201, 69)"
15226,2020-05-23,Kuwait,9,955,19564,"rgb(153, 201, 69)"
15227,2020-05-24,Kuwait,10,900,20464,"rgb(153, 201, 69)"
15228,2020-05-25,Kuwait,8,838,21302,"rgb(153, 201, 69)"
15229,2020-05-26,Kuwait,9,665,21967,"rgb(153, 201, 69)"
15230,2020-05-27,Kuwait,7,608,22575,"rgb(153, 201, 69)"
15231,2020-05-28,Kuwait,3,692,23267,"rgb(153, 201, 69)"
15232,2020-05-29,Kuwait,10,845,24112,"rgb(153, 201, 69)"
15233,2020-05-30,Kuwait,9,1072,25184,"rgb(153, 201, 69)"
15234,2020-05-31,Kuwait,11,1008,26192,"rgb(153, 201, 69)"
15235,2020-06-01,Kuwait,7,851,27043,"rgb(153, 201, 69)"
15236,2020-06-02,Kuwait,8,719,27762,"rgb(153, 201, 69)"
15237,2020-06-03,Kuwait,6,887,28649,"rgb(153, 201, 69)"
15238,2020-06-04,Kuwait,4,710,29359,"rgb(153, 201, 69)"
15239,2020-06-05,Kuwait,6,562,29921,"rgb(153, 201, 69)"
15240,2020-06-06,Kuwait,8,723,30644,"rgb(153, 201, 69)"
15241,2020-06-07,Kuwait,10,487,31131,"rgb(153, 201, 69)"
15242,2020-06-08,Kuwait,10,717,31848,"rgb(153, 201, 69)"
15243,2020-06-09,Kuwait,5,662,32510,"rgb(153, 201, 69)"
15244,2020-06-10,Kuwait,4,630,33140,"rgb(153, 201, 69)"
15245,2020-06-11,Kuwait,2,683,33823,"rgb(153, 201, 69)"
15246,2020-06-12,Kuwait,4,609,34432,"rgb(153, 201, 69)"
15247,2020-06-13,Kuwait,6,520,34952,"rgb(153, 201, 69)"
15248,2020-06-14,Kuwait,4,514,35466,"rgb(153, 201, 69)"
15249,2020-06-15,Kuwait,7,454,35920,"rgb(153, 201, 69)"
15250,2020-06-16,Kuwait,2,511,36431,"rgb(153, 201, 69)"
15251,2020-06-17,Kuwait,5,527,36958,"rgb(153, 201, 69)"
15252,2020-06-18,Kuwait,3,575,37533,"rgb(153, 201, 69)"
15253,2020-06-19,Kuwait,2,541,38074,"rgb(153, 201, 69)"
15254,2020-06-20,Kuwait,5,604,38678,"rgb(153, 201, 69)"
15255,2020-06-21,Kuwait,6,467,39145,"rgb(153, 201, 69)"
15256,2020-06-22,Kuwait,7,505,39650,"rgb(153, 201, 69)"
15257,2020-06-23,Kuwait,4,641,40291,"rgb(153, 201, 69)"
15258,2020-06-24,Kuwait,4,742,41033,"rgb(153, 201, 69)"
15259,2020-06-25,Kuwait,3,846,41879,"rgb(153, 201, 69)"
15260,2020-06-26,Kuwait,2,909,42788,"rgb(153, 201, 69)"
15261,2020-06-27,Kuwait,2,915,43703,"rgb(153, 201, 69)"
15262,2020-06-28,Kuwait,3,688,44391,"rgb(153, 201, 69)"
15263,2020-06-29,Kuwait,4,551,44942,"rgb(153, 201, 69)"
15264,2020-06-30,Kuwait,2,582,45524,"rgb(153, 201, 69)"
15265,2020-07-01,Kuwait,4,671,46195,"rgb(153, 201, 69)"
15266,2020-07-02,Kuwait,4,745,46940,"rgb(153, 201, 69)"
15267,2020-07-03,Kuwait,1,919,47859,"rgb(153, 201, 69)"
15268,2020-07-04,Kuwait,1,813,48672,"rgb(153, 201, 69)"
15269,2020-07-05,Kuwait,5,631,49303,"rgb(153, 201, 69)"
15270,2020-07-06,Kuwait,3,638,49941,"rgb(153, 201, 69)"
15271,2020-07-07,Kuwait,5,703,50644,"rgb(153, 201, 69)"
15272,2020-07-08,Kuwait,4,601,51245,"rgb(153, 201, 69)"
15273,2020-07-09,Kuwait,2,762,52007,"rgb(153, 201, 69)"
15274,2020-07-10,Kuwait,3,833,52840,"rgb(153, 201, 69)"
15275,2020-07-11,Kuwait,1,740,53580,"rgb(153, 201, 69)"
15276,2020-07-12,Kuwait,3,478,54058,"rgb(153, 201, 69)"
15277,2020-07-13,Kuwait,4,836,54894,"rgb(153, 201, 69)"
15278,2020-03-20,Cayman Islands,0,1,1,"rgb(204, 97, 176)"
15279,2020-03-21,Cayman Islands,1,2,3,"rgb(204, 97, 176)"
15280,2020-03-22,Cayman Islands,0,0,3,"rgb(204, 97, 176)"
15281,2020-03-23,Cayman Islands,0,0,3,"rgb(204, 97, 176)"
15282,2020-03-24,Cayman Islands,0,0,3,"rgb(204, 97, 176)"
15283,2020-03-25,Cayman Islands,0,0,3,"rgb(204, 97, 176)"
15284,2020-03-26,Cayman Islands,0,0,3,"rgb(204, 97, 176)"
15285,2020-03-27,Cayman Islands,0,3,6,"rgb(204, 97, 176)"
15286,2020-03-28,Cayman Islands,0,2,8,"rgb(204, 97, 176)"
15287,2020-03-29,Cayman Islands,0,0,8,"rgb(204, 97, 176)"
15288,2020-03-30,Cayman Islands,0,0,8,"rgb(204, 97, 176)"
15289,2020-03-31,Cayman Islands,0,4,12,"rgb(204, 97, 176)"
15290,2020-04-01,Cayman Islands,0,2,14,"rgb(204, 97, 176)"
15291,2020-04-02,Cayman Islands,0,8,22,"rgb(204, 97, 176)"
15292,2020-04-03,Cayman Islands,0,6,28,"rgb(204, 97, 176)"
15293,2020-04-04,Cayman Islands,0,1,29,"rgb(204, 97, 176)"
15294,2020-04-05,Cayman Islands,0,6,35,"rgb(204, 97, 176)"
15295,2020-04-06,Cayman Islands,0,4,39,"rgb(204, 97, 176)"
15296,2020-04-07,Cayman Islands,0,0,39,"rgb(204, 97, 176)"
15297,2020-04-08,Cayman Islands,0,6,45,"rgb(204, 97, 176)"
15298,2020-04-09,Cayman Islands,0,0,45,"rgb(204, 97, 176)"
15299,2020-04-10,Cayman Islands,0,0,45,"rgb(204, 97, 176)"
15300,2020-04-11,Cayman Islands,0,0,45,"rgb(204, 97, 176)"
15301,2020-04-12,Cayman Islands,0,8,53,"rgb(204, 97, 176)"
15302,2020-04-13,Cayman Islands,0,0,53,"rgb(204, 97, 176)"
15303,2020-04-14,Cayman Islands,0,0,53,"rgb(204, 97, 176)"
15304,2020-04-15,Cayman Islands,0,1,54,"rgb(204, 97, 176)"
15305,2020-04-16,Cayman Islands,0,6,60,"rgb(204, 97, 176)"
15306,2020-04-17,Cayman Islands,0,1,61,"rgb(204, 97, 176)"
15307,2020-04-18,Cayman Islands,0,0,61,"rgb(204, 97, 176)"
15308,2020-04-19,Cayman Islands,0,0,61,"rgb(204, 97, 176)"
15309,2020-04-20,Cayman Islands,0,0,61,"rgb(204, 97, 176)"
15310,2020-04-21,Cayman Islands,0,5,66,"rgb(204, 97, 176)"
15311,2020-04-22,Cayman Islands,0,0,66,"rgb(204, 97, 176)"
15312,2020-04-23,Cayman Islands,0,0,66,"rgb(204, 97, 176)"
15313,2020-04-24,Cayman Islands,0,0,66,"rgb(204, 97, 176)"
15314,2020-04-25,Cayman Islands,0,0,66,"rgb(204, 97, 176)"
15315,2020-04-26,Cayman Islands,0,4,70,"rgb(204, 97, 176)"
15316,2020-04-27,Cayman Islands,0,0,70,"rgb(204, 97, 176)"
15317,2020-04-28,Cayman Islands,0,0,70,"rgb(204, 97, 176)"
15318,2020-04-29,Cayman Islands,0,0,70,"rgb(204, 97, 176)"
15319,2020-04-30,Cayman Islands,0,3,73,"rgb(204, 97, 176)"
15320,2020-05-01,Cayman Islands,0,0,73,"rgb(204, 97, 176)"
15321,2020-05-02,Cayman Islands,0,1,74,"rgb(204, 97, 176)"
15322,2020-05-03,Cayman Islands,0,0,74,"rgb(204, 97, 176)"
15323,2020-05-04,Cayman Islands,0,0,74,"rgb(204, 97, 176)"
15324,2020-05-05,Cayman Islands,0,1,75,"rgb(204, 97, 176)"
15325,2020-05-06,Cayman Islands,0,0,75,"rgb(204, 97, 176)"
15326,2020-05-07,Cayman Islands,0,3,78,"rgb(204, 97, 176)"
15327,2020-05-08,Cayman Islands,0,0,78,"rgb(204, 97, 176)"
15328,2020-05-09,Cayman Islands,0,3,81,"rgb(204, 97, 176)"
15329,2020-05-10,Cayman Islands,0,0,81,"rgb(204, 97, 176)"
15330,2020-05-11,Cayman Islands,0,0,81,"rgb(204, 97, 176)"
15331,2020-05-12,Cayman Islands,0,3,84,"rgb(204, 97, 176)"
15332,2020-05-13,Cayman Islands,0,1,85,"rgb(204, 97, 176)"
15333,2020-05-14,Cayman Islands,0,0,85,"rgb(204, 97, 176)"
15334,2020-05-15,Cayman Islands,0,8,93,"rgb(204, 97, 176)"
15335,2020-05-16,Cayman Islands,0,0,93,"rgb(204, 97, 176)"
15336,2020-05-17,Cayman Islands,0,1,94,"rgb(204, 97, 176)"
15337,2020-05-18,Cayman Islands,0,0,94,"rgb(204, 97, 176)"
15338,2020-05-19,Cayman Islands,0,0,94,"rgb(204, 97, 176)"
15339,2020-05-20,Cayman Islands,0,17,111,"rgb(204, 97, 176)"
15340,2020-05-21,Cayman Islands,0,0,111,"rgb(204, 97, 176)"
15341,2020-05-22,Cayman Islands,0,0,111,"rgb(204, 97, 176)"
15342,2020-05-23,Cayman Islands,0,10,121,"rgb(204, 97, 176)"
15343,2020-05-24,Cayman Islands,0,8,129,"rgb(204, 97, 176)"
15344,2020-05-25,Cayman Islands,0,0,129,"rgb(204, 97, 176)"
15345,2020-05-26,Cayman Islands,0,5,134,"rgb(204, 97, 176)"
15346,2020-05-27,Cayman Islands,0,3,137,"rgb(204, 97, 176)"
15347,2020-05-28,Cayman Islands,0,3,140,"rgb(204, 97, 176)"
15348,2020-05-29,Cayman Islands,0,0,140,"rgb(204, 97, 176)"
15349,2020-05-30,Cayman Islands,0,1,141,"rgb(204, 97, 176)"
15350,2020-05-31,Cayman Islands,0,0,141,"rgb(204, 97, 176)"
15351,2020-06-01,Cayman Islands,0,0,141,"rgb(204, 97, 176)"
15352,2020-06-02,Cayman Islands,0,9,150,"rgb(204, 97, 176)"
15353,2020-06-03,Cayman Islands,0,1,151,"rgb(204, 97, 176)"
15354,2020-06-04,Cayman Islands,0,5,156,"rgb(204, 97, 176)"
15355,2020-06-05,Cayman Islands,0,4,160,"rgb(204, 97, 176)"
15356,2020-06-06,Cayman Islands,0,4,164,"rgb(204, 97, 176)"
15357,2020-06-07,Cayman Islands,0,0,164,"rgb(204, 97, 176)"
15358,2020-06-08,Cayman Islands,0,0,164,"rgb(204, 97, 176)"
15359,2020-06-09,Cayman Islands,0,7,171,"rgb(204, 97, 176)"
15360,2020-06-10,Cayman Islands,0,5,176,"rgb(204, 97, 176)"
15361,2020-06-11,Cayman Islands,0,4,180,"rgb(204, 97, 176)"
15362,2020-06-12,Cayman Islands,0,0,180,"rgb(204, 97, 176)"
15363,2020-06-13,Cayman Islands,0,7,187,"rgb(204, 97, 176)"
15364,2020-06-14,Cayman Islands,0,0,187,"rgb(204, 97, 176)"
15365,2020-06-15,Cayman Islands,0,0,187,"rgb(204, 97, 176)"
15366,2020-06-16,Cayman Islands,0,0,187,"rgb(204, 97, 176)"
15367,2020-06-17,Cayman Islands,0,6,193,"rgb(204, 97, 176)"
15368,2020-06-18,Cayman Islands,0,0,193,"rgb(204, 97, 176)"
15369,2020-06-19,Cayman Islands,0,0,193,"rgb(204, 97, 176)"
15370,2020-06-20,Cayman Islands,0,2,195,"rgb(204, 97, 176)"
15371,2020-06-21,Cayman Islands,0,0,195,"rgb(204, 97, 176)"
15372,2020-06-22,Cayman Islands,0,0,195,"rgb(204, 97, 176)"
15373,2020-06-23,Cayman Islands,0,0,195,"rgb(204, 97, 176)"
15374,2020-06-24,Cayman Islands,0,0,195,"rgb(204, 97, 176)"
15375,2020-06-25,Cayman Islands,0,1,196,"rgb(204, 97, 176)"
15376,2020-06-26,Cayman Islands,0,0,196,"rgb(204, 97, 176)"
15377,2020-06-27,Cayman Islands,0,0,196,"rgb(204, 97, 176)"
15378,2020-06-28,Cayman Islands,0,0,196,"rgb(204, 97, 176)"
15379,2020-06-29,Cayman Islands,0,0,196,"rgb(204, 97, 176)"
15380,2020-06-30,Cayman Islands,0,3,199,"rgb(204, 97, 176)"
15381,2020-07-01,Cayman Islands,0,1,200,"rgb(204, 97, 176)"
15382,2020-07-02,Cayman Islands,0,1,201,"rgb(204, 97, 176)"
15383,2020-07-03,Cayman Islands,0,0,201,"rgb(204, 97, 176)"
15384,2020-07-04,Cayman Islands,0,0,201,"rgb(204, 97, 176)"
15385,2020-07-05,Cayman Islands,0,0,201,"rgb(204, 97, 176)"
15386,2020-07-06,Cayman Islands,0,0,201,"rgb(204, 97, 176)"
15387,2020-07-07,Cayman Islands,0,0,201,"rgb(204, 97, 176)"
15388,2020-07-08,Cayman Islands,0,0,201,"rgb(204, 97, 176)"
15389,2020-07-09,Cayman Islands,0,0,201,"rgb(204, 97, 176)"
15390,2020-07-10,Cayman Islands,0,0,201,"rgb(204, 97, 176)"
15391,2020-07-11,Cayman Islands,0,0,201,"rgb(204, 97, 176)"
15392,2020-07-12,Cayman Islands,0,0,201,"rgb(204, 97, 176)"
15393,2020-07-13,Cayman Islands,0,0,201,"rgb(204, 97, 176)"
15394,2020-03-15,Kazakhstan,0,6,6,"rgb(36, 121, 108)"
15395,2020-03-16,Kazakhstan,0,3,9,"rgb(36, 121, 108)"
15396,2020-03-17,Kazakhstan,0,2,11,"rgb(36, 121, 108)"
15397,2020-03-18,Kazakhstan,0,22,33,"rgb(36, 121, 108)"
15398,2020-03-19,Kazakhstan,0,4,37,"rgb(36, 121, 108)"
15399,2020-03-20,Kazakhstan,0,12,49,"rgb(36, 121, 108)"
15400,2020-03-21,Kazakhstan,0,4,53,"rgb(36, 121, 108)"
15401,2020-03-22,Kazakhstan,0,3,56,"rgb(36, 121, 108)"
15402,2020-03-23,Kazakhstan,0,4,60,"rgb(36, 121, 108)"
15403,2020-03-24,Kazakhstan,0,2,62,"rgb(36, 121, 108)"
15404,2020-03-25,Kazakhstan,0,17,79,"rgb(36, 121, 108)"
15405,2020-03-26,Kazakhstan,0,9,88,"rgb(36, 121, 108)"
15406,2020-03-27,Kazakhstan,0,32,120,"rgb(36, 121, 108)"
15407,2020-03-28,Kazakhstan,0,73,193,"rgb(36, 121, 108)"
15408,2020-03-29,Kazakhstan,0,36,229,"rgb(36, 121, 108)"
15409,2020-03-30,Kazakhstan,1,55,284,"rgb(36, 121, 108)"
15410,2020-03-31,Kazakhstan,0,41,325,"rgb(36, 121, 108)"
15411,2020-04-01,Kazakhstan,0,15,340,"rgb(36, 121, 108)"
15412,2020-04-02,Kazakhstan,1,8,348,"rgb(36, 121, 108)"
15413,2020-04-03,Kazakhstan,1,38,386,"rgb(36, 121, 108)"
15414,2020-04-04,Kazakhstan,0,74,460,"rgb(36, 121, 108)"
15415,2020-04-05,Kazakhstan,0,0,460,"rgb(36, 121, 108)"
15416,2020-04-06,Kazakhstan,2,71,531,"rgb(36, 121, 108)"
15417,2020-04-07,Kazakhstan,1,139,670,"rgb(36, 121, 108)"
15418,2020-04-08,Kazakhstan,0,34,704,"rgb(36, 121, 108)"
15419,2020-04-09,Kazakhstan,1,55,759,"rgb(36, 121, 108)"
15420,2020-04-10,Kazakhstan,2,43,802,"rgb(36, 121, 108)"
15421,2020-04-11,Kazakhstan,1,38,840,"rgb(36, 121, 108)"
15422,2020-04-12,Kazakhstan,0,40,880,"rgb(36, 121, 108)"
15423,2020-04-13,Kazakhstan,0,81,961,"rgb(36, 121, 108)"
15424,2020-04-14,Kazakhstan,4,218,1179,"rgb(36, 121, 108)"
15425,2020-04-15,Kazakhstan,0,88,1267,"rgb(36, 121, 108)"
15426,2020-04-16,Kazakhstan,2,64,1331,"rgb(36, 121, 108)"
15427,2020-04-17,Kazakhstan,1,139,1470,"rgb(36, 121, 108)"
15428,2020-04-18,Kazakhstan,0,121,1591,"rgb(36, 121, 108)"
15429,2020-04-19,Kazakhstan,0,63,1654,"rgb(36, 121, 108)"
15430,2020-04-20,Kazakhstan,2,81,1735,"rgb(36, 121, 108)"
15431,2020-04-21,Kazakhstan,0,214,1949,"rgb(36, 121, 108)"
15432,2020-04-22,Kazakhstan,0,76,2025,"rgb(36, 121, 108)"
15433,2020-04-23,Kazakhstan,0,166,2191,"rgb(36, 121, 108)"
15434,2020-04-24,Kazakhstan,3,143,2334,"rgb(36, 121, 108)"
15435,2020-04-25,Kazakhstan,3,148,2482,"rgb(36, 121, 108)"
15436,2020-04-26,Kazakhstan,0,170,2652,"rgb(36, 121, 108)"
15437,2020-04-27,Kazakhstan,0,65,2717,"rgb(36, 121, 108)"
15438,2020-04-28,Kazakhstan,0,143,2860,"rgb(36, 121, 108)"
15439,2020-04-29,Kazakhstan,0,203,3063,"rgb(36, 121, 108)"
15440,2020-04-30,Kazakhstan,0,142,3205,"rgb(36, 121, 108)"
15441,2020-05-01,Kazakhstan,0,299,3504,"rgb(36, 121, 108)"
15442,2020-05-02,Kazakhstan,0,167,3671,"rgb(36, 121, 108)"
15443,2020-05-03,Kazakhstan,0,206,3877,"rgb(36, 121, 108)"
15444,2020-05-04,Kazakhstan,2,87,3964,"rgb(36, 121, 108)"
15445,2020-05-05,Kazakhstan,2,157,4121,"rgb(36, 121, 108)"
15446,2020-05-06,Kazakhstan,0,156,4277,"rgb(36, 121, 108)"
15447,2020-05-07,Kazakhstan,1,225,4502,"rgb(36, 121, 108)"
15448,2020-05-08,Kazakhstan,1,188,4690,"rgb(36, 121, 108)"
15449,2020-05-09,Kazakhstan,0,144,4834,"rgb(36, 121, 108)"
15450,2020-05-10,Kazakhstan,0,202,5036,"rgb(36, 121, 108)"
15451,2020-05-11,Kazakhstan,0,90,5126,"rgb(36, 121, 108)"
15452,2020-05-12,Kazakhstan,1,114,5240,"rgb(36, 121, 108)"
15453,2020-05-13,Kazakhstan,0,177,5417,"rgb(36, 121, 108)"
15454,2020-05-14,Kazakhstan,0,154,5571,"rgb(36, 121, 108)"
15455,2020-05-15,Kazakhstan,0,0,5571,"rgb(36, 121, 108)"
15456,2020-05-16,Kazakhstan,2,279,5850,"rgb(36, 121, 108)"
15457,2020-05-17,Kazakhstan,0,307,6157,"rgb(36, 121, 108)"
15458,2020-05-18,Kazakhstan,0,283,6440,"rgb(36, 121, 108)"
15459,2020-05-19,Kazakhstan,1,311,6751,"rgb(36, 121, 108)"
15460,2020-05-20,Kazakhstan,0,218,6969,"rgb(36, 121, 108)"
15461,2020-05-21,Kazakhstan,0,265,7234,"rgb(36, 121, 108)"
15462,2020-05-22,Kazakhstan,0,363,7597,"rgb(36, 121, 108)"
15463,2020-05-23,Kazakhstan,0,322,7919,"rgb(36, 121, 108)"
15464,2020-05-24,Kazakhstan,0,403,8322,"rgb(36, 121, 108)"
15465,2020-05-25,Kazakhstan,0,209,8531,"rgb(36, 121, 108)"
15466,2020-05-26,Kazakhstan,0,438,8969,"rgb(36, 121, 108)"
15467,2020-05-27,Kazakhstan,2,335,9304,"rgb(36, 121, 108)"
15468,2020-05-28,Kazakhstan,0,272,9576,"rgb(36, 121, 108)"
15469,2020-05-29,Kazakhstan,0,356,9932,"rgb(36, 121, 108)"
15470,2020-05-30,Kazakhstan,0,450,10382,"rgb(36, 121, 108)"
15471,2020-05-31,Kazakhstan,1,476,10858,"rgb(36, 121, 108)"
15472,2020-06-01,Kazakhstan,3,450,11308,"rgb(36, 121, 108)"
15473,2020-06-02,Kazakhstan,0,263,11571,"rgb(36, 121, 108)"
15474,2020-06-03,Kazakhstan,3,225,11796,"rgb(36, 121, 108)"
15475,2020-06-04,Kazakhstan,4,271,12067,"rgb(36, 121, 108)"
15476,2020-06-05,Kazakhstan,4,245,12312,"rgb(36, 121, 108)"
15477,2020-06-06,Kazakhstan,0,199,12511,"rgb(36, 121, 108)"
15478,2020-06-07,Kazakhstan,1,183,12694,"rgb(36, 121, 108)"
15479,2020-06-08,Kazakhstan,3,165,12859,"rgb(36, 121, 108)"
15480,2020-06-09,Kazakhstan,2,215,13074,"rgb(36, 121, 108)"
15481,2020-06-10,Kazakhstan,3,245,13319,"rgb(36, 121, 108)"
15482,2020-06-11,Kazakhstan,6,239,13558,"rgb(36, 121, 108)"
15483,2020-06-12,Kazakhstan,0,314,13872,"rgb(36, 121, 108)"
15484,2020-06-13,Kazakhstan,3,366,14238,"rgb(36, 121, 108)"
15485,2020-06-14,Kazakhstan,3,258,14496,"rgb(36, 121, 108)"
15486,2020-06-15,Kazakhstan,4,313,14809,"rgb(36, 121, 108)"
15487,2020-06-16,Kazakhstan,4,383,15192,"rgb(36, 121, 108)"
15488,2020-06-17,Kazakhstan,7,350,15542,"rgb(36, 121, 108)"
15489,2020-06-18,Kazakhstan,12,335,15877,"rgb(36, 121, 108)"
15490,2020-06-19,Kazakhstan,5,474,16351,"rgb(36, 121, 108)"
15491,2020-06-20,Kazakhstan,8,428,16779,"rgb(36, 121, 108)"
15492,2020-06-21,Kazakhstan,5,446,17225,"rgb(36, 121, 108)"
15493,2020-06-22,Kazakhstan,2,507,17732,"rgb(36, 121, 108)"
15494,2020-06-23,Kazakhstan,7,499,18231,"rgb(36, 121, 108)"
15495,2020-06-24,Kazakhstan,7,534,18765,"rgb(36, 121, 108)"
15496,2020-06-25,Kazakhstan,2,520,19285,"rgb(36, 121, 108)"
15497,2020-06-26,Kazakhstan,11,465,19750,"rgb(36, 121, 108)"
15498,2020-06-27,Kazakhstan,3,569,20319,"rgb(36, 121, 108)"
15499,2020-06-28,Kazakhstan,23,461,20780,"rgb(36, 121, 108)"
15500,2020-06-29,Kazakhstan,10,547,21327,"rgb(36, 121, 108)"
15501,2020-06-30,Kazakhstan,5,492,21819,"rgb(36, 121, 108)"
15502,2020-07-01,Kazakhstan,0,19246,41065,"rgb(36, 121, 108)"
15503,2020-07-02,Kazakhstan,0,1509,42574,"rgb(36, 121, 108)"
15504,2020-07-03,Kazakhstan,0,1501,44075,"rgb(36, 121, 108)"
15505,2020-07-04,Kazakhstan,0,1644,45719,"rgb(36, 121, 108)"
15506,2020-07-05,Kazakhstan,0,1452,47171,"rgb(36, 121, 108)"
15507,2020-07-06,Kazakhstan,0,1403,48574,"rgb(36, 121, 108)"
15508,2020-07-07,Kazakhstan,76,1109,49683,"rgb(36, 121, 108)"
15509,2020-07-08,Kazakhstan,0,1376,51059,"rgb(36, 121, 108)"
15510,2020-07-09,Kazakhstan,0,1962,53021,"rgb(36, 121, 108)"
15511,2020-07-10,Kazakhstan,0,1726,54747,"rgb(36, 121, 108)"
15512,2020-07-11,Kazakhstan,0,1708,56455,"rgb(36, 121, 108)"
15513,2020-07-12,Kazakhstan,0,1798,58253,"rgb(36, 121, 108)"
15514,2020-07-13,Kazakhstan,111,1636,59889,"rgb(36, 121, 108)"
15515,2020-03-25,Laos,0,2,2,"rgb(218, 165, 27)"
15516,2020-03-26,Laos,0,0,2,"rgb(218, 165, 27)"
15517,2020-03-27,Laos,0,4,6,"rgb(218, 165, 27)"
15518,2020-03-28,Laos,0,0,6,"rgb(218, 165, 27)"
15519,2020-03-29,Laos,0,0,6,"rgb(218, 165, 27)"
15520,2020-03-30,Laos,0,0,6,"rgb(218, 165, 27)"
15521,2020-03-31,Laos,0,3,9,"rgb(218, 165, 27)"
15522,2020-04-01,Laos,0,0,9,"rgb(218, 165, 27)"
15523,2020-04-02,Laos,0,1,10,"rgb(218, 165, 27)"
15524,2020-04-03,Laos,0,0,10,"rgb(218, 165, 27)"
15525,2020-04-04,Laos,0,0,10,"rgb(218, 165, 27)"
15526,2020-04-05,Laos,0,0,10,"rgb(218, 165, 27)"
15527,2020-04-06,Laos,0,1,11,"rgb(218, 165, 27)"
15528,2020-04-07,Laos,0,1,12,"rgb(218, 165, 27)"
15529,2020-04-08,Laos,0,0,12,"rgb(218, 165, 27)"
15530,2020-04-09,Laos,0,3,15,"rgb(218, 165, 27)"
15531,2020-04-10,Laos,0,1,16,"rgb(218, 165, 27)"
15532,2020-04-11,Laos,0,0,16,"rgb(218, 165, 27)"
15533,2020-04-12,Laos,0,2,18,"rgb(218, 165, 27)"
15534,2020-04-13,Laos,0,1,19,"rgb(218, 165, 27)"
15535,2020-04-14,Laos,0,0,19,"rgb(218, 165, 27)"
15536,2020-04-15,Laos,0,0,19,"rgb(218, 165, 27)"
15537,2020-04-16,Laos,0,0,19,"rgb(218, 165, 27)"
15538,2020-04-17,Laos,0,0,19,"rgb(218, 165, 27)"
15539,2020-04-18,Laos,0,0,19,"rgb(218, 165, 27)"
15540,2020-04-19,Laos,0,0,19,"rgb(218, 165, 27)"
15541,2020-04-20,Laos,0,0,19,"rgb(218, 165, 27)"
15542,2020-04-21,Laos,0,0,19,"rgb(218, 165, 27)"
15543,2020-04-22,Laos,0,0,19,"rgb(218, 165, 27)"
15544,2020-04-23,Laos,0,0,19,"rgb(218, 165, 27)"
15545,2020-04-24,Laos,0,0,19,"rgb(218, 165, 27)"
15546,2020-04-25,Laos,0,0,19,"rgb(218, 165, 27)"
15547,2020-04-26,Laos,0,0,19,"rgb(218, 165, 27)"
15548,2020-04-27,Laos,0,0,19,"rgb(218, 165, 27)"
15549,2020-04-28,Laos,0,0,19,"rgb(218, 165, 27)"
15550,2020-04-29,Laos,0,0,19,"rgb(218, 165, 27)"
15551,2020-04-30,Laos,0,0,19,"rgb(218, 165, 27)"
15552,2020-05-01,Laos,0,0,19,"rgb(218, 165, 27)"
15553,2020-05-02,Laos,0,0,19,"rgb(218, 165, 27)"
15554,2020-05-03,Laos,0,0,19,"rgb(218, 165, 27)"
15555,2020-05-04,Laos,0,0,19,"rgb(218, 165, 27)"
15556,2020-05-05,Laos,0,0,19,"rgb(218, 165, 27)"
15557,2020-05-06,Laos,0,0,19,"rgb(218, 165, 27)"
15558,2020-05-07,Laos,0,0,19,"rgb(218, 165, 27)"
15559,2020-05-08,Laos,0,0,19,"rgb(218, 165, 27)"
15560,2020-05-09,Laos,0,0,19,"rgb(218, 165, 27)"
15561,2020-05-10,Laos,0,0,19,"rgb(218, 165, 27)"
15562,2020-05-11,Laos,0,0,19,"rgb(218, 165, 27)"
15563,2020-05-12,Laos,0,0,19,"rgb(218, 165, 27)"
15564,2020-05-13,Laos,0,0,19,"rgb(218, 165, 27)"
15565,2020-05-14,Laos,0,0,19,"rgb(218, 165, 27)"
15566,2020-05-15,Laos,0,0,19,"rgb(218, 165, 27)"
15567,2020-05-16,Laos,0,0,19,"rgb(218, 165, 27)"
15568,2020-05-17,Laos,0,0,19,"rgb(218, 165, 27)"
15569,2020-05-18,Laos,0,0,19,"rgb(218, 165, 27)"
15570,2020-05-19,Laos,0,0,19,"rgb(218, 165, 27)"
15571,2020-05-20,Laos,0,0,19,"rgb(218, 165, 27)"
15572,2020-05-21,Laos,0,0,19,"rgb(218, 165, 27)"
15573,2020-05-22,Laos,0,0,19,"rgb(218, 165, 27)"
15574,2020-05-23,Laos,0,0,19,"rgb(218, 165, 27)"
15575,2020-05-24,Laos,0,0,19,"rgb(218, 165, 27)"
15576,2020-05-25,Laos,0,0,19,"rgb(218, 165, 27)"
15577,2020-05-26,Laos,0,0,19,"rgb(218, 165, 27)"
15578,2020-05-27,Laos,0,0,19,"rgb(218, 165, 27)"
15579,2020-05-28,Laos,0,0,19,"rgb(218, 165, 27)"
15580,2020-05-29,Laos,0,0,19,"rgb(218, 165, 27)"
15581,2020-05-30,Laos,0,0,19,"rgb(218, 165, 27)"
15582,2020-05-31,Laos,0,0,19,"rgb(218, 165, 27)"
15583,2020-06-01,Laos,0,0,19,"rgb(218, 165, 27)"
15584,2020-06-02,Laos,0,0,19,"rgb(218, 165, 27)"
15585,2020-06-03,Laos,0,0,19,"rgb(218, 165, 27)"
15586,2020-06-04,Laos,0,0,19,"rgb(218, 165, 27)"
15587,2020-06-05,Laos,0,0,19,"rgb(218, 165, 27)"
15588,2020-06-06,Laos,0,0,19,"rgb(218, 165, 27)"
15589,2020-06-07,Laos,0,0,19,"rgb(218, 165, 27)"
15590,2020-06-08,Laos,0,0,19,"rgb(218, 165, 27)"
15591,2020-06-09,Laos,0,0,19,"rgb(218, 165, 27)"
15592,2020-06-10,Laos,0,0,19,"rgb(218, 165, 27)"
15593,2020-06-11,Laos,0,0,19,"rgb(218, 165, 27)"
15594,2020-06-12,Laos,0,0,19,"rgb(218, 165, 27)"
15595,2020-06-13,Laos,0,0,19,"rgb(218, 165, 27)"
15596,2020-06-14,Laos,0,0,19,"rgb(218, 165, 27)"
15597,2020-06-15,Laos,0,0,19,"rgb(218, 165, 27)"
15598,2020-06-16,Laos,0,0,19,"rgb(218, 165, 27)"
15599,2020-06-17,Laos,0,0,19,"rgb(218, 165, 27)"
15600,2020-06-18,Laos,0,0,19,"rgb(218, 165, 27)"
15601,2020-06-19,Laos,0,0,19,"rgb(218, 165, 27)"
15602,2020-06-20,Laos,0,0,19,"rgb(218, 165, 27)"
15603,2020-06-21,Laos,0,0,19,"rgb(218, 165, 27)"
15604,2020-06-22,Laos,0,0,19,"rgb(218, 165, 27)"
15605,2020-06-23,Laos,0,0,19,"rgb(218, 165, 27)"
15606,2020-06-24,Laos,0,0,19,"rgb(218, 165, 27)"
15607,2020-06-25,Laos,0,0,19,"rgb(218, 165, 27)"
15608,2020-06-26,Laos,0,0,19,"rgb(218, 165, 27)"
15609,2020-06-27,Laos,0,0,19,"rgb(218, 165, 27)"
15610,2020-06-28,Laos,0,0,19,"rgb(218, 165, 27)"
15611,2020-06-29,Laos,0,0,19,"rgb(218, 165, 27)"
15612,2020-06-30,Laos,0,0,19,"rgb(218, 165, 27)"
15613,2020-07-01,Laos,0,0,19,"rgb(218, 165, 27)"
15614,2020-07-02,Laos,0,0,19,"rgb(218, 165, 27)"
15615,2020-07-03,Laos,0,0,19,"rgb(218, 165, 27)"
15616,2020-07-04,Laos,0,0,19,"rgb(218, 165, 27)"
15617,2020-07-05,Laos,0,0,19,"rgb(218, 165, 27)"
15618,2020-07-06,Laos,0,0,19,"rgb(218, 165, 27)"
15619,2020-07-07,Laos,0,0,19,"rgb(218, 165, 27)"
15620,2020-07-08,Laos,0,0,19,"rgb(218, 165, 27)"
15621,2020-07-09,Laos,0,0,19,"rgb(218, 165, 27)"
15622,2020-07-10,Laos,0,0,19,"rgb(218, 165, 27)"
15623,2020-07-11,Laos,0,0,19,"rgb(218, 165, 27)"
15624,2020-07-12,Laos,0,0,19,"rgb(218, 165, 27)"
15625,2020-07-13,Laos,0,0,19,"rgb(218, 165, 27)"
15626,2019-12-31,Lebanon,0,0,0,"rgb(47, 138, 196)"
15627,2020-01-01,Lebanon,0,0,0,"rgb(47, 138, 196)"
15628,2020-01-02,Lebanon,0,0,0,"rgb(47, 138, 196)"
15629,2020-01-03,Lebanon,0,0,0,"rgb(47, 138, 196)"
15630,2020-01-04,Lebanon,0,0,0,"rgb(47, 138, 196)"
15631,2020-01-05,Lebanon,0,0,0,"rgb(47, 138, 196)"
15632,2020-01-06,Lebanon,0,0,0,"rgb(47, 138, 196)"
15633,2020-01-07,Lebanon,0,0,0,"rgb(47, 138, 196)"
15634,2020-01-08,Lebanon,0,0,0,"rgb(47, 138, 196)"
15635,2020-01-09,Lebanon,0,0,0,"rgb(47, 138, 196)"
15636,2020-01-10,Lebanon,0,0,0,"rgb(47, 138, 196)"
15637,2020-01-11,Lebanon,0,0,0,"rgb(47, 138, 196)"
15638,2020-01-12,Lebanon,0,0,0,"rgb(47, 138, 196)"
15639,2020-01-13,Lebanon,0,0,0,"rgb(47, 138, 196)"
15640,2020-01-14,Lebanon,0,0,0,"rgb(47, 138, 196)"
15641,2020-01-15,Lebanon,0,0,0,"rgb(47, 138, 196)"
15642,2020-01-16,Lebanon,0,0,0,"rgb(47, 138, 196)"
15643,2020-01-17,Lebanon,0,0,0,"rgb(47, 138, 196)"
15644,2020-01-18,Lebanon,0,0,0,"rgb(47, 138, 196)"
15645,2020-01-19,Lebanon,0,0,0,"rgb(47, 138, 196)"
15646,2020-01-20,Lebanon,0,0,0,"rgb(47, 138, 196)"
15647,2020-01-21,Lebanon,0,0,0,"rgb(47, 138, 196)"
15648,2020-01-22,Lebanon,0,0,0,"rgb(47, 138, 196)"
15649,2020-01-23,Lebanon,0,0,0,"rgb(47, 138, 196)"
15650,2020-01-24,Lebanon,0,0,0,"rgb(47, 138, 196)"
15651,2020-01-25,Lebanon,0,0,0,"rgb(47, 138, 196)"
15652,2020-01-26,Lebanon,0,0,0,"rgb(47, 138, 196)"
15653,2020-01-27,Lebanon,0,0,0,"rgb(47, 138, 196)"
15654,2020-01-28,Lebanon,0,0,0,"rgb(47, 138, 196)"
15655,2020-01-29,Lebanon,0,0,0,"rgb(47, 138, 196)"
15656,2020-01-30,Lebanon,0,0,0,"rgb(47, 138, 196)"
15657,2020-01-31,Lebanon,0,0,0,"rgb(47, 138, 196)"
15658,2020-02-01,Lebanon,0,0,0,"rgb(47, 138, 196)"
15659,2020-02-02,Lebanon,0,0,0,"rgb(47, 138, 196)"
15660,2020-02-03,Lebanon,0,0,0,"rgb(47, 138, 196)"
15661,2020-02-04,Lebanon,0,0,0,"rgb(47, 138, 196)"
15662,2020-02-05,Lebanon,0,0,0,"rgb(47, 138, 196)"
15663,2020-02-06,Lebanon,0,0,0,"rgb(47, 138, 196)"
15664,2020-02-07,Lebanon,0,0,0,"rgb(47, 138, 196)"
15665,2020-02-08,Lebanon,0,0,0,"rgb(47, 138, 196)"
15666,2020-02-09,Lebanon,0,0,0,"rgb(47, 138, 196)"
15667,2020-02-10,Lebanon,0,0,0,"rgb(47, 138, 196)"
15668,2020-02-11,Lebanon,0,0,0,"rgb(47, 138, 196)"
15669,2020-02-12,Lebanon,0,0,0,"rgb(47, 138, 196)"
15670,2020-02-13,Lebanon,0,0,0,"rgb(47, 138, 196)"
15671,2020-02-14,Lebanon,0,0,0,"rgb(47, 138, 196)"
15672,2020-02-15,Lebanon,0,0,0,"rgb(47, 138, 196)"
15673,2020-02-16,Lebanon,0,0,0,"rgb(47, 138, 196)"
15674,2020-02-17,Lebanon,0,0,0,"rgb(47, 138, 196)"
15675,2020-02-18,Lebanon,0,0,0,"rgb(47, 138, 196)"
15676,2020-02-19,Lebanon,0,0,0,"rgb(47, 138, 196)"
15677,2020-02-20,Lebanon,0,0,0,"rgb(47, 138, 196)"
15678,2020-02-21,Lebanon,0,0,0,"rgb(47, 138, 196)"
15679,2020-02-22,Lebanon,0,1,1,"rgb(47, 138, 196)"
15680,2020-02-23,Lebanon,0,0,1,"rgb(47, 138, 196)"
15681,2020-02-24,Lebanon,0,0,1,"rgb(47, 138, 196)"
15682,2020-02-25,Lebanon,0,0,1,"rgb(47, 138, 196)"
15683,2020-02-26,Lebanon,0,0,1,"rgb(47, 138, 196)"
15684,2020-02-27,Lebanon,0,1,2,"rgb(47, 138, 196)"
15685,2020-02-28,Lebanon,0,1,3,"rgb(47, 138, 196)"
15686,2020-02-29,Lebanon,0,0,3,"rgb(47, 138, 196)"
15687,2020-03-01,Lebanon,0,1,4,"rgb(47, 138, 196)"
15688,2020-03-02,Lebanon,0,6,10,"rgb(47, 138, 196)"
15689,2020-03-03,Lebanon,0,3,13,"rgb(47, 138, 196)"
15690,2020-03-06,Lebanon,0,3,16,"rgb(47, 138, 196)"
15691,2020-03-07,Lebanon,0,6,22,"rgb(47, 138, 196)"
15692,2020-03-09,Lebanon,0,10,32,"rgb(47, 138, 196)"
15693,2020-03-10,Lebanon,0,9,41,"rgb(47, 138, 196)"
15694,2020-03-11,Lebanon,1,0,41,"rgb(47, 138, 196)"
15695,2020-03-12,Lebanon,1,20,61,"rgb(47, 138, 196)"
15696,2020-03-13,Lebanon,0,5,66,"rgb(47, 138, 196)"
15697,2020-03-15,Lebanon,1,27,93,"rgb(47, 138, 196)"
15698,2020-03-16,Lebanon,0,6,99,"rgb(47, 138, 196)"
15699,2020-03-17,Lebanon,0,21,120,"rgb(47, 138, 196)"
15700,2020-03-18,Lebanon,0,0,120,"rgb(47, 138, 196)"
15701,2020-03-19,Lebanon,1,13,133,"rgb(47, 138, 196)"
15702,2020-03-20,Lebanon,0,16,149,"rgb(47, 138, 196)"
15703,2020-03-21,Lebanon,0,14,163,"rgb(47, 138, 196)"
15704,2020-03-22,Lebanon,0,67,230,"rgb(47, 138, 196)"
15705,2020-03-23,Lebanon,0,18,248,"rgb(47, 138, 196)"
15706,2020-03-24,Lebanon,0,19,267,"rgb(47, 138, 196)"
15707,2020-03-25,Lebanon,0,37,304,"rgb(47, 138, 196)"
15708,2020-03-26,Lebanon,0,29,333,"rgb(47, 138, 196)"
15709,2020-03-27,Lebanon,2,35,368,"rgb(47, 138, 196)"
15710,2020-03-28,Lebanon,1,23,391,"rgb(47, 138, 196)"
15711,2020-03-29,Lebanon,1,21,412,"rgb(47, 138, 196)"
15712,2020-03-30,Lebanon,2,26,438,"rgb(47, 138, 196)"
15713,2020-03-31,Lebanon,1,8,446,"rgb(47, 138, 196)"
15714,2020-04-01,Lebanon,1,17,463,"rgb(47, 138, 196)"
15715,2020-04-02,Lebanon,0,16,479,"rgb(47, 138, 196)"
15716,2020-04-03,Lebanon,4,15,494,"rgb(47, 138, 196)"
15717,2020-04-04,Lebanon,0,0,494,"rgb(47, 138, 196)"
15718,2020-04-05,Lebanon,1,26,520,"rgb(47, 138, 196)"
15719,2020-04-06,Lebanon,1,7,527,"rgb(47, 138, 196)"
15720,2020-04-07,Lebanon,1,14,541,"rgb(47, 138, 196)"
15721,2020-04-08,Lebanon,0,7,548,"rgb(47, 138, 196)"
15722,2020-04-09,Lebanon,0,27,575,"rgb(47, 138, 196)"
15723,2020-04-10,Lebanon,0,7,582,"rgb(47, 138, 196)"
15724,2020-04-11,Lebanon,1,27,609,"rgb(47, 138, 196)"
15725,2020-04-12,Lebanon,0,10,619,"rgb(47, 138, 196)"
15726,2020-04-13,Lebanon,0,11,630,"rgb(47, 138, 196)"
15727,2020-04-14,Lebanon,0,2,632,"rgb(47, 138, 196)"
15728,2020-04-15,Lebanon,1,9,641,"rgb(47, 138, 196)"
15729,2020-04-16,Lebanon,0,17,658,"rgb(47, 138, 196)"
15730,2020-04-17,Lebanon,0,5,663,"rgb(47, 138, 196)"
15731,2020-04-18,Lebanon,0,5,668,"rgb(47, 138, 196)"
15732,2020-04-19,Lebanon,0,4,672,"rgb(47, 138, 196)"
15733,2020-04-20,Lebanon,0,1,673,"rgb(47, 138, 196)"
15734,2020-04-21,Lebanon,0,4,677,"rgb(47, 138, 196)"
15735,2020-04-22,Lebanon,0,0,677,"rgb(47, 138, 196)"
15736,2020-04-23,Lebanon,1,5,682,"rgb(47, 138, 196)"
15737,2020-04-24,Lebanon,0,6,688,"rgb(47, 138, 196)"
15738,2020-04-25,Lebanon,0,8,696,"rgb(47, 138, 196)"
15739,2020-04-26,Lebanon,2,8,704,"rgb(47, 138, 196)"
15740,2020-04-27,Lebanon,0,3,707,"rgb(47, 138, 196)"
15741,2020-04-28,Lebanon,0,3,710,"rgb(47, 138, 196)"
15742,2020-04-29,Lebanon,0,7,717,"rgb(47, 138, 196)"
15743,2020-04-30,Lebanon,0,4,721,"rgb(47, 138, 196)"
15744,2020-05-01,Lebanon,0,4,725,"rgb(47, 138, 196)"
15745,2020-05-02,Lebanon,0,4,729,"rgb(47, 138, 196)"
15746,2020-05-03,Lebanon,1,4,733,"rgb(47, 138, 196)"
15747,2020-05-04,Lebanon,0,4,737,"rgb(47, 138, 196)"
15748,2020-05-05,Lebanon,0,3,740,"rgb(47, 138, 196)"
15749,2020-05-06,Lebanon,0,1,741,"rgb(47, 138, 196)"
15750,2020-05-07,Lebanon,0,9,750,"rgb(47, 138, 196)"
15751,2020-05-08,Lebanon,0,34,784,"rgb(47, 138, 196)"
15752,2020-05-09,Lebanon,1,12,796,"rgb(47, 138, 196)"
15753,2020-05-10,Lebanon,0,13,809,"rgb(47, 138, 196)"
15754,2020-05-11,Lebanon,0,36,845,"rgb(47, 138, 196)"
15755,2020-05-12,Lebanon,0,14,859,"rgb(47, 138, 196)"
15756,2020-05-13,Lebanon,0,11,870,"rgb(47, 138, 196)"
15757,2020-05-14,Lebanon,0,8,878,"rgb(47, 138, 196)"
15758,2020-05-15,Lebanon,0,8,886,"rgb(47, 138, 196)"
15759,2020-05-16,Lebanon,0,5,891,"rgb(47, 138, 196)"
15760,2020-05-17,Lebanon,0,11,902,"rgb(47, 138, 196)"
15761,2020-05-18,Lebanon,0,9,911,"rgb(47, 138, 196)"
15762,2020-05-19,Lebanon,0,20,931,"rgb(47, 138, 196)"
15763,2020-05-20,Lebanon,0,23,954,"rgb(47, 138, 196)"
15764,2020-05-21,Lebanon,0,7,961,"rgb(47, 138, 196)"
15765,2020-05-22,Lebanon,0,63,1024,"rgb(47, 138, 196)"
15766,2020-05-23,Lebanon,0,62,1086,"rgb(47, 138, 196)"
15767,2020-05-24,Lebanon,0,11,1097,"rgb(47, 138, 196)"
15768,2020-05-25,Lebanon,0,17,1114,"rgb(47, 138, 196)"
15769,2020-05-26,Lebanon,0,5,1119,"rgb(47, 138, 196)"
15770,2020-05-27,Lebanon,0,21,1140,"rgb(47, 138, 196)"
15771,2020-05-28,Lebanon,0,21,1161,"rgb(47, 138, 196)"
15772,2020-05-29,Lebanon,0,7,1168,"rgb(47, 138, 196)"
15773,2020-05-30,Lebanon,0,4,1172,"rgb(47, 138, 196)"
15774,2020-05-31,Lebanon,0,19,1191,"rgb(47, 138, 196)"
15775,2020-06-01,Lebanon,1,29,1220,"rgb(47, 138, 196)"
15776,2020-06-02,Lebanon,0,13,1233,"rgb(47, 138, 196)"
15777,2020-06-03,Lebanon,0,9,1242,"rgb(47, 138, 196)"
15778,2020-06-04,Lebanon,0,14,1256,"rgb(47, 138, 196)"
15779,2020-06-05,Lebanon,1,50,1306,"rgb(47, 138, 196)"
15780,2020-06-06,Lebanon,0,6,1312,"rgb(47, 138, 196)"
15781,2020-06-07,Lebanon,1,8,1320,"rgb(47, 138, 196)"
15782,2020-06-08,Lebanon,1,11,1331,"rgb(47, 138, 196)"
15783,2020-06-09,Lebanon,0,19,1350,"rgb(47, 138, 196)"
15784,2020-06-10,Lebanon,0,18,1368,"rgb(47, 138, 196)"
15785,2020-06-11,Lebanon,0,20,1388,"rgb(47, 138, 196)"
15786,2020-06-12,Lebanon,1,14,1402,"rgb(47, 138, 196)"
15787,2020-06-13,Lebanon,0,20,1422,"rgb(47, 138, 196)"
15788,2020-06-14,Lebanon,1,20,1442,"rgb(47, 138, 196)"
15789,2020-06-15,Lebanon,0,4,1446,"rgb(47, 138, 196)"
15790,2020-06-16,Lebanon,0,18,1464,"rgb(47, 138, 196)"
15791,2020-06-17,Lebanon,0,9,1473,"rgb(47, 138, 196)"
15792,2020-06-18,Lebanon,0,16,1489,"rgb(47, 138, 196)"
15793,2020-06-19,Lebanon,0,6,1495,"rgb(47, 138, 196)"
15794,2020-06-20,Lebanon,0,15,1510,"rgb(47, 138, 196)"
15795,2020-06-21,Lebanon,0,26,1536,"rgb(47, 138, 196)"
15796,2020-06-22,Lebanon,0,51,1587,"rgb(47, 138, 196)"
15797,2020-06-23,Lebanon,0,16,1603,"rgb(47, 138, 196)"
15798,2020-06-24,Lebanon,0,19,1622,"rgb(47, 138, 196)"
15799,2020-06-25,Lebanon,1,22,1644,"rgb(47, 138, 196)"
15800,2020-06-26,Lebanon,0,18,1662,"rgb(47, 138, 196)"
15801,2020-06-27,Lebanon,0,35,1697,"rgb(47, 138, 196)"
15802,2020-06-28,Lebanon,0,22,1719,"rgb(47, 138, 196)"
15803,2020-06-29,Lebanon,1,21,1740,"rgb(47, 138, 196)"
15804,2020-06-30,Lebanon,0,5,1745,"rgb(47, 138, 196)"
15805,2020-07-01,Lebanon,0,33,1778,"rgb(47, 138, 196)"
15806,2020-07-02,Lebanon,0,10,1788,"rgb(47, 138, 196)"
15807,2020-07-03,Lebanon,1,8,1796,"rgb(47, 138, 196)"
15808,2020-07-04,Lebanon,0,34,1830,"rgb(47, 138, 196)"
15809,2020-07-05,Lebanon,0,25,1855,"rgb(47, 138, 196)"
15810,2020-07-06,Lebanon,1,18,1873,"rgb(47, 138, 196)"
15811,2020-07-07,Lebanon,0,12,1885,"rgb(47, 138, 196)"
15812,2020-07-08,Lebanon,0,22,1907,"rgb(47, 138, 196)"
15813,2020-07-09,Lebanon,0,39,1946,"rgb(47, 138, 196)"
15814,2020-07-10,Lebanon,0,65,2011,"rgb(47, 138, 196)"
15815,2020-07-11,Lebanon,0,71,2082,"rgb(47, 138, 196)"
15816,2020-07-12,Lebanon,0,86,2168,"rgb(47, 138, 196)"
15817,2020-07-13,Lebanon,0,166,2334,"rgb(47, 138, 196)"
15818,2020-03-15,Saint Lucia,0,2,2,"rgb(118, 78, 159)"
15819,2020-03-16,Saint Lucia,0,0,2,"rgb(118, 78, 159)"
15820,2020-03-17,Saint Lucia,0,0,2,"rgb(118, 78, 159)"
15821,2020-03-18,Saint Lucia,0,0,2,"rgb(118, 78, 159)"
15822,2020-03-19,Saint Lucia,0,0,2,"rgb(118, 78, 159)"
15823,2020-03-20,Saint Lucia,0,0,2,"rgb(118, 78, 159)"
15824,2020-03-21,Saint Lucia,0,0,2,"rgb(118, 78, 159)"
15825,2020-03-22,Saint Lucia,0,0,2,"rgb(118, 78, 159)"
15826,2020-03-23,Saint Lucia,0,0,2,"rgb(118, 78, 159)"
15827,2020-03-24,Saint Lucia,0,0,2,"rgb(118, 78, 159)"
15828,2020-03-25,Saint Lucia,0,0,2,"rgb(118, 78, 159)"
15829,2020-03-26,Saint Lucia,0,1,3,"rgb(118, 78, 159)"
15830,2020-03-27,Saint Lucia,0,0,3,"rgb(118, 78, 159)"
15831,2020-03-28,Saint Lucia,0,0,3,"rgb(118, 78, 159)"
15832,2020-03-29,Saint Lucia,0,1,4,"rgb(118, 78, 159)"
15833,2020-03-30,Saint Lucia,0,5,9,"rgb(118, 78, 159)"
15834,2020-03-31,Saint Lucia,0,0,9,"rgb(118, 78, 159)"
15835,2020-04-01,Saint Lucia,0,4,13,"rgb(118, 78, 159)"
15836,2020-04-02,Saint Lucia,0,0,13,"rgb(118, 78, 159)"
15837,2020-04-03,Saint Lucia,0,0,13,"rgb(118, 78, 159)"
15838,2020-04-04,Saint Lucia,0,0,13,"rgb(118, 78, 159)"
15839,2020-04-05,Saint Lucia,0,1,14,"rgb(118, 78, 159)"
15840,2020-04-06,Saint Lucia,0,0,14,"rgb(118, 78, 159)"
15841,2020-04-07,Saint Lucia,0,0,14,"rgb(118, 78, 159)"
15842,2020-04-08,Saint Lucia,0,0,14,"rgb(118, 78, 159)"
15843,2020-04-09,Saint Lucia,0,0,14,"rgb(118, 78, 159)"
15844,2020-04-10,Saint Lucia,0,0,14,"rgb(118, 78, 159)"
15845,2020-04-11,Saint Lucia,0,1,15,"rgb(118, 78, 159)"
15846,2020-04-12,Saint Lucia,0,0,15,"rgb(118, 78, 159)"
15847,2020-04-13,Saint Lucia,0,0,15,"rgb(118, 78, 159)"
15848,2020-04-14,Saint Lucia,0,0,15,"rgb(118, 78, 159)"
15849,2020-04-15,Saint Lucia,0,0,15,"rgb(118, 78, 159)"
15850,2020-04-16,Saint Lucia,0,0,15,"rgb(118, 78, 159)"
15851,2020-04-17,Saint Lucia,0,0,15,"rgb(118, 78, 159)"
15852,2020-04-18,Saint Lucia,0,0,15,"rgb(118, 78, 159)"
15853,2020-04-19,Saint Lucia,0,0,15,"rgb(118, 78, 159)"
15854,2020-04-20,Saint Lucia,0,0,15,"rgb(118, 78, 159)"
15855,2020-04-21,Saint Lucia,0,0,15,"rgb(118, 78, 159)"
15856,2020-04-22,Saint Lucia,0,0,15,"rgb(118, 78, 159)"
15857,2020-04-23,Saint Lucia,0,0,15,"rgb(118, 78, 159)"
15858,2020-04-24,Saint Lucia,0,0,15,"rgb(118, 78, 159)"
15859,2020-04-25,Saint Lucia,0,0,15,"rgb(118, 78, 159)"
15860,2020-04-26,Saint Lucia,0,0,15,"rgb(118, 78, 159)"
15861,2020-04-27,Saint Lucia,0,0,15,"rgb(118, 78, 159)"
15862,2020-04-28,Saint Lucia,0,0,15,"rgb(118, 78, 159)"
15863,2020-04-29,Saint Lucia,0,0,15,"rgb(118, 78, 159)"
15864,2020-04-30,Saint Lucia,0,2,17,"rgb(118, 78, 159)"
15865,2020-05-01,Saint Lucia,0,0,17,"rgb(118, 78, 159)"
15866,2020-05-02,Saint Lucia,0,0,17,"rgb(118, 78, 159)"
15867,2020-05-03,Saint Lucia,0,0,17,"rgb(118, 78, 159)"
15868,2020-05-04,Saint Lucia,0,1,18,"rgb(118, 78, 159)"
15869,2020-05-05,Saint Lucia,0,0,18,"rgb(118, 78, 159)"
15870,2020-05-06,Saint Lucia,0,0,18,"rgb(118, 78, 159)"
15871,2020-05-07,Saint Lucia,0,0,18,"rgb(118, 78, 159)"
15872,2020-05-08,Saint Lucia,0,0,18,"rgb(118, 78, 159)"
15873,2020-05-09,Saint Lucia,0,0,18,"rgb(118, 78, 159)"
15874,2020-05-10,Saint Lucia,0,0,18,"rgb(118, 78, 159)"
15875,2020-05-11,Saint Lucia,0,0,18,"rgb(118, 78, 159)"
15876,2020-05-12,Saint Lucia,0,0,18,"rgb(118, 78, 159)"
15877,2020-05-13,Saint Lucia,0,0,18,"rgb(118, 78, 159)"
15878,2020-05-14,Saint Lucia,0,0,18,"rgb(118, 78, 159)"
15879,2020-05-15,Saint Lucia,0,0,18,"rgb(118, 78, 159)"
15880,2020-05-16,Saint Lucia,0,0,18,"rgb(118, 78, 159)"
15881,2020-05-17,Saint Lucia,0,0,18,"rgb(118, 78, 159)"
15882,2020-05-18,Saint Lucia,0,0,18,"rgb(118, 78, 159)"
15883,2020-05-19,Saint Lucia,0,0,18,"rgb(118, 78, 159)"
15884,2020-05-20,Saint Lucia,0,0,18,"rgb(118, 78, 159)"
15885,2020-05-21,Saint Lucia,0,0,18,"rgb(118, 78, 159)"
15886,2020-05-22,Saint Lucia,0,0,18,"rgb(118, 78, 159)"
15887,2020-05-23,Saint Lucia,0,0,18,"rgb(118, 78, 159)"
15888,2020-05-24,Saint Lucia,0,0,18,"rgb(118, 78, 159)"
15889,2020-05-25,Saint Lucia,0,0,18,"rgb(118, 78, 159)"
15890,2020-05-26,Saint Lucia,0,0,18,"rgb(118, 78, 159)"
15891,2020-05-27,Saint Lucia,0,0,18,"rgb(118, 78, 159)"
15892,2020-05-28,Saint Lucia,0,0,18,"rgb(118, 78, 159)"
15893,2020-05-29,Saint Lucia,0,0,18,"rgb(118, 78, 159)"
15894,2020-05-30,Saint Lucia,0,0,18,"rgb(118, 78, 159)"
15895,2020-05-31,Saint Lucia,0,0,18,"rgb(118, 78, 159)"
15896,2020-06-01,Saint Lucia,0,0,18,"rgb(118, 78, 159)"
15897,2020-06-02,Saint Lucia,0,0,18,"rgb(118, 78, 159)"
15898,2020-06-03,Saint Lucia,0,0,18,"rgb(118, 78, 159)"
15899,2020-06-04,Saint Lucia,0,0,18,"rgb(118, 78, 159)"
15900,2020-06-05,Saint Lucia,0,1,19,"rgb(118, 78, 159)"
15901,2020-06-06,Saint Lucia,0,0,19,"rgb(118, 78, 159)"
15902,2020-06-07,Saint Lucia,0,0,19,"rgb(118, 78, 159)"
15903,2020-06-08,Saint Lucia,0,0,19,"rgb(118, 78, 159)"
15904,2020-06-09,Saint Lucia,0,0,19,"rgb(118, 78, 159)"
15905,2020-06-10,Saint Lucia,0,0,19,"rgb(118, 78, 159)"
15906,2020-06-11,Saint Lucia,0,0,19,"rgb(118, 78, 159)"
15907,2020-06-12,Saint Lucia,0,0,19,"rgb(118, 78, 159)"
15908,2020-06-13,Saint Lucia,0,0,19,"rgb(118, 78, 159)"
15909,2020-06-14,Saint Lucia,0,0,19,"rgb(118, 78, 159)"
15910,2020-06-15,Saint Lucia,0,0,19,"rgb(118, 78, 159)"
15911,2020-06-16,Saint Lucia,0,0,19,"rgb(118, 78, 159)"
15912,2020-06-17,Saint Lucia,0,0,19,"rgb(118, 78, 159)"
15913,2020-06-18,Saint Lucia,0,0,19,"rgb(118, 78, 159)"
15914,2020-06-19,Saint Lucia,0,0,19,"rgb(118, 78, 159)"
15915,2020-06-20,Saint Lucia,0,0,19,"rgb(118, 78, 159)"
15916,2020-06-21,Saint Lucia,0,0,19,"rgb(118, 78, 159)"
15917,2020-06-22,Saint Lucia,0,0,19,"rgb(118, 78, 159)"
15918,2020-06-23,Saint Lucia,0,0,19,"rgb(118, 78, 159)"
15919,2020-06-24,Saint Lucia,0,0,19,"rgb(118, 78, 159)"
15920,2020-06-25,Saint Lucia,0,0,19,"rgb(118, 78, 159)"
15921,2020-06-26,Saint Lucia,0,0,19,"rgb(118, 78, 159)"
15922,2020-06-27,Saint Lucia,0,0,19,"rgb(118, 78, 159)"
15923,2020-06-28,Saint Lucia,0,0,19,"rgb(118, 78, 159)"
15924,2020-06-29,Saint Lucia,0,0,19,"rgb(118, 78, 159)"
15925,2020-06-30,Saint Lucia,0,0,19,"rgb(118, 78, 159)"
15926,2020-07-01,Saint Lucia,0,0,19,"rgb(118, 78, 159)"
15927,2020-07-02,Saint Lucia,0,0,19,"rgb(118, 78, 159)"
15928,2020-07-03,Saint Lucia,0,3,22,"rgb(118, 78, 159)"
15929,2020-07-04,Saint Lucia,0,0,22,"rgb(118, 78, 159)"
15930,2020-07-05,Saint Lucia,0,0,22,"rgb(118, 78, 159)"
15931,2020-07-06,Saint Lucia,0,0,22,"rgb(118, 78, 159)"
15932,2020-07-07,Saint Lucia,0,0,22,"rgb(118, 78, 159)"
15933,2020-07-08,Saint Lucia,0,0,22,"rgb(118, 78, 159)"
15934,2020-07-09,Saint Lucia,0,0,22,"rgb(118, 78, 159)"
15935,2020-07-10,Saint Lucia,0,0,22,"rgb(118, 78, 159)"
15936,2020-07-11,Saint Lucia,0,0,22,"rgb(118, 78, 159)"
15937,2020-07-12,Saint Lucia,0,0,22,"rgb(118, 78, 159)"
15938,2020-07-13,Saint Lucia,0,0,22,"rgb(118, 78, 159)"
15939,2020-03-05,Liechtenstein,0,1,1,"rgb(237, 100, 90)"
15940,2020-03-12,Liechtenstein,0,2,3,"rgb(237, 100, 90)"
15941,2020-03-13,Liechtenstein,0,1,4,"rgb(237, 100, 90)"
15942,2020-03-14,Liechtenstein,0,0,4,"rgb(237, 100, 90)"
15943,2020-03-15,Liechtenstein,0,0,4,"rgb(237, 100, 90)"
15944,2020-03-16,Liechtenstein,0,3,7,"rgb(237, 100, 90)"
15945,2020-03-17,Liechtenstein,0,0,7,"rgb(237, 100, 90)"
15946,2020-03-18,Liechtenstein,0,0,7,"rgb(237, 100, 90)"
15947,2020-03-19,Liechtenstein,0,18,25,"rgb(237, 100, 90)"
15948,2020-03-20,Liechtenstein,0,0,25,"rgb(237, 100, 90)"
15949,2020-03-21,Liechtenstein,0,9,34,"rgb(237, 100, 90)"
15950,2020-03-22,Liechtenstein,0,2,36,"rgb(237, 100, 90)"
15951,2020-03-23,Liechtenstein,0,10,46,"rgb(237, 100, 90)"
15952,2020-03-24,Liechtenstein,0,0,46,"rgb(237, 100, 90)"
15953,2020-03-25,Liechtenstein,0,1,47,"rgb(237, 100, 90)"
15954,2020-03-26,Liechtenstein,0,4,51,"rgb(237, 100, 90)"
15955,2020-03-27,Liechtenstein,0,5,56,"rgb(237, 100, 90)"
15956,2020-03-28,Liechtenstein,0,4,60,"rgb(237, 100, 90)"
15957,2020-03-29,Liechtenstein,0,1,61,"rgb(237, 100, 90)"
15958,2020-03-30,Liechtenstein,0,1,62,"rgb(237, 100, 90)"
15959,2020-03-31,Liechtenstein,0,2,64,"rgb(237, 100, 90)"
15960,2020-04-01,Liechtenstein,0,4,68,"rgb(237, 100, 90)"
15961,2020-04-02,Liechtenstein,0,4,72,"rgb(237, 100, 90)"
15962,2020-04-03,Liechtenstein,0,3,75,"rgb(237, 100, 90)"
15963,2020-04-04,Liechtenstein,0,0,75,"rgb(237, 100, 90)"
15964,2020-04-05,Liechtenstein,1,2,77,"rgb(237, 100, 90)"
15965,2020-04-06,Liechtenstein,0,1,78,"rgb(237, 100, 90)"
15966,2020-04-07,Liechtenstein,0,0,78,"rgb(237, 100, 90)"
15967,2020-04-08,Liechtenstein,0,0,78,"rgb(237, 100, 90)"
15968,2020-04-09,Liechtenstein,0,1,79,"rgb(237, 100, 90)"
15969,2020-04-10,Liechtenstein,0,0,79,"rgb(237, 100, 90)"
15970,2020-04-11,Liechtenstein,0,1,80,"rgb(237, 100, 90)"
15971,2020-04-12,Liechtenstein,0,0,80,"rgb(237, 100, 90)"
15972,2020-04-13,Liechtenstein,0,0,80,"rgb(237, 100, 90)"
15973,2020-04-14,Liechtenstein,0,1,81,"rgb(237, 100, 90)"
15974,2020-04-15,Liechtenstein,0,0,81,"rgb(237, 100, 90)"
15975,2020-04-16,Liechtenstein,0,0,81,"rgb(237, 100, 90)"
15976,2020-04-17,Liechtenstein,0,0,81,"rgb(237, 100, 90)"
15977,2020-04-18,Liechtenstein,0,0,81,"rgb(237, 100, 90)"
15978,2020-04-19,Liechtenstein,0,1,82,"rgb(237, 100, 90)"
15979,2020-04-20,Liechtenstein,0,0,82,"rgb(237, 100, 90)"
15980,2020-04-21,Liechtenstein,0,0,82,"rgb(237, 100, 90)"
15981,2020-04-22,Liechtenstein,0,0,82,"rgb(237, 100, 90)"
15982,2020-04-23,Liechtenstein,0,0,82,"rgb(237, 100, 90)"
15983,2020-04-24,Liechtenstein,0,0,82,"rgb(237, 100, 90)"
15984,2020-04-25,Liechtenstein,0,0,82,"rgb(237, 100, 90)"
15985,2020-04-26,Liechtenstein,0,1,83,"rgb(237, 100, 90)"
15986,2020-04-27,Liechtenstein,0,0,83,"rgb(237, 100, 90)"
15987,2020-04-28,Liechtenstein,0,0,83,"rgb(237, 100, 90)"
15988,2020-04-29,Liechtenstein,0,0,83,"rgb(237, 100, 90)"
15989,2020-04-30,Liechtenstein,0,0,83,"rgb(237, 100, 90)"
15990,2020-05-01,Liechtenstein,0,0,83,"rgb(237, 100, 90)"
15991,2020-05-02,Liechtenstein,0,0,83,"rgb(237, 100, 90)"
15992,2020-05-03,Liechtenstein,0,0,83,"rgb(237, 100, 90)"
15993,2020-05-04,Liechtenstein,0,0,83,"rgb(237, 100, 90)"
15994,2020-05-05,Liechtenstein,0,0,83,"rgb(237, 100, 90)"
15995,2020-05-06,Liechtenstein,0,0,83,"rgb(237, 100, 90)"
15996,2020-05-07,Liechtenstein,0,0,83,"rgb(237, 100, 90)"
15997,2020-05-08,Liechtenstein,0,0,83,"rgb(237, 100, 90)"
15998,2020-05-09,Liechtenstein,0,0,83,"rgb(237, 100, 90)"
15999,2020-05-10,Liechtenstein,0,0,83,"rgb(237, 100, 90)"
16000,2020-05-11,Liechtenstein,0,0,83,"rgb(237, 100, 90)"
16001,2020-05-12,Liechtenstein,0,0,83,"rgb(237, 100, 90)"
16002,2020-05-13,Liechtenstein,0,0,83,"rgb(237, 100, 90)"
16003,2020-05-14,Liechtenstein,0,0,83,"rgb(237, 100, 90)"
16004,2020-05-15,Liechtenstein,0,0,83,"rgb(237, 100, 90)"
16005,2020-05-16,Liechtenstein,0,0,83,"rgb(237, 100, 90)"
16006,2020-05-17,Liechtenstein,0,0,83,"rgb(237, 100, 90)"
16007,2020-05-18,Liechtenstein,0,0,83,"rgb(237, 100, 90)"
16008,2020-05-19,Liechtenstein,0,0,83,"rgb(237, 100, 90)"
16009,2020-05-20,Liechtenstein,0,0,83,"rgb(237, 100, 90)"
16010,2020-05-21,Liechtenstein,0,0,83,"rgb(237, 100, 90)"
16011,2020-05-22,Liechtenstein,0,0,83,"rgb(237, 100, 90)"
16012,2020-05-23,Liechtenstein,0,0,83,"rgb(237, 100, 90)"
16013,2020-05-24,Liechtenstein,0,0,83,"rgb(237, 100, 90)"
16014,2020-05-25,Liechtenstein,0,0,83,"rgb(237, 100, 90)"
16015,2020-05-26,Liechtenstein,0,0,83,"rgb(237, 100, 90)"
16016,2020-05-27,Liechtenstein,0,0,83,"rgb(237, 100, 90)"
16017,2020-05-28,Liechtenstein,0,0,83,"rgb(237, 100, 90)"
16018,2020-05-29,Liechtenstein,0,0,83,"rgb(237, 100, 90)"
16019,2020-05-30,Liechtenstein,0,0,83,"rgb(237, 100, 90)"
16020,2020-05-31,Liechtenstein,0,0,83,"rgb(237, 100, 90)"
16021,2020-06-01,Liechtenstein,0,0,83,"rgb(237, 100, 90)"
16022,2020-06-02,Liechtenstein,0,0,83,"rgb(237, 100, 90)"
16023,2020-06-03,Liechtenstein,0,0,83,"rgb(237, 100, 90)"
16024,2020-06-04,Liechtenstein,0,0,83,"rgb(237, 100, 90)"
16025,2020-06-05,Liechtenstein,0,0,83,"rgb(237, 100, 90)"
16026,2020-06-06,Liechtenstein,0,0,83,"rgb(237, 100, 90)"
16027,2020-06-07,Liechtenstein,0,0,83,"rgb(237, 100, 90)"
16028,2020-06-08,Liechtenstein,0,0,83,"rgb(237, 100, 90)"
16029,2020-06-09,Liechtenstein,0,0,83,"rgb(237, 100, 90)"
16030,2020-06-10,Liechtenstein,0,0,83,"rgb(237, 100, 90)"
16031,2020-06-11,Liechtenstein,0,0,83,"rgb(237, 100, 90)"
16032,2020-06-12,Liechtenstein,0,0,83,"rgb(237, 100, 90)"
16033,2020-06-13,Liechtenstein,0,0,83,"rgb(237, 100, 90)"
16034,2020-06-14,Liechtenstein,0,0,83,"rgb(237, 100, 90)"
16035,2020-06-15,Liechtenstein,0,0,83,"rgb(237, 100, 90)"
16036,2020-06-16,Liechtenstein,0,0,83,"rgb(237, 100, 90)"
16037,2020-06-17,Liechtenstein,0,0,83,"rgb(237, 100, 90)"
16038,2020-06-18,Liechtenstein,0,0,83,"rgb(237, 100, 90)"
16039,2020-06-19,Liechtenstein,0,0,83,"rgb(237, 100, 90)"
16040,2020-06-20,Liechtenstein,0,0,83,"rgb(237, 100, 90)"
16041,2020-06-21,Liechtenstein,0,0,83,"rgb(237, 100, 90)"
16042,2020-06-22,Liechtenstein,0,0,83,"rgb(237, 100, 90)"
16043,2020-06-23,Liechtenstein,0,0,83,"rgb(237, 100, 90)"
16044,2020-06-24,Liechtenstein,0,0,83,"rgb(237, 100, 90)"
16045,2020-06-25,Liechtenstein,0,0,83,"rgb(237, 100, 90)"
16046,2020-06-26,Liechtenstein,0,0,83,"rgb(237, 100, 90)"
16047,2020-06-27,Liechtenstein,0,0,83,"rgb(237, 100, 90)"
16048,2020-06-28,Liechtenstein,0,0,83,"rgb(237, 100, 90)"
16049,2020-06-29,Liechtenstein,0,0,83,"rgb(237, 100, 90)"
16050,2020-06-30,Liechtenstein,0,0,83,"rgb(237, 100, 90)"
16051,2020-07-01,Liechtenstein,0,0,83,"rgb(237, 100, 90)"
16052,2020-07-02,Liechtenstein,0,0,83,"rgb(237, 100, 90)"
16053,2020-07-03,Liechtenstein,0,0,83,"rgb(237, 100, 90)"
16054,2020-07-04,Liechtenstein,0,1,84,"rgb(237, 100, 90)"
16055,2020-07-05,Liechtenstein,0,0,84,"rgb(237, 100, 90)"
16056,2020-07-06,Liechtenstein,0,0,84,"rgb(237, 100, 90)"
16057,2020-07-07,Liechtenstein,0,1,85,"rgb(237, 100, 90)"
16058,2020-07-08,Liechtenstein,0,0,85,"rgb(237, 100, 90)"
16059,2020-07-09,Liechtenstein,0,0,85,"rgb(237, 100, 90)"
16060,2020-07-10,Liechtenstein,0,0,85,"rgb(237, 100, 90)"
16061,2020-07-11,Liechtenstein,0,0,85,"rgb(237, 100, 90)"
16062,2020-07-12,Liechtenstein,0,0,85,"rgb(237, 100, 90)"
16063,2020-07-13,Liechtenstein,0,0,85,"rgb(237, 100, 90)"
16064,2019-12-31,Sri Lanka,0,0,0,"rgb(165, 170, 153)"
16065,2020-01-01,Sri Lanka,0,0,0,"rgb(165, 170, 153)"
16066,2020-01-02,Sri Lanka,0,0,0,"rgb(165, 170, 153)"
16067,2020-01-03,Sri Lanka,0,0,0,"rgb(165, 170, 153)"
16068,2020-01-04,Sri Lanka,0,0,0,"rgb(165, 170, 153)"
16069,2020-01-05,Sri Lanka,0,0,0,"rgb(165, 170, 153)"
16070,2020-01-06,Sri Lanka,0,0,0,"rgb(165, 170, 153)"
16071,2020-01-07,Sri Lanka,0,0,0,"rgb(165, 170, 153)"
16072,2020-01-08,Sri Lanka,0,0,0,"rgb(165, 170, 153)"
16073,2020-01-09,Sri Lanka,0,0,0,"rgb(165, 170, 153)"
16074,2020-01-10,Sri Lanka,0,0,0,"rgb(165, 170, 153)"
16075,2020-01-11,Sri Lanka,0,0,0,"rgb(165, 170, 153)"
16076,2020-01-12,Sri Lanka,0,0,0,"rgb(165, 170, 153)"
16077,2020-01-13,Sri Lanka,0,0,0,"rgb(165, 170, 153)"
16078,2020-01-14,Sri Lanka,0,0,0,"rgb(165, 170, 153)"
16079,2020-01-15,Sri Lanka,0,0,0,"rgb(165, 170, 153)"
16080,2020-01-16,Sri Lanka,0,0,0,"rgb(165, 170, 153)"
16081,2020-01-17,Sri Lanka,0,0,0,"rgb(165, 170, 153)"
16082,2020-01-18,Sri Lanka,0,0,0,"rgb(165, 170, 153)"
16083,2020-01-19,Sri Lanka,0,0,0,"rgb(165, 170, 153)"
16084,2020-01-20,Sri Lanka,0,0,0,"rgb(165, 170, 153)"
16085,2020-01-21,Sri Lanka,0,0,0,"rgb(165, 170, 153)"
16086,2020-01-22,Sri Lanka,0,0,0,"rgb(165, 170, 153)"
16087,2020-01-23,Sri Lanka,0,0,0,"rgb(165, 170, 153)"
16088,2020-01-24,Sri Lanka,0,0,0,"rgb(165, 170, 153)"
16089,2020-01-25,Sri Lanka,0,0,0,"rgb(165, 170, 153)"
16090,2020-01-26,Sri Lanka,0,0,0,"rgb(165, 170, 153)"
16091,2020-01-27,Sri Lanka,0,0,0,"rgb(165, 170, 153)"
16092,2020-01-28,Sri Lanka,0,1,1,"rgb(165, 170, 153)"
16093,2020-01-29,Sri Lanka,0,0,1,"rgb(165, 170, 153)"
16094,2020-01-30,Sri Lanka,0,0,1,"rgb(165, 170, 153)"
16095,2020-01-31,Sri Lanka,0,0,1,"rgb(165, 170, 153)"
16096,2020-02-01,Sri Lanka,0,0,1,"rgb(165, 170, 153)"
16097,2020-02-02,Sri Lanka,0,0,1,"rgb(165, 170, 153)"
16098,2020-02-03,Sri Lanka,0,0,1,"rgb(165, 170, 153)"
16099,2020-02-04,Sri Lanka,0,0,1,"rgb(165, 170, 153)"
16100,2020-02-05,Sri Lanka,0,0,1,"rgb(165, 170, 153)"
16101,2020-02-06,Sri Lanka,0,0,1,"rgb(165, 170, 153)"
16102,2020-02-07,Sri Lanka,0,0,1,"rgb(165, 170, 153)"
16103,2020-02-08,Sri Lanka,0,0,1,"rgb(165, 170, 153)"
16104,2020-02-09,Sri Lanka,0,0,1,"rgb(165, 170, 153)"
16105,2020-02-10,Sri Lanka,0,0,1,"rgb(165, 170, 153)"
16106,2020-02-11,Sri Lanka,0,0,1,"rgb(165, 170, 153)"
16107,2020-02-12,Sri Lanka,0,0,1,"rgb(165, 170, 153)"
16108,2020-02-13,Sri Lanka,0,0,1,"rgb(165, 170, 153)"
16109,2020-02-14,Sri Lanka,0,0,1,"rgb(165, 170, 153)"
16110,2020-02-15,Sri Lanka,0,0,1,"rgb(165, 170, 153)"
16111,2020-02-16,Sri Lanka,0,0,1,"rgb(165, 170, 153)"
16112,2020-02-17,Sri Lanka,0,0,1,"rgb(165, 170, 153)"
16113,2020-02-18,Sri Lanka,0,0,1,"rgb(165, 170, 153)"
16114,2020-02-19,Sri Lanka,0,0,1,"rgb(165, 170, 153)"
16115,2020-02-20,Sri Lanka,0,0,1,"rgb(165, 170, 153)"
16116,2020-02-21,Sri Lanka,0,0,1,"rgb(165, 170, 153)"
16117,2020-02-22,Sri Lanka,0,0,1,"rgb(165, 170, 153)"
16118,2020-02-23,Sri Lanka,0,0,1,"rgb(165, 170, 153)"
16119,2020-02-24,Sri Lanka,0,0,1,"rgb(165, 170, 153)"
16120,2020-02-25,Sri Lanka,0,0,1,"rgb(165, 170, 153)"
16121,2020-02-26,Sri Lanka,0,0,1,"rgb(165, 170, 153)"
16122,2020-02-27,Sri Lanka,0,0,1,"rgb(165, 170, 153)"
16123,2020-02-28,Sri Lanka,0,0,1,"rgb(165, 170, 153)"
16124,2020-02-29,Sri Lanka,0,0,1,"rgb(165, 170, 153)"
16125,2020-03-01,Sri Lanka,0,0,1,"rgb(165, 170, 153)"
16126,2020-03-02,Sri Lanka,0,0,1,"rgb(165, 170, 153)"
16127,2020-03-12,Sri Lanka,0,1,2,"rgb(165, 170, 153)"
16128,2020-03-13,Sri Lanka,0,1,3,"rgb(165, 170, 153)"
16129,2020-03-14,Sri Lanka,0,3,6,"rgb(165, 170, 153)"
16130,2020-03-15,Sri Lanka,0,5,11,"rgb(165, 170, 153)"
16131,2020-03-16,Sri Lanka,0,8,19,"rgb(165, 170, 153)"
16132,2020-03-17,Sri Lanka,0,10,29,"rgb(165, 170, 153)"
16133,2020-03-18,Sri Lanka,0,13,42,"rgb(165, 170, 153)"
16134,2020-03-19,Sri Lanka,0,0,42,"rgb(165, 170, 153)"
16135,2020-03-20,Sri Lanka,0,11,53,"rgb(165, 170, 153)"
16136,2020-03-21,Sri Lanka,0,13,66,"rgb(165, 170, 153)"
16137,2020-03-22,Sri Lanka,0,12,78,"rgb(165, 170, 153)"
16138,2020-03-23,Sri Lanka,0,9,87,"rgb(165, 170, 153)"
16139,2020-03-24,Sri Lanka,0,10,97,"rgb(165, 170, 153)"
16140,2020-03-25,Sri Lanka,0,5,102,"rgb(165, 170, 153)"
16141,2020-03-26,Sri Lanka,0,0,102,"rgb(165, 170, 153)"
16142,2020-03-27,Sri Lanka,0,4,106,"rgb(165, 170, 153)"
16143,2020-03-28,Sri Lanka,0,0,106,"rgb(165, 170, 153)"
16144,2020-03-29,Sri Lanka,1,9,115,"rgb(165, 170, 153)"
16145,2020-03-30,Sri Lanka,0,5,120,"rgb(165, 170, 153)"
16146,2020-03-31,Sri Lanka,0,0,120,"rgb(165, 170, 153)"
16147,2020-04-01,Sri Lanka,1,2,122,"rgb(165, 170, 153)"
16148,2020-04-02,Sri Lanka,0,21,143,"rgb(165, 170, 153)"
16149,2020-04-03,Sri Lanka,1,5,148,"rgb(165, 170, 153)"
16150,2020-04-04,Sri Lanka,1,3,151,"rgb(165, 170, 153)"
16151,2020-04-05,Sri Lanka,1,8,159,"rgb(165, 170, 153)"
16152,2020-04-06,Sri Lanka,0,7,166,"rgb(165, 170, 153)"
16153,2020-04-07,Sri Lanka,0,12,178,"rgb(165, 170, 153)"
16154,2020-04-08,Sri Lanka,1,7,185,"rgb(165, 170, 153)"
16155,2020-04-09,Sri Lanka,1,4,189,"rgb(165, 170, 153)"
16156,2020-04-10,Sri Lanka,0,1,190,"rgb(165, 170, 153)"
16157,2020-04-11,Sri Lanka,0,7,197,"rgb(165, 170, 153)"
16158,2020-04-12,Sri Lanka,0,2,199,"rgb(165, 170, 153)"
16159,2020-04-13,Sri Lanka,0,11,210,"rgb(165, 170, 153)"
16160,2020-04-14,Sri Lanka,0,8,218,"rgb(165, 170, 153)"
16161,2020-04-15,Sri Lanka,0,15,233,"rgb(165, 170, 153)"
16162,2020-04-16,Sri Lanka,0,4,237,"rgb(165, 170, 153)"
16163,2020-04-17,Sri Lanka,0,1,238,"rgb(165, 170, 153)"
16164,2020-04-18,Sri Lanka,0,6,244,"rgb(165, 170, 153)"
16165,2020-04-19,Sri Lanka,0,10,254,"rgb(165, 170, 153)"
16166,2020-04-20,Sri Lanka,0,41,295,"rgb(165, 170, 153)"
16167,2020-04-21,Sri Lanka,0,9,304,"rgb(165, 170, 153)"
16168,2020-04-22,Sri Lanka,0,6,310,"rgb(165, 170, 153)"
16169,2020-04-23,Sri Lanka,0,20,330,"rgb(165, 170, 153)"
16170,2020-04-24,Sri Lanka,0,38,368,"rgb(165, 170, 153)"
16171,2020-04-25,Sri Lanka,0,52,420,"rgb(165, 170, 153)"
16172,2020-04-26,Sri Lanka,0,42,462,"rgb(165, 170, 153)"
16173,2020-04-27,Sri Lanka,0,61,523,"rgb(165, 170, 153)"
16174,2020-04-28,Sri Lanka,0,65,588,"rgb(165, 170, 153)"
16175,2020-04-29,Sri Lanka,0,31,619,"rgb(165, 170, 153)"
16176,2020-04-30,Sri Lanka,0,30,649,"rgb(165, 170, 153)"
16177,2020-05-01,Sri Lanka,0,16,665,"rgb(165, 170, 153)"
16178,2020-05-02,Sri Lanka,0,25,690,"rgb(165, 170, 153)"
16179,2020-05-03,Sri Lanka,0,15,705,"rgb(165, 170, 153)"
16180,2020-05-04,Sri Lanka,0,13,718,"rgb(165, 170, 153)"
16181,2020-05-05,Sri Lanka,1,37,755,"rgb(165, 170, 153)"
16182,2020-05-06,Sri Lanka,1,16,771,"rgb(165, 170, 153)"
16183,2020-05-07,Sri Lanka,0,26,797,"rgb(165, 170, 153)"
16184,2020-05-08,Sri Lanka,0,27,824,"rgb(165, 170, 153)"
16185,2020-05-09,Sri Lanka,0,11,835,"rgb(165, 170, 153)"
16186,2020-05-10,Sri Lanka,0,12,847,"rgb(165, 170, 153)"
16187,2020-05-11,Sri Lanka,0,16,863,"rgb(165, 170, 153)"
16188,2020-05-12,Sri Lanka,0,6,869,"rgb(165, 170, 153)"
16189,2020-05-13,Sri Lanka,0,20,889,"rgb(165, 170, 153)"
16190,2020-05-14,Sri Lanka,0,26,915,"rgb(165, 170, 153)"
16191,2020-05-15,Sri Lanka,0,10,925,"rgb(165, 170, 153)"
16192,2020-05-16,Sri Lanka,0,10,935,"rgb(165, 170, 153)"
16193,2020-05-17,Sri Lanka,0,25,960,"rgb(165, 170, 153)"
16194,2020-05-18,Sri Lanka,0,21,981,"rgb(165, 170, 153)"
16195,2020-05-19,Sri Lanka,0,11,992,"rgb(165, 170, 153)"
16196,2020-05-20,Sri Lanka,0,35,1027,"rgb(165, 170, 153)"
16197,2020-05-21,Sri Lanka,0,1,1028,"rgb(165, 170, 153)"
16198,2020-05-22,Sri Lanka,0,27,1055,"rgb(165, 170, 153)"
16199,2020-05-23,Sri Lanka,0,13,1068,"rgb(165, 170, 153)"
16200,2020-05-24,Sri Lanka,0,21,1089,"rgb(165, 170, 153)"
16201,2020-05-25,Sri Lanka,0,52,1141,"rgb(165, 170, 153)"
16202,2020-05-26,Sri Lanka,1,41,1182,"rgb(165, 170, 153)"
16203,2020-05-27,Sri Lanka,0,137,1319,"rgb(165, 170, 153)"
16204,2020-05-28,Sri Lanka,0,150,1469,"rgb(165, 170, 153)"
16205,2020-05-29,Sri Lanka,0,61,1530,"rgb(165, 170, 153)"
16206,2020-05-30,Sri Lanka,0,28,1558,"rgb(165, 170, 153)"
16207,2020-05-31,Sri Lanka,0,62,1620,"rgb(165, 170, 153)"
16208,2020-06-01,Sri Lanka,0,13,1633,"rgb(165, 170, 153)"
16209,2020-06-02,Sri Lanka,1,10,1643,"rgb(165, 170, 153)"
16210,2020-06-03,Sri Lanka,0,40,1683,"rgb(165, 170, 153)"
16211,2020-06-04,Sri Lanka,0,66,1749,"rgb(165, 170, 153)"
16212,2020-06-05,Sri Lanka,0,48,1797,"rgb(165, 170, 153)"
16213,2020-06-06,Sri Lanka,0,4,1801,"rgb(165, 170, 153)"
16214,2020-06-07,Sri Lanka,0,13,1814,"rgb(165, 170, 153)"
16215,2020-06-08,Sri Lanka,0,21,1835,"rgb(165, 170, 153)"
16216,2020-06-09,Sri Lanka,0,22,1857,"rgb(165, 170, 153)"
16217,2020-06-10,Sri Lanka,0,2,1859,"rgb(165, 170, 153)"
16218,2020-06-11,Sri Lanka,0,10,1869,"rgb(165, 170, 153)"
16219,2020-06-12,Sri Lanka,0,8,1877,"rgb(165, 170, 153)"
16220,2020-06-13,Sri Lanka,0,3,1880,"rgb(165, 170, 153)"
16221,2020-06-14,Sri Lanka,0,4,1884,"rgb(165, 170, 153)"
16222,2020-06-15,Sri Lanka,0,5,1889,"rgb(165, 170, 153)"
16223,2020-06-16,Sri Lanka,0,16,1905,"rgb(165, 170, 153)"
16224,2020-06-17,Sri Lanka,0,10,1915,"rgb(165, 170, 153)"
16225,2020-06-18,Sri Lanka,0,9,1924,"rgb(165, 170, 153)"
16226,2020-06-19,Sri Lanka,0,23,1947,"rgb(165, 170, 153)"
16227,2020-06-20,Sri Lanka,0,3,1950,"rgb(165, 170, 153)"
16228,2020-06-21,Sri Lanka,0,0,1950,"rgb(165, 170, 153)"
16229,2020-06-22,Sri Lanka,0,0,1950,"rgb(165, 170, 153)"
16230,2020-06-23,Sri Lanka,0,1,1951,"rgb(165, 170, 153)"
16231,2020-06-24,Sri Lanka,0,40,1991,"rgb(165, 170, 153)"
16232,2020-06-25,Sri Lanka,0,10,2001,"rgb(165, 170, 153)"
16233,2020-06-26,Sri Lanka,0,9,2010,"rgb(165, 170, 153)"
16234,2020-06-27,Sri Lanka,0,4,2014,"rgb(165, 170, 153)"
16235,2020-06-28,Sri Lanka,0,19,2033,"rgb(165, 170, 153)"
16236,2020-06-29,Sri Lanka,0,4,2037,"rgb(165, 170, 153)"
16237,2020-06-30,Sri Lanka,0,5,2042,"rgb(165, 170, 153)"
16238,2020-07-01,Sri Lanka,0,5,2047,"rgb(165, 170, 153)"
16239,2020-07-02,Sri Lanka,0,7,2054,"rgb(165, 170, 153)"
16240,2020-07-03,Sri Lanka,0,12,2066,"rgb(165, 170, 153)"
16241,2020-07-04,Sri Lanka,0,3,2069,"rgb(165, 170, 153)"
16242,2020-07-05,Sri Lanka,0,5,2074,"rgb(165, 170, 153)"
16243,2020-07-06,Sri Lanka,0,2,2076,"rgb(165, 170, 153)"
16244,2020-07-07,Sri Lanka,0,2,2078,"rgb(165, 170, 153)"
16245,2020-07-08,Sri Lanka,0,3,2081,"rgb(165, 170, 153)"
16246,2020-07-09,Sri Lanka,0,13,2094,"rgb(165, 170, 153)"
16247,2020-07-10,Sri Lanka,0,256,2350,"rgb(165, 170, 153)"
16248,2020-07-11,Sri Lanka,0,104,2454,"rgb(165, 170, 153)"
16249,2020-07-12,Sri Lanka,0,57,2511,"rgb(165, 170, 153)"
16250,2020-07-13,Sri Lanka,0,106,2617,"rgb(165, 170, 153)"
16251,2020-03-17,Liberia,0,1,1,"rgb(27,158,119)"
16252,2020-03-18,Liberia,0,1,2,"rgb(27,158,119)"
16253,2020-03-19,Liberia,0,0,2,"rgb(27,158,119)"
16254,2020-03-20,Liberia,0,0,2,"rgb(27,158,119)"
16255,2020-03-21,Liberia,0,0,2,"rgb(27,158,119)"
16256,2020-03-22,Liberia,0,1,3,"rgb(27,158,119)"
16257,2020-03-23,Liberia,0,0,3,"rgb(27,158,119)"
16258,2020-03-24,Liberia,0,0,3,"rgb(27,158,119)"
16259,2020-03-25,Liberia,0,0,3,"rgb(27,158,119)"
16260,2020-03-26,Liberia,0,0,3,"rgb(27,158,119)"
16261,2020-03-27,Liberia,0,0,3,"rgb(27,158,119)"
16262,2020-03-28,Liberia,0,0,3,"rgb(27,158,119)"
16263,2020-03-29,Liberia,0,0,3,"rgb(27,158,119)"
16264,2020-03-30,Liberia,0,0,3,"rgb(27,158,119)"
16265,2020-03-31,Liberia,0,0,3,"rgb(27,158,119)"
16266,2020-04-01,Liberia,0,0,3,"rgb(27,158,119)"
16267,2020-04-02,Liberia,0,3,6,"rgb(27,158,119)"
16268,2020-04-03,Liberia,0,0,6,"rgb(27,158,119)"
16269,2020-04-04,Liberia,0,1,7,"rgb(27,158,119)"
16270,2020-04-05,Liberia,1,3,10,"rgb(27,158,119)"
16271,2020-04-06,Liberia,2,3,13,"rgb(27,158,119)"
16272,2020-04-07,Liberia,0,1,14,"rgb(27,158,119)"
16273,2020-04-08,Liberia,0,0,14,"rgb(27,158,119)"
16274,2020-04-09,Liberia,1,17,31,"rgb(27,158,119)"
16275,2020-04-10,Liberia,0,0,31,"rgb(27,158,119)"
16276,2020-04-11,Liberia,0,6,37,"rgb(27,158,119)"
16277,2020-04-12,Liberia,1,11,48,"rgb(27,158,119)"
16278,2020-04-13,Liberia,0,2,50,"rgb(27,158,119)"
16279,2020-04-14,Liberia,1,9,59,"rgb(27,158,119)"
16280,2020-04-15,Liberia,0,0,59,"rgb(27,158,119)"
16281,2020-04-16,Liberia,0,0,59,"rgb(27,158,119)"
16282,2020-04-17,Liberia,0,14,73,"rgb(27,158,119)"
16283,2020-04-18,Liberia,1,3,76,"rgb(27,158,119)"
16284,2020-04-19,Liberia,0,5,81,"rgb(27,158,119)"
16285,2020-04-20,Liberia,1,10,91,"rgb(27,158,119)"
16286,2020-04-21,Liberia,0,8,99,"rgb(27,158,119)"
16287,2020-04-22,Liberia,0,2,101,"rgb(27,158,119)"
16288,2020-04-23,Liberia,0,0,101,"rgb(27,158,119)"
16289,2020-04-24,Liberia,0,0,101,"rgb(27,158,119)"
16290,2020-04-25,Liberia,0,16,117,"rgb(27,158,119)"
16291,2020-04-26,Liberia,3,3,120,"rgb(27,158,119)"
16292,2020-04-27,Liberia,1,4,124,"rgb(27,158,119)"
16293,2020-04-28,Liberia,4,9,133,"rgb(27,158,119)"
16294,2020-04-29,Liberia,0,8,141,"rgb(27,158,119)"
16295,2020-04-30,Liberia,0,0,141,"rgb(27,158,119)"
16296,2020-05-01,Liberia,0,0,141,"rgb(27,158,119)"
16297,2020-05-02,Liberia,2,11,152,"rgb(27,158,119)"
16298,2020-05-03,Liberia,0,2,154,"rgb(27,158,119)"
16299,2020-05-04,Liberia,0,4,158,"rgb(27,158,119)"
16300,2020-05-05,Liberia,0,8,166,"rgb(27,158,119)"
16301,2020-05-06,Liberia,2,4,170,"rgb(27,158,119)"
16302,2020-05-07,Liberia,0,8,178,"rgb(27,158,119)"
16303,2020-05-08,Liberia,0,11,189,"rgb(27,158,119)"
16304,2020-05-09,Liberia,0,10,199,"rgb(27,158,119)"
16305,2020-05-10,Liberia,0,0,199,"rgb(27,158,119)"
16306,2020-05-11,Liberia,0,0,199,"rgb(27,158,119)"
16307,2020-05-12,Liberia,0,12,211,"rgb(27,158,119)"
16308,2020-05-13,Liberia,0,1,212,"rgb(27,158,119)"
16309,2020-05-14,Liberia,0,1,213,"rgb(27,158,119)"
16310,2020-05-15,Liberia,0,2,215,"rgb(27,158,119)"
16311,2020-05-16,Liberia,0,4,219,"rgb(27,158,119)"
16312,2020-05-17,Liberia,0,4,223,"rgb(27,158,119)"
16313,2020-05-18,Liberia,1,3,226,"rgb(27,158,119)"
16314,2020-05-19,Liberia,1,3,229,"rgb(27,158,119)"
16315,2020-05-20,Liberia,1,4,233,"rgb(27,158,119)"
16316,2020-05-21,Liberia,0,5,238,"rgb(27,158,119)"
16317,2020-05-22,Liberia,0,2,240,"rgb(27,158,119)"
16318,2020-05-23,Liberia,1,9,249,"rgb(27,158,119)"
16319,2020-05-24,Liberia,2,6,255,"rgb(27,158,119)"
16320,2020-05-25,Liberia,0,10,265,"rgb(27,158,119)"
16321,2020-05-26,Liberia,0,0,265,"rgb(27,158,119)"
16322,2020-05-27,Liberia,0,1,266,"rgb(27,158,119)"
16323,2020-05-28,Liberia,1,0,266,"rgb(27,158,119)"
16324,2020-05-29,Liberia,0,3,269,"rgb(27,158,119)"
16325,2020-05-30,Liberia,0,4,273,"rgb(27,158,119)"
16326,2020-05-31,Liberia,0,7,280,"rgb(27,158,119)"
16327,2020-06-01,Liberia,0,8,288,"rgb(27,158,119)"
16328,2020-06-02,Liberia,0,8,296,"rgb(27,158,119)"
16329,2020-06-03,Liberia,1,15,311,"rgb(27,158,119)"
16330,2020-06-04,Liberia,0,5,316,"rgb(27,158,119)"
16331,2020-06-05,Liberia,0,5,321,"rgb(27,158,119)"
16332,2020-06-06,Liberia,2,13,334,"rgb(27,158,119)"
16333,2020-06-07,Liberia,0,11,345,"rgb(27,158,119)"
16334,2020-06-08,Liberia,0,14,359,"rgb(27,158,119)"
16335,2020-06-09,Liberia,0,11,370,"rgb(27,158,119)"
16336,2020-06-10,Liberia,1,13,383,"rgb(27,158,119)"
16337,2020-06-11,Liberia,0,14,397,"rgb(27,158,119)"
16338,2020-06-12,Liberia,0,13,410,"rgb(27,158,119)"
16339,2020-06-13,Liberia,1,11,421,"rgb(27,158,119)"
16340,2020-06-14,Liberia,0,25,446,"rgb(27,158,119)"
16341,2020-06-15,Liberia,0,12,458,"rgb(27,158,119)"
16342,2020-06-16,Liberia,1,40,498,"rgb(27,158,119)"
16343,2020-06-17,Liberia,0,11,509,"rgb(27,158,119)"
16344,2020-06-18,Liberia,0,0,509,"rgb(27,158,119)"
16345,2020-06-19,Liberia,0,33,542,"rgb(27,158,119)"
16346,2020-06-20,Liberia,0,39,581,"rgb(27,158,119)"
16347,2020-06-21,Liberia,0,20,601,"rgb(27,158,119)"
16348,2020-06-22,Liberia,1,25,626,"rgb(27,158,119)"
16349,2020-06-23,Liberia,0,24,650,"rgb(27,158,119)"
16350,2020-06-24,Liberia,0,2,652,"rgb(27,158,119)"
16351,2020-06-25,Liberia,0,10,662,"rgb(27,158,119)"
16352,2020-06-26,Liberia,0,19,681,"rgb(27,158,119)"
16353,2020-06-27,Liberia,0,3,684,"rgb(27,158,119)"
16354,2020-06-28,Liberia,0,45,729,"rgb(27,158,119)"
16355,2020-06-29,Liberia,0,39,768,"rgb(27,158,119)"
16356,2020-06-30,Liberia,2,2,770,"rgb(27,158,119)"
16357,2020-07-01,Liberia,0,10,780,"rgb(27,158,119)"
16358,2020-07-02,Liberia,1,24,804,"rgb(27,158,119)"
16359,2020-07-03,Liberia,0,15,819,"rgb(27,158,119)"
16360,2020-07-04,Liberia,0,14,833,"rgb(27,158,119)"
16361,2020-07-05,Liberia,0,36,869,"rgb(27,158,119)"
16362,2020-07-06,Liberia,0,5,874,"rgb(27,158,119)"
16363,2020-07-07,Liberia,2,17,891,"rgb(27,158,119)"
16364,2020-07-08,Liberia,2,26,917,"rgb(27,158,119)"
16365,2020-07-09,Liberia,0,9,926,"rgb(27,158,119)"
16366,2020-07-10,Liberia,1,31,957,"rgb(27,158,119)"
16367,2020-07-11,Liberia,5,6,963,"rgb(27,158,119)"
16368,2020-07-12,Liberia,0,35,998,"rgb(27,158,119)"
16369,2020-07-13,Liberia,4,12,1010,"rgb(27,158,119)"
16370,2020-05-15,Lesotho,0,1,1,"rgb(217,95,2)"
16371,2020-05-16,Lesotho,0,0,1,"rgb(217,95,2)"
16372,2020-05-17,Lesotho,0,0,1,"rgb(217,95,2)"
16373,2020-05-18,Lesotho,0,0,1,"rgb(217,95,2)"
16374,2020-05-19,Lesotho,0,0,1,"rgb(217,95,2)"
16375,2020-05-20,Lesotho,0,0,1,"rgb(217,95,2)"
16376,2020-05-21,Lesotho,0,0,1,"rgb(217,95,2)"
16377,2020-05-22,Lesotho,0,0,1,"rgb(217,95,2)"
16378,2020-05-23,Lesotho,0,0,1,"rgb(217,95,2)"
16379,2020-05-24,Lesotho,0,1,2,"rgb(217,95,2)"
16380,2020-05-25,Lesotho,0,0,2,"rgb(217,95,2)"
16381,2020-05-26,Lesotho,0,0,2,"rgb(217,95,2)"
16382,2020-05-27,Lesotho,0,0,2,"rgb(217,95,2)"
16383,2020-05-28,Lesotho,0,0,2,"rgb(217,95,2)"
16384,2020-05-29,Lesotho,0,0,2,"rgb(217,95,2)"
16385,2020-05-30,Lesotho,0,0,2,"rgb(217,95,2)"
16386,2020-05-31,Lesotho,0,0,2,"rgb(217,95,2)"
16387,2020-06-01,Lesotho,0,0,2,"rgb(217,95,2)"
16388,2020-06-02,Lesotho,0,0,2,"rgb(217,95,2)"
16389,2020-06-03,Lesotho,0,0,2,"rgb(217,95,2)"
16390,2020-06-04,Lesotho,0,0,2,"rgb(217,95,2)"
16391,2020-06-05,Lesotho,0,2,4,"rgb(217,95,2)"
16392,2020-06-06,Lesotho,0,0,4,"rgb(217,95,2)"
16393,2020-06-07,Lesotho,0,0,4,"rgb(217,95,2)"
16394,2020-06-08,Lesotho,0,0,4,"rgb(217,95,2)"
16395,2020-06-09,Lesotho,0,0,4,"rgb(217,95,2)"
16396,2020-06-10,Lesotho,0,0,4,"rgb(217,95,2)"
16397,2020-06-11,Lesotho,0,0,4,"rgb(217,95,2)"
16398,2020-06-12,Lesotho,0,0,4,"rgb(217,95,2)"
16399,2020-06-13,Lesotho,0,0,4,"rgb(217,95,2)"
16400,2020-06-14,Lesotho,0,0,4,"rgb(217,95,2)"
16401,2020-06-15,Lesotho,0,0,4,"rgb(217,95,2)"
16402,2020-06-16,Lesotho,0,0,4,"rgb(217,95,2)"
16403,2020-06-17,Lesotho,0,0,4,"rgb(217,95,2)"
16404,2020-06-18,Lesotho,0,0,4,"rgb(217,95,2)"
16405,2020-06-19,Lesotho,0,0,4,"rgb(217,95,2)"
16406,2020-06-20,Lesotho,0,0,4,"rgb(217,95,2)"
16407,2020-06-21,Lesotho,0,0,4,"rgb(217,95,2)"
16408,2020-06-22,Lesotho,0,0,4,"rgb(217,95,2)"
16409,2020-06-23,Lesotho,0,0,4,"rgb(217,95,2)"
16410,2020-06-24,Lesotho,0,13,17,"rgb(217,95,2)"
16411,2020-06-25,Lesotho,0,0,17,"rgb(217,95,2)"
16412,2020-06-26,Lesotho,0,3,20,"rgb(217,95,2)"
16413,2020-06-27,Lesotho,0,4,24,"rgb(217,95,2)"
16414,2020-06-28,Lesotho,0,0,24,"rgb(217,95,2)"
16415,2020-06-29,Lesotho,0,3,27,"rgb(217,95,2)"
16416,2020-06-30,Lesotho,0,0,27,"rgb(217,95,2)"
16417,2020-07-01,Lesotho,0,0,27,"rgb(217,95,2)"
16418,2020-07-02,Lesotho,0,8,35,"rgb(217,95,2)"
16419,2020-07-03,Lesotho,0,0,35,"rgb(217,95,2)"
16420,2020-07-04,Lesotho,0,0,35,"rgb(217,95,2)"
16421,2020-07-05,Lesotho,0,0,35,"rgb(217,95,2)"
16422,2020-07-06,Lesotho,0,44,79,"rgb(217,95,2)"
16423,2020-07-07,Lesotho,0,12,91,"rgb(217,95,2)"
16424,2020-07-08,Lesotho,0,0,91,"rgb(217,95,2)"
16425,2020-07-09,Lesotho,0,0,91,"rgb(217,95,2)"
16426,2020-07-10,Lesotho,1,43,134,"rgb(217,95,2)"
16427,2020-07-11,Lesotho,0,0,134,"rgb(217,95,2)"
16428,2020-07-12,Lesotho,0,50,184,"rgb(217,95,2)"
16429,2020-07-13,Lesotho,1,49,233,"rgb(217,95,2)"
16430,2019-12-31,Lithuania,0,0,0,"rgb(117,112,179)"
16431,2020-01-01,Lithuania,0,0,0,"rgb(117,112,179)"
16432,2020-01-02,Lithuania,0,0,0,"rgb(117,112,179)"
16433,2020-01-03,Lithuania,0,0,0,"rgb(117,112,179)"
16434,2020-01-04,Lithuania,0,0,0,"rgb(117,112,179)"
16435,2020-01-05,Lithuania,0,0,0,"rgb(117,112,179)"
16436,2020-01-06,Lithuania,0,0,0,"rgb(117,112,179)"
16437,2020-01-07,Lithuania,0,0,0,"rgb(117,112,179)"
16438,2020-01-08,Lithuania,0,0,0,"rgb(117,112,179)"
16439,2020-01-09,Lithuania,0,0,0,"rgb(117,112,179)"
16440,2020-01-10,Lithuania,0,0,0,"rgb(117,112,179)"
16441,2020-01-11,Lithuania,0,0,0,"rgb(117,112,179)"
16442,2020-01-12,Lithuania,0,0,0,"rgb(117,112,179)"
16443,2020-01-13,Lithuania,0,0,0,"rgb(117,112,179)"
16444,2020-01-14,Lithuania,0,0,0,"rgb(117,112,179)"
16445,2020-01-15,Lithuania,0,0,0,"rgb(117,112,179)"
16446,2020-01-16,Lithuania,0,0,0,"rgb(117,112,179)"
16447,2020-01-17,Lithuania,0,0,0,"rgb(117,112,179)"
16448,2020-01-18,Lithuania,0,0,0,"rgb(117,112,179)"
16449,2020-01-19,Lithuania,0,0,0,"rgb(117,112,179)"
16450,2020-01-20,Lithuania,0,0,0,"rgb(117,112,179)"
16451,2020-01-21,Lithuania,0,0,0,"rgb(117,112,179)"
16452,2020-01-22,Lithuania,0,0,0,"rgb(117,112,179)"
16453,2020-01-23,Lithuania,0,0,0,"rgb(117,112,179)"
16454,2020-01-24,Lithuania,0,0,0,"rgb(117,112,179)"
16455,2020-01-25,Lithuania,0,0,0,"rgb(117,112,179)"
16456,2020-01-26,Lithuania,0,0,0,"rgb(117,112,179)"
16457,2020-01-27,Lithuania,0,0,0,"rgb(117,112,179)"
16458,2020-01-28,Lithuania,0,0,0,"rgb(117,112,179)"
16459,2020-01-29,Lithuania,0,0,0,"rgb(117,112,179)"
16460,2020-01-30,Lithuania,0,0,0,"rgb(117,112,179)"
16461,2020-01-31,Lithuania,0,0,0,"rgb(117,112,179)"
16462,2020-02-01,Lithuania,0,0,0,"rgb(117,112,179)"
16463,2020-02-02,Lithuania,0,0,0,"rgb(117,112,179)"
16464,2020-02-03,Lithuania,0,0,0,"rgb(117,112,179)"
16465,2020-02-04,Lithuania,0,0,0,"rgb(117,112,179)"
16466,2020-02-05,Lithuania,0,0,0,"rgb(117,112,179)"
16467,2020-02-06,Lithuania,0,0,0,"rgb(117,112,179)"
16468,2020-02-07,Lithuania,0,0,0,"rgb(117,112,179)"
16469,2020-02-08,Lithuania,0,0,0,"rgb(117,112,179)"
16470,2020-02-09,Lithuania,0,0,0,"rgb(117,112,179)"
16471,2020-02-10,Lithuania,0,0,0,"rgb(117,112,179)"
16472,2020-02-11,Lithuania,0,0,0,"rgb(117,112,179)"
16473,2020-02-12,Lithuania,0,0,0,"rgb(117,112,179)"
16474,2020-02-13,Lithuania,0,0,0,"rgb(117,112,179)"
16475,2020-02-14,Lithuania,0,0,0,"rgb(117,112,179)"
16476,2020-02-15,Lithuania,0,0,0,"rgb(117,112,179)"
16477,2020-02-16,Lithuania,0,0,0,"rgb(117,112,179)"
16478,2020-02-17,Lithuania,0,0,0,"rgb(117,112,179)"
16479,2020-02-18,Lithuania,0,0,0,"rgb(117,112,179)"
16480,2020-02-19,Lithuania,0,0,0,"rgb(117,112,179)"
16481,2020-02-20,Lithuania,0,0,0,"rgb(117,112,179)"
16482,2020-02-21,Lithuania,0,0,0,"rgb(117,112,179)"
16483,2020-02-22,Lithuania,0,0,0,"rgb(117,112,179)"
16484,2020-02-23,Lithuania,0,0,0,"rgb(117,112,179)"
16485,2020-02-24,Lithuania,0,0,0,"rgb(117,112,179)"
16486,2020-02-25,Lithuania,0,0,0,"rgb(117,112,179)"
16487,2020-02-26,Lithuania,0,0,0,"rgb(117,112,179)"
16488,2020-02-27,Lithuania,0,0,0,"rgb(117,112,179)"
16489,2020-02-28,Lithuania,0,1,1,"rgb(117,112,179)"
16490,2020-02-29,Lithuania,0,0,1,"rgb(117,112,179)"
16491,2020-03-01,Lithuania,0,0,1,"rgb(117,112,179)"
16492,2020-03-02,Lithuania,0,0,1,"rgb(117,112,179)"
16493,2020-03-11,Lithuania,0,2,3,"rgb(117,112,179)"
16494,2020-03-12,Lithuania,0,0,3,"rgb(117,112,179)"
16495,2020-03-14,Lithuania,0,3,6,"rgb(117,112,179)"
16496,2020-03-15,Lithuania,0,3,9,"rgb(117,112,179)"
16497,2020-03-16,Lithuania,0,5,14,"rgb(117,112,179)"
16498,2020-03-17,Lithuania,0,3,17,"rgb(117,112,179)"
16499,2020-03-18,Lithuania,0,8,25,"rgb(117,112,179)"
16500,2020-03-19,Lithuania,0,8,33,"rgb(117,112,179)"
16501,2020-03-20,Lithuania,0,15,48,"rgb(117,112,179)"
16502,2020-03-21,Lithuania,1,21,69,"rgb(117,112,179)"
16503,2020-03-22,Lithuania,0,36,105,"rgb(117,112,179)"
16504,2020-03-23,Lithuania,0,38,143,"rgb(117,112,179)"
16505,2020-03-24,Lithuania,0,36,179,"rgb(117,112,179)"
16506,2020-03-25,Lithuania,1,30,209,"rgb(117,112,179)"
16507,2020-03-26,Lithuania,2,65,274,"rgb(117,112,179)"
16508,2020-03-27,Lithuania,0,25,299,"rgb(117,112,179)"
16509,2020-03-28,Lithuania,1,59,358,"rgb(117,112,179)"
16510,2020-03-29,Lithuania,2,36,394,"rgb(117,112,179)"
16511,2020-03-30,Lithuania,0,90,484,"rgb(117,112,179)"
16512,2020-03-31,Lithuania,0,0,484,"rgb(117,112,179)"
16513,2020-04-01,Lithuania,0,49,533,"rgb(117,112,179)"
16514,2020-04-02,Lithuania,1,48,581,"rgb(117,112,179)"
16515,2020-04-03,Lithuania,1,68,649,"rgb(117,112,179)"
16516,2020-04-04,Lithuania,0,122,771,"rgb(117,112,179)"
16517,2020-04-05,Lithuania,0,0,771,"rgb(117,112,179)"
16518,2020-04-06,Lithuania,4,40,811,"rgb(117,112,179)"
16519,2020-04-07,Lithuania,1,32,843,"rgb(117,112,179)"
16520,2020-04-08,Lithuania,1,37,880,"rgb(117,112,179)"
16521,2020-04-09,Lithuania,0,32,912,"rgb(117,112,179)"
16522,2020-04-10,Lithuania,0,43,955,"rgb(117,112,179)"
16523,2020-04-11,Lithuania,2,44,999,"rgb(117,112,179)"
16524,2020-04-12,Lithuania,6,54,1053,"rgb(117,112,179)"
16525,2020-04-13,Lithuania,1,9,1062,"rgb(117,112,179)"
16526,2020-04-14,Lithuania,0,8,1070,"rgb(117,112,179)"
16527,2020-04-15,Lithuania,0,0,1070,"rgb(117,112,179)"
16528,2020-04-16,Lithuania,5,21,1091,"rgb(117,112,179)"
16529,2020-04-17,Lithuania,3,58,1149,"rgb(117,112,179)"
16530,2020-04-18,Lithuania,1,90,1239,"rgb(117,112,179)"
16531,2020-04-19,Lithuania,0,59,1298,"rgb(117,112,179)"
16532,2020-04-20,Lithuania,3,28,1326,"rgb(117,112,179)"
16533,2020-04-21,Lithuania,1,24,1350,"rgb(117,112,179)"
16534,2020-04-22,Lithuania,1,20,1370,"rgb(117,112,179)"
16535,2020-04-23,Lithuania,0,28,1398,"rgb(117,112,179)"
16536,2020-04-24,Lithuania,2,12,1410,"rgb(117,112,179)"
16537,2020-04-25,Lithuania,0,0,1410,"rgb(117,112,179)"
16538,2020-04-26,Lithuania,1,16,1426,"rgb(117,112,179)"
16539,2020-04-27,Lithuania,0,12,1438,"rgb(117,112,179)"
16540,2020-04-28,Lithuania,0,11,1449,"rgb(117,112,179)"
16541,2020-04-29,Lithuania,3,-105,1344,"rgb(117,112,179)"
16542,2020-04-30,Lithuania,1,31,1375,"rgb(117,112,179)"
16543,2020-05-01,Lithuania,0,10,1385,"rgb(117,112,179)"
16544,2020-05-02,Lithuania,0,14,1399,"rgb(117,112,179)"
16545,2020-05-03,Lithuania,1,7,1406,"rgb(117,112,179)"
16546,2020-05-04,Lithuania,0,4,1410,"rgb(117,112,179)"
16547,2020-05-05,Lithuania,0,9,1419,"rgb(117,112,179)"
16548,2020-05-06,Lithuania,0,4,1423,"rgb(117,112,179)"
16549,2020-05-07,Lithuania,2,5,1428,"rgb(117,112,179)"
16550,2020-05-08,Lithuania,1,5,1433,"rgb(117,112,179)"
16551,2020-05-09,Lithuania,0,3,1436,"rgb(117,112,179)"
16552,2020-05-10,Lithuania,1,8,1444,"rgb(117,112,179)"
16553,2020-05-11,Lithuania,0,35,1479,"rgb(117,112,179)"
16554,2020-05-12,Lithuania,0,6,1485,"rgb(117,112,179)"
16555,2020-05-13,Lithuania,0,6,1491,"rgb(117,112,179)"
16556,2020-05-14,Lithuania,4,14,1505,"rgb(117,112,179)"
16557,2020-05-15,Lithuania,0,6,1511,"rgb(117,112,179)"
16558,2020-05-16,Lithuania,0,12,1523,"rgb(117,112,179)"
16559,2020-05-17,Lithuania,1,11,1534,"rgb(117,112,179)"
16560,2020-05-18,Lithuania,1,7,1541,"rgb(117,112,179)"
16561,2020-05-19,Lithuania,3,6,1547,"rgb(117,112,179)"
16562,2020-05-20,Lithuania,1,15,1562,"rgb(117,112,179)"
16563,2020-05-21,Lithuania,0,15,1577,"rgb(117,112,179)"
16564,2020-05-22,Lithuania,1,17,1594,"rgb(117,112,179)"
16565,2020-05-23,Lithuania,0,10,1604,"rgb(117,112,179)"
16566,2020-05-24,Lithuania,2,12,1616,"rgb(117,112,179)"
16567,2020-05-25,Lithuania,0,7,1623,"rgb(117,112,179)"
16568,2020-05-26,Lithuania,0,12,1635,"rgb(117,112,179)"
16569,2020-05-27,Lithuania,2,4,1639,"rgb(117,112,179)"
16570,2020-05-28,Lithuania,1,8,1647,"rgb(117,112,179)"
16571,2020-05-29,Lithuania,2,9,1656,"rgb(117,112,179)"
16572,2020-05-30,Lithuania,0,6,1662,"rgb(117,112,179)"
16573,2020-05-31,Lithuania,2,8,1670,"rgb(117,112,179)"
16574,2020-06-01,Lithuania,0,5,1675,"rgb(117,112,179)"
16575,2020-06-02,Lithuania,0,3,1678,"rgb(117,112,179)"
16576,2020-06-03,Lithuania,1,4,1682,"rgb(117,112,179)"
16577,2020-06-04,Lithuania,0,2,1684,"rgb(117,112,179)"
16578,2020-06-05,Lithuania,0,3,1687,"rgb(117,112,179)"
16579,2020-06-06,Lithuania,0,7,1694,"rgb(117,112,179)"
16580,2020-06-07,Lithuania,0,11,1705,"rgb(117,112,179)"
16581,2020-06-08,Lithuania,0,9,1714,"rgb(117,112,179)"
16582,2020-06-09,Lithuania,0,6,1720,"rgb(117,112,179)"
16583,2020-06-10,Lithuania,1,7,1727,"rgb(117,112,179)"
16584,2020-06-11,Lithuania,2,6,1733,"rgb(117,112,179)"
16585,2020-06-12,Lithuania,0,19,1752,"rgb(117,112,179)"
16586,2020-06-13,Lithuania,0,4,1756,"rgb(117,112,179)"
16587,2020-06-14,Lithuania,1,7,1763,"rgb(117,112,179)"
16588,2020-06-15,Lithuania,0,5,1768,"rgb(117,112,179)"
16589,2020-06-16,Lithuania,1,5,1773,"rgb(117,112,179)"
16590,2020-06-17,Lithuania,0,3,1776,"rgb(117,112,179)"
16591,2020-06-18,Lithuania,0,2,1778,"rgb(117,112,179)"
16592,2020-06-19,Lithuania,0,6,1784,"rgb(117,112,179)"
16593,2020-06-20,Lithuania,0,8,1792,"rgb(117,112,179)"
16594,2020-06-21,Lithuania,0,3,1795,"rgb(117,112,179)"
16595,2020-06-22,Lithuania,0,3,1798,"rgb(117,112,179)"
16596,2020-06-23,Lithuania,0,3,1801,"rgb(117,112,179)"
16597,2020-06-24,Lithuania,1,2,1803,"rgb(117,112,179)"
16598,2020-06-25,Lithuania,1,1,1804,"rgb(117,112,179)"
16599,2020-06-26,Lithuania,0,2,1806,"rgb(117,112,179)"
16600,2020-06-27,Lithuania,0,2,1808,"rgb(117,112,179)"
16601,2020-06-28,Lithuania,0,5,1813,"rgb(117,112,179)"
16602,2020-06-29,Lithuania,0,3,1816,"rgb(117,112,179)"
16603,2020-06-30,Lithuania,0,0,1816,"rgb(117,112,179)"
16604,2020-07-01,Lithuania,0,1,1817,"rgb(117,112,179)"
16605,2020-07-02,Lithuania,0,1,1818,"rgb(117,112,179)"
16606,2020-07-03,Lithuania,0,7,1825,"rgb(117,112,179)"
16607,2020-07-04,Lithuania,1,3,1828,"rgb(117,112,179)"
16608,2020-07-05,Lithuania,0,3,1831,"rgb(117,112,179)"
16609,2020-07-06,Lithuania,0,5,1836,"rgb(117,112,179)"
16610,2020-07-07,Lithuania,0,5,1841,"rgb(117,112,179)"
16611,2020-07-08,Lithuania,0,3,1844,"rgb(117,112,179)"
16612,2020-07-09,Lithuania,0,10,1854,"rgb(117,112,179)"
16613,2020-07-10,Lithuania,0,3,1857,"rgb(117,112,179)"
16614,2020-07-11,Lithuania,0,4,1861,"rgb(117,112,179)"
16615,2020-07-12,Lithuania,0,4,1865,"rgb(117,112,179)"
16616,2020-07-13,Lithuania,0,4,1869,"rgb(117,112,179)"
16617,2019-12-31,Luxembourg,0,0,0,"rgb(231,41,138)"
16618,2020-01-01,Luxembourg,0,0,0,"rgb(231,41,138)"
16619,2020-01-02,Luxembourg,0,0,0,"rgb(231,41,138)"
16620,2020-01-03,Luxembourg,0,0,0,"rgb(231,41,138)"
16621,2020-01-04,Luxembourg,0,0,0,"rgb(231,41,138)"
16622,2020-01-05,Luxembourg,0,0,0,"rgb(231,41,138)"
16623,2020-01-06,Luxembourg,0,0,0,"rgb(231,41,138)"
16624,2020-01-07,Luxembourg,0,0,0,"rgb(231,41,138)"
16625,2020-01-08,Luxembourg,0,0,0,"rgb(231,41,138)"
16626,2020-01-09,Luxembourg,0,0,0,"rgb(231,41,138)"
16627,2020-01-10,Luxembourg,0,0,0,"rgb(231,41,138)"
16628,2020-01-11,Luxembourg,0,0,0,"rgb(231,41,138)"
16629,2020-01-12,Luxembourg,0,0,0,"rgb(231,41,138)"
16630,2020-01-13,Luxembourg,0,0,0,"rgb(231,41,138)"
16631,2020-01-14,Luxembourg,0,0,0,"rgb(231,41,138)"
16632,2020-01-15,Luxembourg,0,0,0,"rgb(231,41,138)"
16633,2020-01-16,Luxembourg,0,0,0,"rgb(231,41,138)"
16634,2020-01-17,Luxembourg,0,0,0,"rgb(231,41,138)"
16635,2020-01-18,Luxembourg,0,0,0,"rgb(231,41,138)"
16636,2020-01-19,Luxembourg,0,0,0,"rgb(231,41,138)"
16637,2020-01-20,Luxembourg,0,0,0,"rgb(231,41,138)"
16638,2020-01-21,Luxembourg,0,0,0,"rgb(231,41,138)"
16639,2020-01-22,Luxembourg,0,0,0,"rgb(231,41,138)"
16640,2020-01-23,Luxembourg,0,0,0,"rgb(231,41,138)"
16641,2020-01-24,Luxembourg,0,0,0,"rgb(231,41,138)"
16642,2020-01-25,Luxembourg,0,0,0,"rgb(231,41,138)"
16643,2020-01-26,Luxembourg,0,0,0,"rgb(231,41,138)"
16644,2020-01-27,Luxembourg,0,0,0,"rgb(231,41,138)"
16645,2020-01-28,Luxembourg,0,0,0,"rgb(231,41,138)"
16646,2020-01-29,Luxembourg,0,0,0,"rgb(231,41,138)"
16647,2020-01-30,Luxembourg,0,0,0,"rgb(231,41,138)"
16648,2020-01-31,Luxembourg,0,0,0,"rgb(231,41,138)"
16649,2020-02-01,Luxembourg,0,0,0,"rgb(231,41,138)"
16650,2020-02-02,Luxembourg,0,0,0,"rgb(231,41,138)"
16651,2020-02-03,Luxembourg,0,0,0,"rgb(231,41,138)"
16652,2020-02-04,Luxembourg,0,0,0,"rgb(231,41,138)"
16653,2020-02-05,Luxembourg,0,0,0,"rgb(231,41,138)"
16654,2020-02-06,Luxembourg,0,0,0,"rgb(231,41,138)"
16655,2020-02-07,Luxembourg,0,0,0,"rgb(231,41,138)"
16656,2020-02-08,Luxembourg,0,0,0,"rgb(231,41,138)"
16657,2020-02-09,Luxembourg,0,0,0,"rgb(231,41,138)"
16658,2020-02-10,Luxembourg,0,0,0,"rgb(231,41,138)"
16659,2020-02-11,Luxembourg,0,0,0,"rgb(231,41,138)"
16660,2020-02-12,Luxembourg,0,0,0,"rgb(231,41,138)"
16661,2020-02-13,Luxembourg,0,0,0,"rgb(231,41,138)"
16662,2020-02-14,Luxembourg,0,0,0,"rgb(231,41,138)"
16663,2020-02-15,Luxembourg,0,0,0,"rgb(231,41,138)"
16664,2020-02-16,Luxembourg,0,0,0,"rgb(231,41,138)"
16665,2020-02-17,Luxembourg,0,0,0,"rgb(231,41,138)"
16666,2020-02-18,Luxembourg,0,0,0,"rgb(231,41,138)"
16667,2020-02-19,Luxembourg,0,0,0,"rgb(231,41,138)"
16668,2020-02-20,Luxembourg,0,0,0,"rgb(231,41,138)"
16669,2020-02-21,Luxembourg,0,0,0,"rgb(231,41,138)"
16670,2020-02-22,Luxembourg,0,0,0,"rgb(231,41,138)"
16671,2020-02-23,Luxembourg,0,0,0,"rgb(231,41,138)"
16672,2020-02-24,Luxembourg,0,0,0,"rgb(231,41,138)"
16673,2020-02-25,Luxembourg,0,0,0,"rgb(231,41,138)"
16674,2020-02-26,Luxembourg,0,0,0,"rgb(231,41,138)"
16675,2020-02-27,Luxembourg,0,0,0,"rgb(231,41,138)"
16676,2020-02-28,Luxembourg,0,0,0,"rgb(231,41,138)"
16677,2020-02-29,Luxembourg,0,0,0,"rgb(231,41,138)"
16678,2020-03-01,Luxembourg,0,1,1,"rgb(231,41,138)"
16679,2020-03-02,Luxembourg,0,0,1,"rgb(231,41,138)"
16680,2020-03-07,Luxembourg,0,2,3,"rgb(231,41,138)"
16681,2020-03-09,Luxembourg,0,2,5,"rgb(231,41,138)"
16682,2020-03-11,Luxembourg,0,2,7,"rgb(231,41,138)"
16683,2020-03-12,Luxembourg,0,0,7,"rgb(231,41,138)"
16684,2020-03-13,Luxembourg,0,19,26,"rgb(231,41,138)"
16685,2020-03-14,Luxembourg,1,12,38,"rgb(231,41,138)"
16686,2020-03-16,Luxembourg,0,39,77,"rgb(231,41,138)"
16687,2020-03-17,Luxembourg,0,4,81,"rgb(231,41,138)"
16688,2020-03-18,Luxembourg,0,59,140,"rgb(231,41,138)"
16689,2020-03-19,Luxembourg,1,70,210,"rgb(231,41,138)"
16690,2020-03-20,Luxembourg,2,135,345,"rgb(231,41,138)"
16691,2020-03-21,Luxembourg,1,139,484,"rgb(231,41,138)"
16692,2020-03-22,Luxembourg,3,186,670,"rgb(231,41,138)"
16693,2020-03-23,Luxembourg,0,128,798,"rgb(231,41,138)"
16694,2020-03-24,Luxembourg,0,77,875,"rgb(231,41,138)"
16695,2020-03-25,Luxembourg,0,224,1099,"rgb(231,41,138)"
16696,2020-03-26,Luxembourg,0,234,1333,"rgb(231,41,138)"
16697,2020-03-27,Luxembourg,1,120,1453,"rgb(231,41,138)"
16698,2020-03-28,Luxembourg,6,152,1605,"rgb(231,41,138)"
16699,2020-03-29,Luxembourg,3,226,1831,"rgb(231,41,138)"
16700,2020-03-30,Luxembourg,3,119,1950,"rgb(231,41,138)"
16701,2020-03-31,Luxembourg,1,38,1988,"rgb(231,41,138)"
16702,2020-04-01,Luxembourg,1,190,2178,"rgb(231,41,138)"
16703,2020-04-02,Luxembourg,6,141,2319,"rgb(231,41,138)"
16704,2020-04-03,Luxembourg,1,168,2487,"rgb(231,41,138)"
16705,2020-04-04,Luxembourg,1,125,2612,"rgb(231,41,138)"
16706,2020-04-05,Luxembourg,0,117,2729,"rgb(231,41,138)"
16707,2020-04-06,Luxembourg,5,75,2804,"rgb(231,41,138)"
16708,2020-04-07,Luxembourg,5,39,2843,"rgb(231,41,138)"
16709,2020-04-08,Luxembourg,3,127,2970,"rgb(231,41,138)"
16710,2020-04-09,Luxembourg,2,64,3034,"rgb(231,41,138)"
16711,2020-04-10,Luxembourg,6,81,3115,"rgb(231,41,138)"
16712,2020-04-11,Luxembourg,2,108,3223,"rgb(231,41,138)"
16713,2020-04-12,Luxembourg,8,47,3270,"rgb(231,41,138)"
16714,2020-04-13,Luxembourg,4,11,3281,"rgb(231,41,138)"
16715,2020-04-14,Luxembourg,1,11,3292,"rgb(231,41,138)"
16716,2020-04-15,Luxembourg,0,15,3307,"rgb(231,41,138)"
16717,2020-04-16,Luxembourg,2,66,3373,"rgb(231,41,138)"
16718,2020-04-17,Luxembourg,0,71,3444,"rgb(231,41,138)"
16719,2020-04-18,Luxembourg,3,36,3480,"rgb(231,41,138)"
16720,2020-04-19,Luxembourg,0,57,3537,"rgb(231,41,138)"
16721,2020-04-20,Luxembourg,1,13,3550,"rgb(231,41,138)"
16722,2020-04-21,Luxembourg,2,8,3558,"rgb(231,41,138)"
16723,2020-04-22,Luxembourg,3,60,3618,"rgb(231,41,138)"
16724,2020-04-23,Luxembourg,2,36,3654,"rgb(231,41,138)"
16725,2020-04-24,Luxembourg,3,11,3665,"rgb(231,41,138)"
16726,2020-04-25,Luxembourg,2,30,3695,"rgb(231,41,138)"
16727,2020-04-26,Luxembourg,0,16,3711,"rgb(231,41,138)"
16728,2020-04-27,Luxembourg,3,12,3723,"rgb(231,41,138)"
16729,2020-04-28,Luxembourg,0,6,3729,"rgb(231,41,138)"
16730,2020-04-29,Luxembourg,1,12,3741,"rgb(231,41,138)"
16731,2020-04-30,Luxembourg,0,28,3769,"rgb(231,41,138)"
16732,2020-05-01,Luxembourg,1,15,3784,"rgb(231,41,138)"
16733,2020-05-02,Luxembourg,2,18,3802,"rgb(231,41,138)"
16734,2020-05-03,Luxembourg,0,10,3812,"rgb(231,41,138)"
16735,2020-05-04,Luxembourg,4,12,3824,"rgb(231,41,138)"
16736,2020-05-05,Luxembourg,0,4,3828,"rgb(231,41,138)"
16737,2020-05-06,Luxembourg,0,12,3840,"rgb(231,41,138)"
16738,2020-05-07,Luxembourg,2,11,3851,"rgb(231,41,138)"
16739,2020-05-08,Luxembourg,2,8,3859,"rgb(231,41,138)"
16740,2020-05-09,Luxembourg,0,12,3871,"rgb(231,41,138)"
16741,2020-05-10,Luxembourg,1,6,3877,"rgb(231,41,138)"
16742,2020-05-11,Luxembourg,0,9,3886,"rgb(231,41,138)"
16743,2020-05-12,Luxembourg,0,2,3888,"rgb(231,41,138)"
16744,2020-05-13,Luxembourg,1,6,3894,"rgb(231,41,138)"
16745,2020-05-14,Luxembourg,1,10,3904,"rgb(231,41,138)"
16746,2020-05-15,Luxembourg,0,11,3915,"rgb(231,41,138)"
16747,2020-05-16,Luxembourg,1,8,3923,"rgb(231,41,138)"
16748,2020-05-17,Luxembourg,0,7,3930,"rgb(231,41,138)"
16749,2020-05-18,Luxembourg,3,15,3945,"rgb(231,41,138)"
16750,2020-05-19,Luxembourg,0,2,3947,"rgb(231,41,138)"
16751,2020-05-20,Luxembourg,2,11,3958,"rgb(231,41,138)"
16752,2020-05-21,Luxembourg,0,13,3971,"rgb(231,41,138)"
16753,2020-05-22,Luxembourg,0,9,3980,"rgb(231,41,138)"
16754,2020-05-23,Luxembourg,0,1,3981,"rgb(231,41,138)"
16755,2020-05-24,Luxembourg,0,9,3990,"rgb(231,41,138)"
16756,2020-05-25,Luxembourg,1,2,3992,"rgb(231,41,138)"
16757,2020-05-26,Luxembourg,0,1,3993,"rgb(231,41,138)"
16758,2020-05-27,Luxembourg,0,2,3995,"rgb(231,41,138)"
16759,2020-05-28,Luxembourg,0,6,4001,"rgb(231,41,138)"
16760,2020-05-29,Luxembourg,0,7,4008,"rgb(231,41,138)"
16761,2020-05-30,Luxembourg,0,4,4012,"rgb(231,41,138)"
16762,2020-05-31,Luxembourg,0,4,4016,"rgb(231,41,138)"
16763,2020-06-01,Luxembourg,0,2,4018,"rgb(231,41,138)"
16764,2020-06-02,Luxembourg,0,1,4019,"rgb(231,41,138)"
16765,2020-06-03,Luxembourg,0,1,4020,"rgb(231,41,138)"
16766,2020-06-04,Luxembourg,0,0,4020,"rgb(231,41,138)"
16767,2020-06-05,Luxembourg,0,7,4027,"rgb(231,41,138)"
16768,2020-06-06,Luxembourg,0,5,4032,"rgb(231,41,138)"
16769,2020-06-07,Luxembourg,0,3,4035,"rgb(231,41,138)"
16770,2020-06-08,Luxembourg,0,4,4039,"rgb(231,41,138)"
16771,2020-06-09,Luxembourg,0,1,4040,"rgb(231,41,138)"
16772,2020-06-10,Luxembourg,0,6,4046,"rgb(231,41,138)"
16773,2020-06-11,Luxembourg,0,3,4049,"rgb(231,41,138)"
16774,2020-06-12,Luxembourg,0,3,4052,"rgb(231,41,138)"
16775,2020-06-13,Luxembourg,0,3,4055,"rgb(231,41,138)"
16776,2020-06-14,Luxembourg,0,8,4063,"rgb(231,41,138)"
16777,2020-06-15,Luxembourg,0,7,4070,"rgb(231,41,138)"
16778,2020-06-16,Luxembourg,0,2,4072,"rgb(231,41,138)"
16779,2020-06-17,Luxembourg,0,3,4075,"rgb(231,41,138)"
16780,2020-06-18,Luxembourg,0,10,4085,"rgb(231,41,138)"
16781,2020-06-19,Luxembourg,0,6,4091,"rgb(231,41,138)"
16782,2020-06-20,Luxembourg,0,8,4099,"rgb(231,41,138)"
16783,2020-06-21,Luxembourg,0,6,4105,"rgb(231,41,138)"
16784,2020-06-22,Luxembourg,0,15,4120,"rgb(231,41,138)"
16785,2020-06-23,Luxembourg,0,1,4121,"rgb(231,41,138)"
16786,2020-06-24,Luxembourg,0,12,4133,"rgb(231,41,138)"
16787,2020-06-25,Luxembourg,0,7,4140,"rgb(231,41,138)"
16788,2020-06-26,Luxembourg,0,11,4151,"rgb(231,41,138)"
16789,2020-06-27,Luxembourg,0,22,4173,"rgb(231,41,138)"
16790,2020-06-28,Luxembourg,0,44,4217,"rgb(231,41,138)"
16791,2020-06-29,Luxembourg,0,25,4242,"rgb(231,41,138)"
16792,2020-06-30,Luxembourg,0,14,4256,"rgb(231,41,138)"
16793,2020-07-01,Luxembourg,0,43,4299,"rgb(231,41,138)"
16794,2020-07-02,Luxembourg,0,46,4345,"rgb(231,41,138)"
16795,2020-07-03,Luxembourg,0,50,4395,"rgb(231,41,138)"
16796,2020-07-04,Luxembourg,0,52,4447,"rgb(231,41,138)"
16797,2020-07-05,Luxembourg,0,29,4476,"rgb(231,41,138)"
16798,2020-07-06,Luxembourg,0,46,4522,"rgb(231,41,138)"
16799,2020-07-07,Luxembourg,0,20,4542,"rgb(231,41,138)"
16800,2020-07-08,Luxembourg,0,61,4603,"rgb(231,41,138)"
16801,2020-07-09,Luxembourg,0,47,4650,"rgb(231,41,138)"
16802,2020-07-10,Luxembourg,0,69,4719,"rgb(231,41,138)"
16803,2020-07-11,Luxembourg,0,58,4777,"rgb(231,41,138)"
16804,2020-07-12,Luxembourg,0,65,4842,"rgb(231,41,138)"
16805,2020-07-13,Luxembourg,1,83,4925,"rgb(231,41,138)"
16806,2020-03-03,Latvia,0,1,1,"rgb(102,166,30)"
16807,2020-03-08,Latvia,0,1,2,"rgb(102,166,30)"
16808,2020-03-09,Latvia,0,1,3,"rgb(102,166,30)"
16809,2020-03-10,Latvia,0,3,6,"rgb(102,166,30)"
16810,2020-03-11,Latvia,0,2,8,"rgb(102,166,30)"
16811,2020-03-12,Latvia,0,2,10,"rgb(102,166,30)"
16812,2020-03-13,Latvia,0,6,16,"rgb(102,166,30)"
16813,2020-03-14,Latvia,0,3,19,"rgb(102,166,30)"
16814,2020-03-15,Latvia,0,7,26,"rgb(102,166,30)"
16815,2020-03-16,Latvia,0,5,31,"rgb(102,166,30)"
16816,2020-03-17,Latvia,0,5,36,"rgb(102,166,30)"
16817,2020-03-18,Latvia,0,25,61,"rgb(102,166,30)"
16818,2020-03-19,Latvia,0,10,71,"rgb(102,166,30)"
16819,2020-03-20,Latvia,0,15,86,"rgb(102,166,30)"
16820,2020-03-21,Latvia,0,25,111,"rgb(102,166,30)"
16821,2020-03-22,Latvia,0,13,124,"rgb(102,166,30)"
16822,2020-03-23,Latvia,0,15,139,"rgb(102,166,30)"
16823,2020-03-24,Latvia,0,41,180,"rgb(102,166,30)"
16824,2020-03-25,Latvia,0,17,197,"rgb(102,166,30)"
16825,2020-03-26,Latvia,0,24,221,"rgb(102,166,30)"
16826,2020-03-27,Latvia,0,23,244,"rgb(102,166,30)"
16827,2020-03-28,Latvia,0,36,280,"rgb(102,166,30)"
16828,2020-03-29,Latvia,0,25,305,"rgb(102,166,30)"
16829,2020-03-30,Latvia,0,71,376,"rgb(102,166,30)"
16830,2020-03-31,Latvia,0,0,376,"rgb(102,166,30)"
16831,2020-04-01,Latvia,0,22,398,"rgb(102,166,30)"
16832,2020-04-02,Latvia,0,48,446,"rgb(102,166,30)"
16833,2020-04-03,Latvia,0,12,458,"rgb(102,166,30)"
16834,2020-04-04,Latvia,1,35,493,"rgb(102,166,30)"
16835,2020-04-05,Latvia,0,16,509,"rgb(102,166,30)"
16836,2020-04-06,Latvia,0,24,533,"rgb(102,166,30)"
16837,2020-04-07,Latvia,0,9,542,"rgb(102,166,30)"
16838,2020-04-08,Latvia,1,6,548,"rgb(102,166,30)"
16839,2020-04-09,Latvia,0,29,577,"rgb(102,166,30)"
16840,2020-04-10,Latvia,0,12,589,"rgb(102,166,30)"
16841,2020-04-11,Latvia,0,23,612,"rgb(102,166,30)"
16842,2020-04-12,Latvia,1,18,630,"rgb(102,166,30)"
16843,2020-04-13,Latvia,2,21,651,"rgb(102,166,30)"
16844,2020-04-14,Latvia,0,4,655,"rgb(102,166,30)"
16845,2020-04-15,Latvia,0,2,657,"rgb(102,166,30)"
16846,2020-04-16,Latvia,0,9,666,"rgb(102,166,30)"
16847,2020-04-17,Latvia,0,9,675,"rgb(102,166,30)"
16848,2020-04-18,Latvia,0,7,682,"rgb(102,166,30)"
16849,2020-04-19,Latvia,0,30,712,"rgb(102,166,30)"
16850,2020-04-20,Latvia,0,15,727,"rgb(102,166,30)"
16851,2020-04-21,Latvia,0,12,739,"rgb(102,166,30)"
16852,2020-04-22,Latvia,4,9,748,"rgb(102,166,30)"
16853,2020-04-23,Latvia,2,13,761,"rgb(102,166,30)"
16854,2020-04-24,Latvia,0,17,778,"rgb(102,166,30)"
16855,2020-04-25,Latvia,1,6,784,"rgb(102,166,30)"
16856,2020-04-26,Latvia,0,20,804,"rgb(102,166,30)"
16857,2020-04-27,Latvia,0,8,812,"rgb(102,166,30)"
16858,2020-04-28,Latvia,1,6,818,"rgb(102,166,30)"
16859,2020-04-29,Latvia,0,18,836,"rgb(102,166,30)"
16860,2020-04-30,Latvia,2,13,849,"rgb(102,166,30)"
16861,2020-05-01,Latvia,0,9,858,"rgb(102,166,30)"
16862,2020-05-02,Latvia,1,12,870,"rgb(102,166,30)"
16863,2020-05-03,Latvia,0,1,871,"rgb(102,166,30)"
16864,2020-05-04,Latvia,0,8,879,"rgb(102,166,30)"
16865,2020-05-05,Latvia,0,17,896,"rgb(102,166,30)"
16866,2020-05-06,Latvia,1,0,896,"rgb(102,166,30)"
16867,2020-05-07,Latvia,0,4,900,"rgb(102,166,30)"
16868,2020-05-08,Latvia,1,9,909,"rgb(102,166,30)"
16869,2020-05-09,Latvia,0,19,928,"rgb(102,166,30)"
16870,2020-05-10,Latvia,0,2,930,"rgb(102,166,30)"
16871,2020-05-11,Latvia,0,9,939,"rgb(102,166,30)"
16872,2020-05-12,Latvia,0,7,946,"rgb(102,166,30)"
16873,2020-05-13,Latvia,0,4,950,"rgb(102,166,30)"
16874,2020-05-14,Latvia,1,1,951,"rgb(102,166,30)"
16875,2020-05-15,Latvia,0,11,962,"rgb(102,166,30)"
16876,2020-05-16,Latvia,0,8,970,"rgb(102,166,30)"
16877,2020-05-17,Latvia,0,27,997,"rgb(102,166,30)"
16878,2020-05-18,Latvia,0,11,1008,"rgb(102,166,30)"
16879,2020-05-19,Latvia,0,1,1009,"rgb(102,166,30)"
16880,2020-05-20,Latvia,2,3,1012,"rgb(102,166,30)"
16881,2020-05-21,Latvia,0,4,1016,"rgb(102,166,30)"
16882,2020-05-22,Latvia,1,9,1025,"rgb(102,166,30)"
16883,2020-05-23,Latvia,0,5,1030,"rgb(102,166,30)"
16884,2020-05-24,Latvia,0,16,1046,"rgb(102,166,30)"
16885,2020-05-25,Latvia,0,1,1047,"rgb(102,166,30)"
16886,2020-05-26,Latvia,0,2,1049,"rgb(102,166,30)"
16887,2020-05-27,Latvia,0,4,1053,"rgb(102,166,30)"
16888,2020-05-28,Latvia,1,4,1057,"rgb(102,166,30)"
16889,2020-05-29,Latvia,1,4,1061,"rgb(102,166,30)"
16890,2020-05-30,Latvia,0,3,1064,"rgb(102,166,30)"
16891,2020-05-31,Latvia,0,1,1065,"rgb(102,166,30)"
16892,2020-06-01,Latvia,0,1,1066,"rgb(102,166,30)"
16893,2020-06-02,Latvia,0,5,1071,"rgb(102,166,30)"
16894,2020-06-03,Latvia,0,8,1079,"rgb(102,166,30)"
16895,2020-06-04,Latvia,0,0,1079,"rgb(102,166,30)"
16896,2020-06-05,Latvia,1,3,1082,"rgb(102,166,30)"
16897,2020-06-06,Latvia,0,0,1082,"rgb(102,166,30)"
16898,2020-06-07,Latvia,0,4,1086,"rgb(102,166,30)"
16899,2020-06-08,Latvia,0,2,1088,"rgb(102,166,30)"
16900,2020-06-09,Latvia,1,0,1088,"rgb(102,166,30)"
16901,2020-06-10,Latvia,0,1,1089,"rgb(102,166,30)"
16902,2020-06-11,Latvia,0,3,1092,"rgb(102,166,30)"
16903,2020-06-12,Latvia,0,2,1094,"rgb(102,166,30)"
16904,2020-06-13,Latvia,1,2,1096,"rgb(102,166,30)"
16905,2020-06-14,Latvia,1,1,1097,"rgb(102,166,30)"
16906,2020-06-15,Latvia,0,0,1097,"rgb(102,166,30)"
16907,2020-06-16,Latvia,0,0,1097,"rgb(102,166,30)"
16908,2020-06-17,Latvia,0,1,1098,"rgb(102,166,30)"
16909,2020-06-18,Latvia,2,6,1104,"rgb(102,166,30)"
16910,2020-06-19,Latvia,0,4,1108,"rgb(102,166,30)"
16911,2020-06-20,Latvia,0,2,1110,"rgb(102,166,30)"
16912,2020-06-21,Latvia,0,1,1111,"rgb(102,166,30)"
16913,2020-06-22,Latvia,0,0,1111,"rgb(102,166,30)"
16914,2020-06-23,Latvia,0,0,1111,"rgb(102,166,30)"
16915,2020-06-24,Latvia,0,0,1111,"rgb(102,166,30)"
16916,2020-06-25,Latvia,0,0,1111,"rgb(102,166,30)"
16917,2020-06-26,Latvia,0,0,1111,"rgb(102,166,30)"
16918,2020-06-27,Latvia,0,1,1112,"rgb(102,166,30)"
16919,2020-06-28,Latvia,0,3,1115,"rgb(102,166,30)"
16920,2020-06-29,Latvia,0,1,1116,"rgb(102,166,30)"
16921,2020-06-30,Latvia,0,1,1117,"rgb(102,166,30)"
16922,2020-07-01,Latvia,0,1,1118,"rgb(102,166,30)"
16923,2020-07-02,Latvia,0,3,1121,"rgb(102,166,30)"
16924,2020-07-03,Latvia,0,1,1122,"rgb(102,166,30)"
16925,2020-07-04,Latvia,0,0,1122,"rgb(102,166,30)"
16926,2020-07-05,Latvia,0,1,1123,"rgb(102,166,30)"
16927,2020-07-06,Latvia,0,1,1124,"rgb(102,166,30)"
16928,2020-07-07,Latvia,0,3,1127,"rgb(102,166,30)"
16929,2020-07-08,Latvia,0,7,1134,"rgb(102,166,30)"
16930,2020-07-09,Latvia,0,7,1141,"rgb(102,166,30)"
16931,2020-07-10,Latvia,0,13,1154,"rgb(102,166,30)"
16932,2020-07-11,Latvia,0,0,1154,"rgb(102,166,30)"
16933,2020-07-12,Latvia,0,19,1173,"rgb(102,166,30)"
16934,2020-07-13,Latvia,0,0,1173,"rgb(102,166,30)"
16935,2020-03-25,Libya,0,1,1,"rgb(230,171,2)"
16936,2020-03-26,Libya,0,0,1,"rgb(230,171,2)"
16937,2020-03-27,Libya,0,0,1,"rgb(230,171,2)"
16938,2020-03-28,Libya,0,0,1,"rgb(230,171,2)"
16939,2020-03-29,Libya,0,0,1,"rgb(230,171,2)"
16940,2020-03-30,Libya,0,7,8,"rgb(230,171,2)"
16941,2020-03-31,Libya,0,0,8,"rgb(230,171,2)"
16942,2020-04-01,Libya,0,2,10,"rgb(230,171,2)"
16943,2020-04-02,Libya,0,0,10,"rgb(230,171,2)"
16944,2020-04-03,Libya,1,1,11,"rgb(230,171,2)"
16945,2020-04-04,Libya,0,0,11,"rgb(230,171,2)"
16946,2020-04-05,Libya,0,7,18,"rgb(230,171,2)"
16947,2020-04-06,Libya,0,0,18,"rgb(230,171,2)"
16948,2020-04-07,Libya,0,0,18,"rgb(230,171,2)"
16949,2020-04-08,Libya,0,1,19,"rgb(230,171,2)"
16950,2020-04-09,Libya,0,2,21,"rgb(230,171,2)"
16951,2020-04-10,Libya,0,3,24,"rgb(230,171,2)"
16952,2020-04-11,Libya,0,0,24,"rgb(230,171,2)"
16953,2020-04-12,Libya,0,1,25,"rgb(230,171,2)"
16954,2020-04-13,Libya,0,0,25,"rgb(230,171,2)"
16955,2020-04-14,Libya,0,1,26,"rgb(230,171,2)"
16956,2020-04-15,Libya,0,9,35,"rgb(230,171,2)"
16957,2020-04-16,Libya,0,13,48,"rgb(230,171,2)"
16958,2020-04-17,Libya,0,1,49,"rgb(230,171,2)"
16959,2020-04-18,Libya,0,0,49,"rgb(230,171,2)"
16960,2020-04-19,Libya,0,0,49,"rgb(230,171,2)"
16961,2020-04-20,Libya,0,0,49,"rgb(230,171,2)"
16962,2020-04-21,Libya,0,2,51,"rgb(230,171,2)"
16963,2020-04-22,Libya,0,0,51,"rgb(230,171,2)"
16964,2020-04-23,Libya,0,8,59,"rgb(230,171,2)"
16965,2020-04-24,Libya,1,1,60,"rgb(230,171,2)"
16966,2020-04-25,Libya,0,1,61,"rgb(230,171,2)"
16967,2020-04-26,Libya,0,0,61,"rgb(230,171,2)"
16968,2020-04-27,Libya,0,0,61,"rgb(230,171,2)"
16969,2020-04-28,Libya,0,0,61,"rgb(230,171,2)"
16970,2020-04-29,Libya,0,0,61,"rgb(230,171,2)"
16971,2020-04-30,Libya,0,0,61,"rgb(230,171,2)"
16972,2020-05-01,Libya,1,0,61,"rgb(230,171,2)"
16973,2020-05-02,Libya,0,2,63,"rgb(230,171,2)"
16974,2020-05-03,Libya,0,0,63,"rgb(230,171,2)"
16975,2020-05-04,Libya,0,0,63,"rgb(230,171,2)"
16976,2020-05-05,Libya,0,0,63,"rgb(230,171,2)"
16977,2020-05-06,Libya,0,0,63,"rgb(230,171,2)"
16978,2020-05-07,Libya,0,1,64,"rgb(230,171,2)"
16979,2020-05-08,Libya,0,0,64,"rgb(230,171,2)"
16980,2020-05-09,Libya,0,0,64,"rgb(230,171,2)"
16981,2020-05-10,Libya,0,0,64,"rgb(230,171,2)"
16982,2020-05-11,Libya,0,0,64,"rgb(230,171,2)"
16983,2020-05-12,Libya,0,0,64,"rgb(230,171,2)"
16984,2020-05-13,Libya,0,0,64,"rgb(230,171,2)"
16985,2020-05-14,Libya,0,0,64,"rgb(230,171,2)"
16986,2020-05-15,Libya,0,0,64,"rgb(230,171,2)"
16987,2020-05-16,Libya,0,0,64,"rgb(230,171,2)"
16988,2020-05-17,Libya,0,1,65,"rgb(230,171,2)"
16989,2020-05-18,Libya,0,0,65,"rgb(230,171,2)"
16990,2020-05-19,Libya,0,0,65,"rgb(230,171,2)"
16991,2020-05-20,Libya,0,3,68,"rgb(230,171,2)"
16992,2020-05-21,Libya,0,1,69,"rgb(230,171,2)"
16993,2020-05-22,Libya,0,2,71,"rgb(230,171,2)"
16994,2020-05-23,Libya,0,1,72,"rgb(230,171,2)"
16995,2020-05-24,Libya,0,3,75,"rgb(230,171,2)"
16996,2020-05-25,Libya,0,0,75,"rgb(230,171,2)"
16997,2020-05-26,Libya,0,0,75,"rgb(230,171,2)"
16998,2020-05-27,Libya,0,2,77,"rgb(230,171,2)"
16999,2020-05-28,Libya,1,22,99,"rgb(230,171,2)"
17000,2020-05-29,Libya,1,6,105,"rgb(230,171,2)"
17001,2020-05-30,Libya,0,13,118,"rgb(230,171,2)"
17002,2020-05-31,Libya,0,12,130,"rgb(230,171,2)"
17003,2020-06-01,Libya,0,26,156,"rgb(230,171,2)"
17004,2020-06-02,Libya,0,12,168,"rgb(230,171,2)"
17005,2020-06-03,Libya,0,14,182,"rgb(230,171,2)"
17006,2020-06-04,Libya,0,14,196,"rgb(230,171,2)"
17007,2020-06-05,Libya,0,0,196,"rgb(230,171,2)"
17008,2020-06-06,Libya,0,43,239,"rgb(230,171,2)"
17009,2020-06-07,Libya,0,17,256,"rgb(230,171,2)"
17010,2020-06-08,Libya,0,0,256,"rgb(230,171,2)"
17011,2020-06-09,Libya,0,14,270,"rgb(230,171,2)"
17012,2020-06-10,Libya,0,62,332,"rgb(230,171,2)"
17013,2020-06-11,Libya,0,46,378,"rgb(230,171,2)"
17014,2020-06-12,Libya,0,15,393,"rgb(230,171,2)"
17015,2020-06-13,Libya,1,16,409,"rgb(230,171,2)"
17016,2020-06-14,Libya,2,9,418,"rgb(230,171,2)"
17017,2020-06-15,Libya,0,0,418,"rgb(230,171,2)"
17018,2020-06-16,Libya,2,49,467,"rgb(230,171,2)"
17019,2020-06-17,Libya,0,0,467,"rgb(230,171,2)"
17020,2020-06-18,Libya,0,0,467,"rgb(230,171,2)"
17021,2020-06-19,Libya,0,33,500,"rgb(230,171,2)"
17022,2020-06-20,Libya,0,10,510,"rgb(230,171,2)"
17023,2020-06-21,Libya,0,10,520,"rgb(230,171,2)"
17024,2020-06-22,Libya,0,24,544,"rgb(230,171,2)"
17025,2020-06-23,Libya,0,27,571,"rgb(230,171,2)"
17026,2020-06-24,Libya,7,68,639,"rgb(230,171,2)"
17027,2020-06-25,Libya,1,0,639,"rgb(230,171,2)"
17028,2020-06-26,Libya,0,59,698,"rgb(230,171,2)"
17029,2020-06-27,Libya,0,0,698,"rgb(230,171,2)"
17030,2020-06-28,Libya,0,15,713,"rgb(230,171,2)"
17031,2020-06-29,Libya,3,49,762,"rgb(230,171,2)"
17032,2020-06-30,Libya,0,0,762,"rgb(230,171,2)"
17033,2020-07-01,Libya,3,62,824,"rgb(230,171,2)"
17034,2020-07-02,Libya,0,34,858,"rgb(230,171,2)"
17035,2020-07-03,Libya,2,33,891,"rgb(230,171,2)"
17036,2020-07-04,Libya,1,27,918,"rgb(230,171,2)"
17037,2020-07-05,Libya,0,71,989,"rgb(230,171,2)"
17038,2020-07-06,Libya,0,0,989,"rgb(230,171,2)"
17039,2020-07-07,Libya,5,57,1046,"rgb(230,171,2)"
17040,2020-07-08,Libya,3,136,1182,"rgb(230,171,2)"
17041,2020-07-09,Libya,0,0,1182,"rgb(230,171,2)"
17042,2020-07-10,Libya,1,86,1268,"rgb(230,171,2)"
17043,2020-07-11,Libya,2,74,1342,"rgb(230,171,2)"
17044,2020-07-12,Libya,0,47,1389,"rgb(230,171,2)"
17045,2020-07-13,Libya,1,44,1433,"rgb(230,171,2)"
17046,2020-03-03,Morocco,0,1,1,"rgb(166,118,29)"
17047,2020-03-06,Morocco,0,1,2,"rgb(166,118,29)"
17048,2020-03-12,Morocco,1,3,5,"rgb(166,118,29)"
17049,2020-03-13,Morocco,0,1,6,"rgb(166,118,29)"
17050,2020-03-14,Morocco,0,1,7,"rgb(166,118,29)"
17051,2020-03-15,Morocco,0,11,18,"rgb(166,118,29)"
17052,2020-03-16,Morocco,0,10,28,"rgb(166,118,29)"
17053,2020-03-17,Morocco,0,9,37,"rgb(166,118,29)"
17054,2020-03-18,Morocco,1,7,44,"rgb(166,118,29)"
17055,2020-03-19,Morocco,0,10,54,"rgb(166,118,29)"
17056,2020-03-20,Morocco,0,9,63,"rgb(166,118,29)"
17057,2020-03-21,Morocco,1,23,86,"rgb(166,118,29)"
17058,2020-03-22,Morocco,0,10,96,"rgb(166,118,29)"
17059,2020-03-23,Morocco,1,19,115,"rgb(166,118,29)"
17060,2020-03-24,Morocco,0,19,134,"rgb(166,118,29)"
17061,2020-03-25,Morocco,1,36,170,"rgb(166,118,29)"
17062,2020-03-26,Morocco,1,55,225,"rgb(166,118,29)"
17063,2020-03-27,Morocco,4,50,275,"rgb(166,118,29)"
17064,2020-03-28,Morocco,13,70,345,"rgb(166,118,29)"
17065,2020-03-29,Morocco,0,13,358,"rgb(166,118,29)"
17066,2020-03-30,Morocco,3,121,479,"rgb(166,118,29)"
17067,2020-03-31,Morocco,7,77,556,"rgb(166,118,29)"
17068,2020-04-01,Morocco,3,61,617,"rgb(166,118,29)"
17069,2020-04-02,Morocco,3,37,654,"rgb(166,118,29)"
17070,2020-04-03,Morocco,5,54,708,"rgb(166,118,29)"
17071,2020-04-04,Morocco,0,0,708,"rgb(166,118,29)"
17072,2020-04-05,Morocco,15,211,919,"rgb(166,118,29)"
17073,2020-04-06,Morocco,11,102,1021,"rgb(166,118,29)"
17074,2020-04-07,Morocco,10,99,1120,"rgb(166,118,29)"
17075,2020-04-08,Morocco,10,64,1184,"rgb(166,118,29)"
17076,2020-04-09,Morocco,3,91,1275,"rgb(166,118,29)"
17077,2020-04-10,Morocco,4,99,1374,"rgb(166,118,29)"
17078,2020-04-11,Morocco,10,74,1448,"rgb(166,118,29)"
17079,2020-04-12,Morocco,4,97,1545,"rgb(166,118,29)"
17080,2020-04-13,Morocco,7,116,1661,"rgb(166,118,29)"
17081,2020-04-14,Morocco,8,102,1763,"rgb(166,118,29)"
17082,2020-04-15,Morocco,0,125,1888,"rgb(166,118,29)"
17083,2020-04-16,Morocco,1,136,2024,"rgb(166,118,29)"
17084,2020-04-17,Morocco,3,259,2283,"rgb(166,118,29)"
17085,2020-04-18,Morocco,5,281,2564,"rgb(166,118,29)"
17086,2020-04-19,Morocco,2,121,2685,"rgb(166,118,29)"
17087,2020-04-20,Morocco,4,170,2855,"rgb(166,118,29)"
17088,2020-04-21,Morocco,2,191,3046,"rgb(166,118,29)"
17089,2020-04-22,Morocco,2,163,3209,"rgb(166,118,29)"
17090,2020-04-23,Morocco,4,168,3377,"rgb(166,118,29)"
17091,2020-04-24,Morocco,6,191,3568,"rgb(166,118,29)"
17092,2020-04-25,Morocco,3,190,3758,"rgb(166,118,29)"
17093,2020-04-26,Morocco,1,139,3897,"rgb(166,118,29)"
17094,2020-04-27,Morocco,2,168,4065,"rgb(166,118,29)"
17095,2020-04-28,Morocco,1,55,4120,"rgb(166,118,29)"
17096,2020-04-29,Morocco,3,132,4252,"rgb(166,118,29)"
17097,2020-04-30,Morocco,3,69,4321,"rgb(166,118,29)"
17098,2020-05-01,Morocco,2,102,4423,"rgb(166,118,29)"
17099,2020-05-02,Morocco,1,146,4569,"rgb(166,118,29)"
17100,2020-05-03,Morocco,2,160,4729,"rgb(166,118,29)"
17101,2020-05-04,Morocco,1,174,4903,"rgb(166,118,29)"
17102,2020-05-05,Morocco,5,140,5043,"rgb(166,118,29)"
17103,2020-05-06,Morocco,2,176,5219,"rgb(166,118,29)"
17104,2020-05-07,Morocco,2,189,5408,"rgb(166,118,29)"
17105,2020-05-08,Morocco,0,140,5548,"rgb(166,118,29)"
17106,2020-05-09,Morocco,3,163,5711,"rgb(166,118,29)"
17107,2020-05-10,Morocco,0,199,5910,"rgb(166,118,29)"
17108,2020-05-11,Morocco,2,153,6063,"rgb(166,118,29)"
17109,2020-05-12,Morocco,0,218,6281,"rgb(166,118,29)"
17110,2020-05-13,Morocco,0,137,6418,"rgb(166,118,29)"
17111,2020-05-14,Morocco,0,94,6512,"rgb(166,118,29)"
17112,2020-05-15,Morocco,2,95,6607,"rgb(166,118,29)"
17113,2020-05-16,Morocco,0,45,6652,"rgb(166,118,29)"
17114,2020-05-17,Morocco,2,89,6741,"rgb(166,118,29)"
17115,2020-05-18,Morocco,0,129,6870,"rgb(166,118,29)"
17116,2020-05-19,Morocco,0,82,6952,"rgb(166,118,29)"
17117,2020-05-20,Morocco,1,71,7023,"rgb(166,118,29)"
17118,2020-05-21,Morocco,1,110,7133,"rgb(166,118,29)"
17119,2020-05-22,Morocco,2,78,7211,"rgb(166,118,29)"
17120,2020-05-23,Morocco,1,121,7332,"rgb(166,118,29)"
17121,2020-05-24,Morocco,1,74,7406,"rgb(166,118,29)"
17122,2020-05-25,Morocco,1,27,7433,"rgb(166,118,29)"
17123,2020-05-26,Morocco,1,99,7532,"rgb(166,118,29)"
17124,2020-05-27,Morocco,2,45,7577,"rgb(166,118,29)"
17125,2020-05-28,Morocco,0,24,7601,"rgb(166,118,29)"
17126,2020-05-29,Morocco,0,42,7643,"rgb(166,118,29)"
17127,2020-05-30,Morocco,0,71,7714,"rgb(166,118,29)"
17128,2020-05-31,Morocco,2,66,7780,"rgb(166,118,29)"
17129,2020-06-01,Morocco,1,27,7807,"rgb(166,118,29)"
17130,2020-06-02,Morocco,0,26,7833,"rgb(166,118,29)"
17131,2020-06-03,Morocco,1,33,7866,"rgb(166,118,29)"
17132,2020-06-04,Morocco,0,56,7922,"rgb(166,118,29)"
17133,2020-06-05,Morocco,2,81,8003,"rgb(166,118,29)"
17134,2020-06-06,Morocco,0,68,8071,"rgb(166,118,29)"
17135,2020-06-07,Morocco,0,61,8132,"rgb(166,118,29)"
17136,2020-06-08,Morocco,0,92,8224,"rgb(166,118,29)"
17137,2020-06-09,Morocco,0,78,8302,"rgb(166,118,29)"
17138,2020-06-10,Morocco,2,135,8437,"rgb(166,118,29)"
17139,2020-06-11,Morocco,0,18,8455,"rgb(166,118,29)"
17140,2020-06-12,Morocco,1,82,8537,"rgb(166,118,29)"
17141,2020-06-13,Morocco,1,73,8610,"rgb(166,118,29)"
17142,2020-06-14,Morocco,0,82,8692,"rgb(166,118,29)"
17143,2020-06-15,Morocco,0,42,8734,"rgb(166,118,29)"
17144,2020-06-16,Morocco,0,104,8838,"rgb(166,118,29)"
17145,2020-06-17,Morocco,0,83,8921,"rgb(166,118,29)"
17146,2020-06-18,Morocco,1,76,8997,"rgb(166,118,29)"
17147,2020-06-19,Morocco,0,77,9074,"rgb(166,118,29)"
17148,2020-06-20,Morocco,0,539,9613,"rgb(166,118,29)"
17149,2020-06-21,Morocco,0,188,9801,"rgb(166,118,29)"
17150,2020-06-22,Morocco,1,176,9977,"rgb(166,118,29)"
17151,2020-06-23,Morocco,0,195,10172,"rgb(166,118,29)"
17152,2020-06-24,Morocco,0,92,10264,"rgb(166,118,29)"
17153,2020-06-25,Morocco,2,643,10907,"rgb(166,118,29)"
17154,2020-06-26,Morocco,1,431,11338,"rgb(166,118,29)"
17155,2020-06-27,Morocco,1,295,11633,"rgb(166,118,29)"
17156,2020-06-28,Morocco,2,244,11877,"rgb(166,118,29)"
17157,2020-06-29,Morocco,1,175,12052,"rgb(166,118,29)"
17158,2020-06-30,Morocco,4,238,12290,"rgb(166,118,29)"
17159,2020-07-01,Morocco,3,243,12533,"rgb(166,118,29)"
17160,2020-07-02,Morocco,0,103,12636,"rgb(166,118,29)"
17161,2020-07-03,Morocco,1,333,12969,"rgb(166,118,29)"
17162,2020-07-04,Morocco,1,319,13288,"rgb(166,118,29)"
17163,2020-07-05,Morocco,2,534,13822,"rgb(166,118,29)"
17164,2020-07-06,Morocco,3,393,14215,"rgb(166,118,29)"
17165,2020-07-07,Morocco,0,114,14329,"rgb(166,118,29)"
17166,2020-07-08,Morocco,0,0,14329,"rgb(166,118,29)"
17167,2020-07-09,Morocco,7,442,14771,"rgb(166,118,29)"
17168,2020-07-10,Morocco,0,178,14949,"rgb(166,118,29)"
17169,2020-07-11,Morocco,1,379,15328,"rgb(166,118,29)"
17170,2020-07-12,Morocco,2,214,15542,"rgb(166,118,29)"
17171,2020-07-13,Morocco,5,203,15745,"rgb(166,118,29)"
17172,2019-12-31,Monaco,0,0,0,"rgb(102,102,102)"
17173,2020-01-01,Monaco,0,0,0,"rgb(102,102,102)"
17174,2020-01-02,Monaco,0,0,0,"rgb(102,102,102)"
17175,2020-01-03,Monaco,0,0,0,"rgb(102,102,102)"
17176,2020-01-04,Monaco,0,0,0,"rgb(102,102,102)"
17177,2020-01-05,Monaco,0,0,0,"rgb(102,102,102)"
17178,2020-01-06,Monaco,0,0,0,"rgb(102,102,102)"
17179,2020-01-07,Monaco,0,0,0,"rgb(102,102,102)"
17180,2020-01-08,Monaco,0,0,0,"rgb(102,102,102)"
17181,2020-01-09,Monaco,0,0,0,"rgb(102,102,102)"
17182,2020-01-10,Monaco,0,0,0,"rgb(102,102,102)"
17183,2020-01-11,Monaco,0,0,0,"rgb(102,102,102)"
17184,2020-01-12,Monaco,0,0,0,"rgb(102,102,102)"
17185,2020-01-13,Monaco,0,0,0,"rgb(102,102,102)"
17186,2020-01-14,Monaco,0,0,0,"rgb(102,102,102)"
17187,2020-01-15,Monaco,0,0,0,"rgb(102,102,102)"
17188,2020-01-16,Monaco,0,0,0,"rgb(102,102,102)"
17189,2020-01-17,Monaco,0,0,0,"rgb(102,102,102)"
17190,2020-01-18,Monaco,0,0,0,"rgb(102,102,102)"
17191,2020-01-19,Monaco,0,0,0,"rgb(102,102,102)"
17192,2020-01-20,Monaco,0,0,0,"rgb(102,102,102)"
17193,2020-01-21,Monaco,0,0,0,"rgb(102,102,102)"
17194,2020-01-22,Monaco,0,0,0,"rgb(102,102,102)"
17195,2020-01-23,Monaco,0,0,0,"rgb(102,102,102)"
17196,2020-01-24,Monaco,0,0,0,"rgb(102,102,102)"
17197,2020-01-25,Monaco,0,0,0,"rgb(102,102,102)"
17198,2020-01-26,Monaco,0,0,0,"rgb(102,102,102)"
17199,2020-01-27,Monaco,0,0,0,"rgb(102,102,102)"
17200,2020-01-28,Monaco,0,0,0,"rgb(102,102,102)"
17201,2020-01-29,Monaco,0,0,0,"rgb(102,102,102)"
17202,2020-01-30,Monaco,0,0,0,"rgb(102,102,102)"
17203,2020-01-31,Monaco,0,0,0,"rgb(102,102,102)"
17204,2020-02-01,Monaco,0,0,0,"rgb(102,102,102)"
17205,2020-02-02,Monaco,0,0,0,"rgb(102,102,102)"
17206,2020-02-03,Monaco,0,0,0,"rgb(102,102,102)"
17207,2020-02-04,Monaco,0,0,0,"rgb(102,102,102)"
17208,2020-02-05,Monaco,0,0,0,"rgb(102,102,102)"
17209,2020-02-06,Monaco,0,0,0,"rgb(102,102,102)"
17210,2020-02-07,Monaco,0,0,0,"rgb(102,102,102)"
17211,2020-02-08,Monaco,0,0,0,"rgb(102,102,102)"
17212,2020-02-09,Monaco,0,0,0,"rgb(102,102,102)"
17213,2020-02-10,Monaco,0,0,0,"rgb(102,102,102)"
17214,2020-02-11,Monaco,0,0,0,"rgb(102,102,102)"
17215,2020-02-12,Monaco,0,0,0,"rgb(102,102,102)"
17216,2020-02-13,Monaco,0,0,0,"rgb(102,102,102)"
17217,2020-02-14,Monaco,0,0,0,"rgb(102,102,102)"
17218,2020-02-15,Monaco,0,0,0,"rgb(102,102,102)"
17219,2020-02-16,Monaco,0,0,0,"rgb(102,102,102)"
17220,2020-02-17,Monaco,0,0,0,"rgb(102,102,102)"
17221,2020-02-18,Monaco,0,0,0,"rgb(102,102,102)"
17222,2020-02-19,Monaco,0,0,0,"rgb(102,102,102)"
17223,2020-02-20,Monaco,0,0,0,"rgb(102,102,102)"
17224,2020-02-21,Monaco,0,0,0,"rgb(102,102,102)"
17225,2020-02-22,Monaco,0,0,0,"rgb(102,102,102)"
17226,2020-02-23,Monaco,0,0,0,"rgb(102,102,102)"
17227,2020-02-24,Monaco,0,0,0,"rgb(102,102,102)"
17228,2020-02-25,Monaco,0,0,0,"rgb(102,102,102)"
17229,2020-02-26,Monaco,0,0,0,"rgb(102,102,102)"
17230,2020-02-27,Monaco,0,0,0,"rgb(102,102,102)"
17231,2020-02-28,Monaco,0,0,0,"rgb(102,102,102)"
17232,2020-02-29,Monaco,0,1,1,"rgb(102,102,102)"
17233,2020-03-01,Monaco,0,0,1,"rgb(102,102,102)"
17234,2020-03-02,Monaco,0,0,1,"rgb(102,102,102)"
17235,2020-03-15,Monaco,0,2,3,"rgb(102,102,102)"
17236,2020-03-16,Monaco,0,4,7,"rgb(102,102,102)"
17237,2020-03-17,Monaco,0,2,9,"rgb(102,102,102)"
17238,2020-03-18,Monaco,0,0,9,"rgb(102,102,102)"
17239,2020-03-19,Monaco,0,0,9,"rgb(102,102,102)"
17240,2020-03-20,Monaco,0,2,11,"rgb(102,102,102)"
17241,2020-03-21,Monaco,0,1,12,"rgb(102,102,102)"
17242,2020-03-22,Monaco,0,6,18,"rgb(102,102,102)"
17243,2020-03-23,Monaco,0,5,23,"rgb(102,102,102)"
17244,2020-03-24,Monaco,0,0,23,"rgb(102,102,102)"
17245,2020-03-25,Monaco,0,4,27,"rgb(102,102,102)"
17246,2020-03-26,Monaco,0,4,31,"rgb(102,102,102)"
17247,2020-03-27,Monaco,0,2,33,"rgb(102,102,102)"
17248,2020-03-28,Monaco,0,9,42,"rgb(102,102,102)"
17249,2020-03-29,Monaco,0,1,43,"rgb(102,102,102)"
17250,2020-03-30,Monaco,0,3,46,"rgb(102,102,102)"
17251,2020-03-31,Monaco,0,3,49,"rgb(102,102,102)"
17252,2020-04-01,Monaco,0,3,52,"rgb(102,102,102)"
17253,2020-04-02,Monaco,0,3,55,"rgb(102,102,102)"
17254,2020-04-03,Monaco,0,5,60,"rgb(102,102,102)"
17255,2020-04-04,Monaco,0,4,64,"rgb(102,102,102)"
17256,2020-04-05,Monaco,2,2,66,"rgb(102,102,102)"
17257,2020-04-06,Monaco,0,7,73,"rgb(102,102,102)"
17258,2020-04-07,Monaco,0,4,77,"rgb(102,102,102)"
17259,2020-04-08,Monaco,0,2,79,"rgb(102,102,102)"
17260,2020-04-09,Monaco,0,2,81,"rgb(102,102,102)"
17261,2020-04-10,Monaco,0,3,84,"rgb(102,102,102)"
17262,2020-04-11,Monaco,0,6,90,"rgb(102,102,102)"
17263,2020-04-12,Monaco,0,2,92,"rgb(102,102,102)"
17264,2020-04-13,Monaco,0,1,93,"rgb(102,102,102)"
17265,2020-04-14,Monaco,0,0,93,"rgb(102,102,102)"
17266,2020-04-15,Monaco,0,0,93,"rgb(102,102,102)"
17267,2020-04-16,Monaco,1,0,93,"rgb(102,102,102)"
17268,2020-04-17,Monaco,0,0,93,"rgb(102,102,102)"
17269,2020-04-18,Monaco,0,1,94,"rgb(102,102,102)"
17270,2020-04-19,Monaco,0,0,94,"rgb(102,102,102)"
17271,2020-04-20,Monaco,0,0,94,"rgb(102,102,102)"
17272,2020-04-21,Monaco,0,0,94,"rgb(102,102,102)"
17273,2020-04-22,Monaco,0,0,94,"rgb(102,102,102)"
17274,2020-04-23,Monaco,0,0,94,"rgb(102,102,102)"
17275,2020-04-24,Monaco,1,0,94,"rgb(102,102,102)"
17276,2020-04-25,Monaco,0,0,94,"rgb(102,102,102)"
17277,2020-04-26,Monaco,0,0,94,"rgb(102,102,102)"
17278,2020-04-27,Monaco,0,0,94,"rgb(102,102,102)"
17279,2020-04-28,Monaco,0,1,95,"rgb(102,102,102)"
17280,2020-04-29,Monaco,0,0,95,"rgb(102,102,102)"
17281,2020-04-30,Monaco,0,0,95,"rgb(102,102,102)"
17282,2020-05-01,Monaco,0,0,95,"rgb(102,102,102)"
17283,2020-05-02,Monaco,0,0,95,"rgb(102,102,102)"
17284,2020-05-03,Monaco,0,0,95,"rgb(102,102,102)"
17285,2020-05-04,Monaco,0,0,95,"rgb(102,102,102)"
17286,2020-05-05,Monaco,0,0,95,"rgb(102,102,102)"
17287,2020-05-06,Monaco,0,0,95,"rgb(102,102,102)"
17288,2020-05-07,Monaco,0,0,95,"rgb(102,102,102)"
17289,2020-05-08,Monaco,0,0,95,"rgb(102,102,102)"
17290,2020-05-09,Monaco,0,0,95,"rgb(102,102,102)"
17291,2020-05-10,Monaco,0,1,96,"rgb(102,102,102)"
17292,2020-05-11,Monaco,0,0,96,"rgb(102,102,102)"
17293,2020-05-12,Monaco,0,0,96,"rgb(102,102,102)"
17294,2020-05-13,Monaco,0,0,96,"rgb(102,102,102)"
17295,2020-05-14,Monaco,0,0,96,"rgb(102,102,102)"
17296,2020-05-15,Monaco,0,0,96,"rgb(102,102,102)"
17297,2020-05-16,Monaco,1,0,96,"rgb(102,102,102)"
17298,2020-05-17,Monaco,0,0,96,"rgb(102,102,102)"
17299,2020-05-18,Monaco,0,0,96,"rgb(102,102,102)"
17300,2020-05-19,Monaco,0,1,97,"rgb(102,102,102)"
17301,2020-05-20,Monaco,0,0,97,"rgb(102,102,102)"
17302,2020-05-21,Monaco,0,0,97,"rgb(102,102,102)"
17303,2020-05-22,Monaco,0,0,97,"rgb(102,102,102)"
17304,2020-05-23,Monaco,0,0,97,"rgb(102,102,102)"
17305,2020-05-24,Monaco,0,1,98,"rgb(102,102,102)"
17306,2020-05-25,Monaco,0,0,98,"rgb(102,102,102)"
17307,2020-05-26,Monaco,0,0,98,"rgb(102,102,102)"
17308,2020-05-27,Monaco,0,0,98,"rgb(102,102,102)"
17309,2020-05-28,Monaco,0,0,98,"rgb(102,102,102)"
17310,2020-05-29,Monaco,0,0,98,"rgb(102,102,102)"
17311,2020-05-30,Monaco,0,0,98,"rgb(102,102,102)"
17312,2020-05-31,Monaco,0,1,99,"rgb(102,102,102)"
17313,2020-06-01,Monaco,0,0,99,"rgb(102,102,102)"
17314,2020-06-02,Monaco,0,0,99,"rgb(102,102,102)"
17315,2020-06-03,Monaco,0,0,99,"rgb(102,102,102)"
17316,2020-06-04,Monaco,0,0,99,"rgb(102,102,102)"
17317,2020-06-05,Monaco,0,0,99,"rgb(102,102,102)"
17318,2020-06-06,Monaco,0,0,99,"rgb(102,102,102)"
17319,2020-06-07,Monaco,0,0,99,"rgb(102,102,102)"
17320,2020-06-08,Monaco,0,0,99,"rgb(102,102,102)"
17321,2020-06-09,Monaco,0,0,99,"rgb(102,102,102)"
17322,2020-06-10,Monaco,0,0,99,"rgb(102,102,102)"
17323,2020-06-11,Monaco,0,0,99,"rgb(102,102,102)"
17324,2020-06-12,Monaco,0,0,99,"rgb(102,102,102)"
17325,2020-06-13,Monaco,0,0,99,"rgb(102,102,102)"
17326,2020-06-14,Monaco,0,0,99,"rgb(102,102,102)"
17327,2020-06-15,Monaco,0,0,99,"rgb(102,102,102)"
17328,2020-06-16,Monaco,0,0,99,"rgb(102,102,102)"
17329,2020-06-17,Monaco,0,0,99,"rgb(102,102,102)"
17330,2020-06-18,Monaco,0,0,99,"rgb(102,102,102)"
17331,2020-06-19,Monaco,0,0,99,"rgb(102,102,102)"
17332,2020-06-20,Monaco,0,0,99,"rgb(102,102,102)"
17333,2020-06-21,Monaco,0,0,99,"rgb(102,102,102)"
17334,2020-06-22,Monaco,0,1,100,"rgb(102,102,102)"
17335,2020-06-23,Monaco,0,1,101,"rgb(102,102,102)"
17336,2020-06-24,Monaco,0,0,101,"rgb(102,102,102)"
17337,2020-06-25,Monaco,0,1,102,"rgb(102,102,102)"
17338,2020-06-26,Monaco,0,0,102,"rgb(102,102,102)"
17339,2020-06-27,Monaco,0,0,102,"rgb(102,102,102)"
17340,2020-06-28,Monaco,0,1,103,"rgb(102,102,102)"
17341,2020-06-29,Monaco,0,0,103,"rgb(102,102,102)"
17342,2020-06-30,Monaco,0,0,103,"rgb(102,102,102)"
17343,2020-07-01,Monaco,0,0,103,"rgb(102,102,102)"
17344,2020-07-02,Monaco,0,0,103,"rgb(102,102,102)"
17345,2020-07-03,Monaco,0,3,106,"rgb(102,102,102)"
17346,2020-07-04,Monaco,0,0,106,"rgb(102,102,102)"
17347,2020-07-05,Monaco,0,0,106,"rgb(102,102,102)"
17348,2020-07-06,Monaco,0,2,108,"rgb(102,102,102)"
17349,2020-07-07,Monaco,0,0,108,"rgb(102,102,102)"
17350,2020-07-08,Monaco,0,0,108,"rgb(102,102,102)"
17351,2020-07-09,Monaco,0,0,108,"rgb(102,102,102)"
17352,2020-07-10,Monaco,0,0,108,"rgb(102,102,102)"
17353,2020-07-11,Monaco,0,0,108,"rgb(102,102,102)"
17354,2020-07-12,Monaco,0,1,109,"rgb(102,102,102)"
17355,2020-07-13,Monaco,0,0,109,"rgb(102,102,102)"
17356,2020-03-08,Moldova,0,1,1,"rgb(102, 197, 204)"
17357,2020-03-11,Moldova,0,2,3,"rgb(102, 197, 204)"
17358,2020-03-12,Moldova,0,1,4,"rgb(102, 197, 204)"
17359,2020-03-13,Moldova,0,2,6,"rgb(102, 197, 204)"
17360,2020-03-14,Moldova,0,2,8,"rgb(102, 197, 204)"
17361,2020-03-15,Moldova,0,12,20,"rgb(102, 197, 204)"
17362,2020-03-16,Moldova,0,3,23,"rgb(102, 197, 204)"
17363,2020-03-17,Moldova,0,6,29,"rgb(102, 197, 204)"
17364,2020-03-18,Moldova,0,1,30,"rgb(102, 197, 204)"
17365,2020-03-19,Moldova,1,6,36,"rgb(102, 197, 204)"
17366,2020-03-20,Moldova,0,13,49,"rgb(102, 197, 204)"
17367,2020-03-21,Moldova,0,17,66,"rgb(102, 197, 204)"
17368,2020-03-22,Moldova,0,14,80,"rgb(102, 197, 204)"
17369,2020-03-23,Moldova,0,14,94,"rgb(102, 197, 204)"
17370,2020-03-24,Moldova,0,15,109,"rgb(102, 197, 204)"
17371,2020-03-25,Moldova,0,16,125,"rgb(102, 197, 204)"
17372,2020-03-26,Moldova,0,24,149,"rgb(102, 197, 204)"
17373,2020-03-27,Moldova,0,28,177,"rgb(102, 197, 204)"
17374,2020-03-28,Moldova,1,22,199,"rgb(102, 197, 204)"
17375,2020-03-29,Moldova,0,32,231,"rgb(102, 197, 204)"
17376,2020-03-30,Moldova,0,32,263,"rgb(102, 197, 204)"
17377,2020-03-31,Moldova,0,35,298,"rgb(102, 197, 204)"
17378,2020-04-01,Moldova,2,55,353,"rgb(102, 197, 204)"
17379,2020-04-02,Moldova,1,70,423,"rgb(102, 197, 204)"
17380,2020-04-03,Moldova,1,82,505,"rgb(102, 197, 204)"
17381,2020-04-04,Moldova,2,86,591,"rgb(102, 197, 204)"
17382,2020-04-05,Moldova,4,161,752,"rgb(102, 197, 204)"
17383,2020-04-06,Moldova,3,112,864,"rgb(102, 197, 204)"
17384,2020-04-07,Moldova,4,101,965,"rgb(102, 197, 204)"
17385,2020-04-08,Moldova,3,91,1056,"rgb(102, 197, 204)"
17386,2020-04-09,Moldova,5,118,1174,"rgb(102, 197, 204)"
17387,2020-04-10,Moldova,2,115,1289,"rgb(102, 197, 204)"
17388,2020-04-11,Moldova,0,149,1438,"rgb(102, 197, 204)"
17389,2020-04-12,Moldova,1,122,1560,"rgb(102, 197, 204)"
17390,2020-04-13,Moldova,2,102,1662,"rgb(102, 197, 204)"
17391,2020-04-14,Moldova,4,50,1712,"rgb(102, 197, 204)"
17392,2020-04-15,Moldova,4,222,1934,"rgb(102, 197, 204)"
17393,2020-04-16,Moldova,6,115,2049,"rgb(102, 197, 204)"
17394,2020-04-17,Moldova,8,105,2154,"rgb(102, 197, 204)"
17395,2020-04-18,Moldova,2,110,2264,"rgb(102, 197, 204)"
17396,2020-04-19,Moldova,4,87,2351,"rgb(102, 197, 204)"
17397,2020-04-20,Moldova,7,121,2472,"rgb(102, 197, 204)"
17398,2020-04-21,Moldova,3,76,2548,"rgb(102, 197, 204)"
17399,2020-04-22,Moldova,3,66,2614,"rgb(102, 197, 204)"
17400,2020-04-23,Moldova,3,164,2778,"rgb(102, 197, 204)"
17401,2020-04-24,Moldova,4,148,2926,"rgb(102, 197, 204)"
17402,2020-04-25,Moldova,7,184,3110,"rgb(102, 197, 204)"
17403,2020-04-26,Moldova,7,194,3304,"rgb(102, 197, 204)"
17404,2020-04-27,Moldova,2,104,3408,"rgb(102, 197, 204)"
17405,2020-04-28,Moldova,6,73,3481,"rgb(102, 197, 204)"
17406,2020-04-29,Moldova,5,157,3638,"rgb(102, 197, 204)"
17407,2020-04-30,Moldova,4,133,3771,"rgb(102, 197, 204)"
17408,2020-05-01,Moldova,8,126,3897,"rgb(102, 197, 204)"
17409,2020-05-02,Moldova,3,83,3980,"rgb(102, 197, 204)"
17410,2020-05-03,Moldova,2,72,4052,"rgb(102, 197, 204)"
17411,2020-05-04,Moldova,1,69,4121,"rgb(102, 197, 204)"
17412,2020-05-05,Moldova,7,127,4248,"rgb(102, 197, 204)"
17413,2020-05-06,Moldova,4,115,4363,"rgb(102, 197, 204)"
17414,2020-05-07,Moldova,7,113,4476,"rgb(102, 197, 204)"
17415,2020-05-08,Moldova,2,129,4605,"rgb(102, 197, 204)"
17416,2020-05-09,Moldova,7,123,4728,"rgb(102, 197, 204)"
17417,2020-05-10,Moldova,9,139,4867,"rgb(102, 197, 204)"
17418,2020-05-11,Moldova,8,60,4927,"rgb(102, 197, 204)"
17419,2020-05-12,Moldova,6,68,4995,"rgb(102, 197, 204)"
17420,2020-05-13,Moldova,7,159,5154,"rgb(102, 197, 204)"
17421,2020-05-14,Moldova,3,252,5406,"rgb(102, 197, 204)"
17422,2020-05-15,Moldova,9,147,5553,"rgb(102, 197, 204)"
17423,2020-05-16,Moldova,3,192,5745,"rgb(102, 197, 204)"
17424,2020-05-17,Moldova,10,189,5934,"rgb(102, 197, 204)"
17425,2020-05-18,Moldova,4,126,6060,"rgb(102, 197, 204)"
17426,2020-05-19,Moldova,4,78,6138,"rgb(102, 197, 204)"
17427,2020-05-20,Moldova,6,202,6340,"rgb(102, 197, 204)"
17428,2020-05-21,Moldova,7,213,6553,"rgb(102, 197, 204)"
17429,2020-05-22,Moldova,5,151,6704,"rgb(102, 197, 204)"
17430,2020-05-23,Moldova,4,143,6847,"rgb(102, 197, 204)"
17431,2020-05-24,Moldova,5,147,6994,"rgb(102, 197, 204)"
17432,2020-05-25,Moldova,8,99,7093,"rgb(102, 197, 204)"
17433,2020-05-26,Moldova,11,54,7147,"rgb(102, 197, 204)"
17434,2020-05-27,Moldova,6,158,7305,"rgb(102, 197, 204)"
17435,2020-05-28,Moldova,7,232,7537,"rgb(102, 197, 204)"
17436,2020-05-29,Moldova,8,188,7725,"rgb(102, 197, 204)"
17437,2020-05-30,Moldova,6,171,7896,"rgb(102, 197, 204)"
17438,2020-05-31,Moldova,3,202,8098,"rgb(102, 197, 204)"
17439,2020-06-01,Moldova,4,153,8251,"rgb(102, 197, 204)"
17440,2020-06-02,Moldova,12,109,8360,"rgb(102, 197, 204)"
17441,2020-06-03,Moldova,0,188,8548,"rgb(102, 197, 204)"
17442,2020-06-04,Moldova,3,247,8795,"rgb(102, 197, 204)"
17443,2020-06-05,Moldova,5,223,9018,"rgb(102, 197, 204)"
17444,2020-06-06,Moldova,8,229,9247,"rgb(102, 197, 204)"
17445,2020-06-07,Moldova,8,264,9511,"rgb(102, 197, 204)"
17446,2020-06-08,Moldova,10,189,9700,"rgb(102, 197, 204)"
17447,2020-06-09,Moldova,12,107,9807,"rgb(102, 197, 204)"
17448,2020-06-10,Moldova,12,218,10025,"rgb(102, 197, 204)"
17449,2020-06-11,Moldova,6,296,10321,"rgb(102, 197, 204)"
17450,2020-06-12,Moldova,4,406,10727,"rgb(102, 197, 204)"
17451,2020-06-13,Moldova,10,366,11093,"rgb(102, 197, 204)"
17452,2020-06-14,Moldova,13,366,11459,"rgb(102, 197, 204)"
17453,2020-06-15,Moldova,8,281,11740,"rgb(102, 197, 204)"
17454,2020-06-16,Moldova,5,139,11879,"rgb(102, 197, 204)"
17455,2020-06-17,Moldova,12,375,12254,"rgb(102, 197, 204)"
17456,2020-06-18,Moldova,10,478,12732,"rgb(102, 197, 204)"
17457,2020-06-19,Moldova,11,374,13106,"rgb(102, 197, 204)"
17458,2020-06-20,Moldova,6,450,13556,"rgb(102, 197, 204)"
17459,2020-06-21,Moldova,14,397,13953,"rgb(102, 197, 204)"
17460,2020-06-22,Moldova,9,247,14200,"rgb(102, 197, 204)"
17461,2020-06-23,Moldova,7,163,14363,"rgb(102, 197, 204)"
17462,2020-06-24,Moldova,10,351,14714,"rgb(102, 197, 204)"
17463,2020-06-25,Moldova,5,364,15078,"rgb(102, 197, 204)"
17464,2020-06-26,Moldova,7,375,15453,"rgb(102, 197, 204)"
17465,2020-06-27,Moldova,13,323,15776,"rgb(102, 197, 204)"
17466,2020-06-28,Moldova,6,304,16080,"rgb(102, 197, 204)"
17467,2020-06-29,Moldova,9,170,16250,"rgb(102, 197, 204)"
17468,2020-06-30,Moldova,6,107,16357,"rgb(102, 197, 204)"
17469,2020-07-01,Moldova,9,256,16613,"rgb(102, 197, 204)"
17470,2020-07-02,Moldova,4,285,16898,"rgb(102, 197, 204)"
17471,2020-07-03,Moldova,11,252,17150,"rgb(102, 197, 204)"
17472,2020-07-04,Moldova,12,295,17445,"rgb(102, 197, 204)"
17473,2020-07-05,Moldova,8,227,17672,"rgb(102, 197, 204)"
17474,2020-07-06,Moldova,5,142,17814,"rgb(102, 197, 204)"
17475,2020-07-07,Moldova,10,92,17906,"rgb(102, 197, 204)"
17476,2020-07-08,Moldova,8,235,18141,"rgb(102, 197, 204)"
17477,2020-07-09,Moldova,11,330,18471,"rgb(102, 197, 204)"
17478,2020-07-10,Moldova,10,195,18666,"rgb(102, 197, 204)"
17479,2020-07-11,Moldova,11,258,18924,"rgb(102, 197, 204)"
17480,2020-07-12,Moldova,5,284,19208,"rgb(102, 197, 204)"
17481,2020-07-13,Moldova,2,174,19382,"rgb(102, 197, 204)"
17482,2020-03-18,Montenegro,0,2,2,"rgb(246, 207, 113)"
17483,2020-03-19,Montenegro,0,6,8,"rgb(246, 207, 113)"
17484,2020-03-20,Montenegro,0,5,13,"rgb(246, 207, 113)"
17485,2020-03-21,Montenegro,0,1,14,"rgb(246, 207, 113)"
17486,2020-03-22,Montenegro,0,0,14,"rgb(246, 207, 113)"
17487,2020-03-23,Montenegro,0,7,21,"rgb(246, 207, 113)"
17488,2020-03-24,Montenegro,0,6,27,"rgb(246, 207, 113)"
17489,2020-03-25,Montenegro,0,20,47,"rgb(246, 207, 113)"
17490,2020-03-26,Montenegro,0,6,53,"rgb(246, 207, 113)"
17491,2020-03-27,Montenegro,1,14,67,"rgb(246, 207, 113)"
17492,2020-03-28,Montenegro,0,8,75,"rgb(246, 207, 113)"
17493,2020-03-29,Montenegro,0,9,84,"rgb(246, 207, 113)"
17494,2020-03-30,Montenegro,0,1,85,"rgb(246, 207, 113)"
17495,2020-03-31,Montenegro,0,6,91,"rgb(246, 207, 113)"
17496,2020-04-01,Montenegro,0,18,109,"rgb(246, 207, 113)"
17497,2020-04-02,Montenegro,0,14,123,"rgb(246, 207, 113)"
17498,2020-04-03,Montenegro,1,21,144,"rgb(246, 207, 113)"
17499,2020-04-04,Montenegro,0,30,174,"rgb(246, 207, 113)"
17500,2020-04-05,Montenegro,0,27,201,"rgb(246, 207, 113)"
17501,2020-04-06,Montenegro,0,13,214,"rgb(246, 207, 113)"
17502,2020-04-07,Montenegro,0,19,233,"rgb(246, 207, 113)"
17503,2020-04-08,Montenegro,0,8,241,"rgb(246, 207, 113)"
17504,2020-04-09,Montenegro,0,8,249,"rgb(246, 207, 113)"
17505,2020-04-10,Montenegro,0,3,252,"rgb(246, 207, 113)"
17506,2020-04-11,Montenegro,0,5,257,"rgb(246, 207, 113)"
17507,2020-04-12,Montenegro,0,6,263,"rgb(246, 207, 113)"
17508,2020-04-13,Montenegro,1,9,272,"rgb(246, 207, 113)"
17509,2020-04-14,Montenegro,0,2,274,"rgb(246, 207, 113)"
17510,2020-04-15,Montenegro,1,9,283,"rgb(246, 207, 113)"
17511,2020-04-16,Montenegro,0,5,288,"rgb(246, 207, 113)"
17512,2020-04-17,Montenegro,0,15,303,"rgb(246, 207, 113)"
17513,2020-04-18,Montenegro,0,0,303,"rgb(246, 207, 113)"
17514,2020-04-19,Montenegro,1,4,307,"rgb(246, 207, 113)"
17515,2020-04-20,Montenegro,0,1,308,"rgb(246, 207, 113)"
17516,2020-04-21,Montenegro,0,4,312,"rgb(246, 207, 113)"
17517,2020-04-22,Montenegro,0,1,313,"rgb(246, 207, 113)"
17518,2020-04-23,Montenegro,0,2,315,"rgb(246, 207, 113)"
17519,2020-04-24,Montenegro,0,4,319,"rgb(246, 207, 113)"
17520,2020-04-25,Montenegro,1,0,319,"rgb(246, 207, 113)"
17521,2020-04-26,Montenegro,0,1,320,"rgb(246, 207, 113)"
17522,2020-04-27,Montenegro,1,1,321,"rgb(246, 207, 113)"
17523,2020-04-28,Montenegro,0,0,321,"rgb(246, 207, 113)"
17524,2020-04-29,Montenegro,0,0,321,"rgb(246, 207, 113)"
17525,2020-04-30,Montenegro,0,1,322,"rgb(246, 207, 113)"
17526,2020-05-01,Montenegro,0,0,322,"rgb(246, 207, 113)"
17527,2020-05-02,Montenegro,0,0,322,"rgb(246, 207, 113)"
17528,2020-05-03,Montenegro,0,0,322,"rgb(246, 207, 113)"
17529,2020-05-04,Montenegro,1,0,322,"rgb(246, 207, 113)"
17530,2020-05-05,Montenegro,0,1,323,"rgb(246, 207, 113)"
17531,2020-05-06,Montenegro,0,1,324,"rgb(246, 207, 113)"
17532,2020-05-07,Montenegro,0,0,324,"rgb(246, 207, 113)"
17533,2020-05-08,Montenegro,0,0,324,"rgb(246, 207, 113)"
17534,2020-05-09,Montenegro,0,0,324,"rgb(246, 207, 113)"
17535,2020-05-10,Montenegro,0,0,324,"rgb(246, 207, 113)"
17536,2020-05-11,Montenegro,1,0,324,"rgb(246, 207, 113)"
17537,2020-05-12,Montenegro,0,0,324,"rgb(246, 207, 113)"
17538,2020-05-13,Montenegro,0,0,324,"rgb(246, 207, 113)"
17539,2020-05-14,Montenegro,0,0,324,"rgb(246, 207, 113)"
17540,2020-05-15,Montenegro,0,0,324,"rgb(246, 207, 113)"
17541,2020-05-16,Montenegro,0,0,324,"rgb(246, 207, 113)"
17542,2020-05-17,Montenegro,0,0,324,"rgb(246, 207, 113)"
17543,2020-05-18,Montenegro,0,0,324,"rgb(246, 207, 113)"
17544,2020-05-19,Montenegro,0,0,324,"rgb(246, 207, 113)"
17545,2020-05-20,Montenegro,0,0,324,"rgb(246, 207, 113)"
17546,2020-05-21,Montenegro,0,0,324,"rgb(246, 207, 113)"
17547,2020-05-22,Montenegro,0,0,324,"rgb(246, 207, 113)"
17548,2020-05-23,Montenegro,0,0,324,"rgb(246, 207, 113)"
17549,2020-05-24,Montenegro,0,0,324,"rgb(246, 207, 113)"
17550,2020-05-25,Montenegro,0,0,324,"rgb(246, 207, 113)"
17551,2020-05-26,Montenegro,0,0,324,"rgb(246, 207, 113)"
17552,2020-05-27,Montenegro,0,0,324,"rgb(246, 207, 113)"
17553,2020-05-28,Montenegro,0,0,324,"rgb(246, 207, 113)"
17554,2020-05-29,Montenegro,0,0,324,"rgb(246, 207, 113)"
17555,2020-05-30,Montenegro,0,0,324,"rgb(246, 207, 113)"
17556,2020-05-31,Montenegro,0,0,324,"rgb(246, 207, 113)"
17557,2020-06-01,Montenegro,0,0,324,"rgb(246, 207, 113)"
17558,2020-06-02,Montenegro,0,0,324,"rgb(246, 207, 113)"
17559,2020-06-03,Montenegro,0,0,324,"rgb(246, 207, 113)"
17560,2020-06-04,Montenegro,0,0,324,"rgb(246, 207, 113)"
17561,2020-06-05,Montenegro,0,0,324,"rgb(246, 207, 113)"
17562,2020-06-06,Montenegro,0,0,324,"rgb(246, 207, 113)"
17563,2020-06-07,Montenegro,0,0,324,"rgb(246, 207, 113)"
17564,2020-06-08,Montenegro,0,0,324,"rgb(246, 207, 113)"
17565,2020-06-09,Montenegro,0,0,324,"rgb(246, 207, 113)"
17566,2020-06-10,Montenegro,0,0,324,"rgb(246, 207, 113)"
17567,2020-06-11,Montenegro,0,0,324,"rgb(246, 207, 113)"
17568,2020-06-12,Montenegro,0,0,324,"rgb(246, 207, 113)"
17569,2020-06-13,Montenegro,0,0,324,"rgb(246, 207, 113)"
17570,2020-06-14,Montenegro,0,0,324,"rgb(246, 207, 113)"
17571,2020-06-15,Montenegro,0,1,325,"rgb(246, 207, 113)"
17572,2020-06-16,Montenegro,0,1,326,"rgb(246, 207, 113)"
17573,2020-06-17,Montenegro,0,0,326,"rgb(246, 207, 113)"
17574,2020-06-18,Montenegro,0,7,333,"rgb(246, 207, 113)"
17575,2020-06-19,Montenegro,0,4,337,"rgb(246, 207, 113)"
17576,2020-06-20,Montenegro,0,18,355,"rgb(246, 207, 113)"
17577,2020-06-21,Montenegro,0,4,359,"rgb(246, 207, 113)"
17578,2020-06-22,Montenegro,0,3,362,"rgb(246, 207, 113)"
17579,2020-06-23,Montenegro,0,5,367,"rgb(246, 207, 113)"
17580,2020-06-24,Montenegro,0,11,378,"rgb(246, 207, 113)"
17581,2020-06-25,Montenegro,0,11,389,"rgb(246, 207, 113)"
17582,2020-06-26,Montenegro,0,25,414,"rgb(246, 207, 113)"
17583,2020-06-27,Montenegro,0,25,439,"rgb(246, 207, 113)"
17584,2020-06-28,Montenegro,0,30,469,"rgb(246, 207, 113)"
17585,2020-06-29,Montenegro,2,12,481,"rgb(246, 207, 113)"
17586,2020-06-30,Montenegro,0,20,501,"rgb(246, 207, 113)"
17587,2020-07-01,Montenegro,1,47,548,"rgb(246, 207, 113)"
17588,2020-07-02,Montenegro,0,28,576,"rgb(246, 207, 113)"
17589,2020-07-03,Montenegro,0,40,616,"rgb(246, 207, 113)"
17590,2020-07-04,Montenegro,1,47,663,"rgb(246, 207, 113)"
17591,2020-07-05,Montenegro,1,57,720,"rgb(246, 207, 113)"
17592,2020-07-06,Montenegro,0,61,781,"rgb(246, 207, 113)"
17593,2020-07-07,Montenegro,0,60,841,"rgb(246, 207, 113)"
17594,2020-07-08,Montenegro,3,66,907,"rgb(246, 207, 113)"
17595,2020-07-09,Montenegro,0,53,960,"rgb(246, 207, 113)"
17596,2020-07-10,Montenegro,2,59,1019,"rgb(246, 207, 113)"
17597,2020-07-11,Montenegro,0,58,1077,"rgb(246, 207, 113)"
17598,2020-07-12,Montenegro,4,87,1164,"rgb(246, 207, 113)"
17599,2020-07-13,Montenegro,0,57,1221,"rgb(246, 207, 113)"
17600,2020-03-21,Madagascar,0,3,3,"rgb(248, 156, 116)"
17601,2020-03-22,Madagascar,0,0,3,"rgb(248, 156, 116)"
17602,2020-03-23,Madagascar,0,0,3,"rgb(248, 156, 116)"
17603,2020-03-24,Madagascar,0,14,17,"rgb(248, 156, 116)"
17604,2020-03-25,Madagascar,0,2,19,"rgb(248, 156, 116)"
17605,2020-03-26,Madagascar,0,0,19,"rgb(248, 156, 116)"
17606,2020-03-27,Madagascar,0,4,23,"rgb(248, 156, 116)"
17607,2020-03-28,Madagascar,0,1,24,"rgb(248, 156, 116)"
17608,2020-03-29,Madagascar,0,4,28,"rgb(248, 156, 116)"
17609,2020-03-30,Madagascar,0,9,37,"rgb(248, 156, 116)"
17610,2020-03-31,Madagascar,0,7,44,"rgb(248, 156, 116)"
17611,2020-04-01,Madagascar,0,2,46,"rgb(248, 156, 116)"
17612,2020-04-02,Madagascar,0,8,54,"rgb(248, 156, 116)"
17613,2020-04-03,Madagascar,0,5,59,"rgb(248, 156, 116)"
17614,2020-04-04,Madagascar,0,6,65,"rgb(248, 156, 116)"
17615,2020-04-05,Madagascar,0,6,71,"rgb(248, 156, 116)"
17616,2020-04-06,Madagascar,0,1,72,"rgb(248, 156, 116)"
17617,2020-04-07,Madagascar,0,5,77,"rgb(248, 156, 116)"
17618,2020-04-08,Madagascar,0,8,85,"rgb(248, 156, 116)"
17619,2020-04-09,Madagascar,0,8,93,"rgb(248, 156, 116)"
17620,2020-04-10,Madagascar,0,0,93,"rgb(248, 156, 116)"
17621,2020-04-11,Madagascar,0,9,102,"rgb(248, 156, 116)"
17622,2020-04-12,Madagascar,0,0,102,"rgb(248, 156, 116)"
17623,2020-04-13,Madagascar,0,4,106,"rgb(248, 156, 116)"
17624,2020-04-14,Madagascar,0,0,106,"rgb(248, 156, 116)"
17625,2020-04-15,Madagascar,0,2,108,"rgb(248, 156, 116)"
17626,2020-04-16,Madagascar,0,2,110,"rgb(248, 156, 116)"
17627,2020-04-17,Madagascar,0,1,111,"rgb(248, 156, 116)"
17628,2020-04-18,Madagascar,0,6,117,"rgb(248, 156, 116)"
17629,2020-04-19,Madagascar,0,0,117,"rgb(248, 156, 116)"
17630,2020-04-20,Madagascar,0,4,121,"rgb(248, 156, 116)"
17631,2020-04-21,Madagascar,0,0,121,"rgb(248, 156, 116)"
17632,2020-04-22,Madagascar,0,0,121,"rgb(248, 156, 116)"
17633,2020-04-23,Madagascar,0,0,121,"rgb(248, 156, 116)"
17634,2020-04-24,Madagascar,0,0,121,"rgb(248, 156, 116)"
17635,2020-04-25,Madagascar,0,1,122,"rgb(248, 156, 116)"
17636,2020-04-26,Madagascar,0,2,124,"rgb(248, 156, 116)"
17637,2020-04-27,Madagascar,0,0,124,"rgb(248, 156, 116)"
17638,2020-04-28,Madagascar,0,4,128,"rgb(248, 156, 116)"
17639,2020-04-29,Madagascar,0,0,128,"rgb(248, 156, 116)"
17640,2020-04-30,Madagascar,0,0,128,"rgb(248, 156, 116)"
17641,2020-05-01,Madagascar,0,4,132,"rgb(248, 156, 116)"
17642,2020-05-02,Madagascar,0,3,135,"rgb(248, 156, 116)"
17643,2020-05-03,Madagascar,0,0,135,"rgb(248, 156, 116)"
17644,2020-05-04,Madagascar,0,14,149,"rgb(248, 156, 116)"
17645,2020-05-05,Madagascar,0,0,149,"rgb(248, 156, 116)"
17646,2020-05-06,Madagascar,0,9,158,"rgb(248, 156, 116)"
17647,2020-05-07,Madagascar,0,0,158,"rgb(248, 156, 116)"
17648,2020-05-08,Madagascar,0,11,169,"rgb(248, 156, 116)"
17649,2020-05-09,Madagascar,0,0,169,"rgb(248, 156, 116)"
17650,2020-05-10,Madagascar,0,0,169,"rgb(248, 156, 116)"
17651,2020-05-11,Madagascar,0,2,171,"rgb(248, 156, 116)"
17652,2020-05-12,Madagascar,0,15,186,"rgb(248, 156, 116)"
17653,2020-05-13,Madagascar,0,6,192,"rgb(248, 156, 116)"
17654,2020-05-14,Madagascar,0,20,212,"rgb(248, 156, 116)"
17655,2020-05-15,Madagascar,0,18,230,"rgb(248, 156, 116)"
17656,2020-05-16,Madagascar,0,8,238,"rgb(248, 156, 116)"
17657,2020-05-17,Madagascar,0,45,283,"rgb(248, 156, 116)"
17658,2020-05-18,Madagascar,1,21,304,"rgb(248, 156, 116)"
17659,2020-05-19,Madagascar,0,18,322,"rgb(248, 156, 116)"
17660,2020-05-20,Madagascar,1,4,326,"rgb(248, 156, 116)"
17661,2020-05-21,Madagascar,0,45,371,"rgb(248, 156, 116)"
17662,2020-05-22,Madagascar,0,34,405,"rgb(248, 156, 116)"
17663,2020-05-23,Madagascar,0,43,448,"rgb(248, 156, 116)"
17664,2020-05-24,Madagascar,0,0,448,"rgb(248, 156, 116)"
17665,2020-05-25,Madagascar,0,79,527,"rgb(248, 156, 116)"
17666,2020-05-26,Madagascar,0,15,542,"rgb(248, 156, 116)"
17667,2020-05-27,Madagascar,0,44,586,"rgb(248, 156, 116)"
17668,2020-05-28,Madagascar,0,26,612,"rgb(248, 156, 116)"
17669,2020-05-29,Madagascar,0,44,656,"rgb(248, 156, 116)"
17670,2020-05-30,Madagascar,3,42,698,"rgb(248, 156, 116)"
17671,2020-05-31,Madagascar,1,60,758,"rgb(248, 156, 116)"
17672,2020-06-01,Madagascar,0,13,771,"rgb(248, 156, 116)"
17673,2020-06-02,Madagascar,0,55,826,"rgb(248, 156, 116)"
17674,2020-06-03,Madagascar,0,19,845,"rgb(248, 156, 116)"
17675,2020-06-04,Madagascar,0,63,908,"rgb(248, 156, 116)"
17676,2020-06-05,Madagascar,1,49,957,"rgb(248, 156, 116)"
17677,2020-06-06,Madagascar,0,18,975,"rgb(248, 156, 116)"
17678,2020-06-07,Madagascar,1,51,1026,"rgb(248, 156, 116)"
17679,2020-06-08,Madagascar,1,26,1052,"rgb(248, 156, 116)"
17680,2020-06-09,Madagascar,0,42,1094,"rgb(248, 156, 116)"
17681,2020-06-10,Madagascar,0,44,1138,"rgb(248, 156, 116)"
17682,2020-06-11,Madagascar,1,24,1162,"rgb(248, 156, 116)"
17683,2020-06-12,Madagascar,0,41,1203,"rgb(248, 156, 116)"
17684,2020-06-13,Madagascar,0,27,1230,"rgb(248, 156, 116)"
17685,2020-06-14,Madagascar,0,22,1252,"rgb(248, 156, 116)"
17686,2020-06-15,Madagascar,0,20,1272,"rgb(248, 156, 116)"
17687,2020-06-16,Madagascar,0,18,1290,"rgb(248, 156, 116)"
17688,2020-06-17,Madagascar,2,27,1317,"rgb(248, 156, 116)"
17689,2020-06-18,Madagascar,0,61,1378,"rgb(248, 156, 116)"
17690,2020-06-19,Madagascar,1,25,1403,"rgb(248, 156, 116)"
17691,2020-06-20,Madagascar,0,40,1443,"rgb(248, 156, 116)"
17692,2020-06-21,Madagascar,0,60,1503,"rgb(248, 156, 116)"
17693,2020-06-22,Madagascar,1,93,1596,"rgb(248, 156, 116)"
17694,2020-06-23,Madagascar,1,44,1640,"rgb(248, 156, 116)"
17695,2020-06-24,Madagascar,0,84,1724,"rgb(248, 156, 116)"
17696,2020-06-25,Madagascar,1,63,1787,"rgb(248, 156, 116)"
17697,2020-06-26,Madagascar,0,42,1829,"rgb(248, 156, 116)"
17698,2020-06-27,Madagascar,0,93,1922,"rgb(248, 156, 116)"
17699,2020-06-28,Madagascar,0,83,2005,"rgb(248, 156, 116)"
17700,2020-06-29,Madagascar,2,73,2078,"rgb(248, 156, 116)"
17701,2020-06-30,Madagascar,2,60,2138,"rgb(248, 156, 116)"
17702,2020-07-01,Madagascar,0,76,2214,"rgb(248, 156, 116)"
17703,2020-07-02,Madagascar,2,89,2303,"rgb(248, 156, 116)"
17704,2020-07-03,Madagascar,2,100,2403,"rgb(248, 156, 116)"
17705,2020-07-04,Madagascar,2,109,2512,"rgb(248, 156, 116)"
17706,2020-07-05,Madagascar,3,216,2728,"rgb(248, 156, 116)"
17707,2020-07-06,Madagascar,0,0,2728,"rgb(248, 156, 116)"
17708,2020-07-07,Madagascar,4,522,3250,"rgb(248, 156, 116)"
17709,2020-07-08,Madagascar,0,222,3472,"rgb(248, 156, 116)"
17710,2020-07-09,Madagascar,0,101,3573,"rgb(248, 156, 116)"
17711,2020-07-10,Madagascar,0,209,3782,"rgb(248, 156, 116)"
17712,2020-07-11,Madagascar,1,361,4143,"rgb(248, 156, 116)"
17713,2020-07-12,Madagascar,0,435,4578,"rgb(248, 156, 116)"
17714,2020-07-13,Madagascar,1,289,4867,"rgb(248, 156, 116)"
17715,2019-12-31,North Macedonia,0,0,0,"rgb(220, 176, 242)"
17716,2020-01-01,North Macedonia,0,0,0,"rgb(220, 176, 242)"
17717,2020-01-02,North Macedonia,0,0,0,"rgb(220, 176, 242)"
17718,2020-01-03,North Macedonia,0,0,0,"rgb(220, 176, 242)"
17719,2020-01-04,North Macedonia,0,0,0,"rgb(220, 176, 242)"
17720,2020-01-05,North Macedonia,0,0,0,"rgb(220, 176, 242)"
17721,2020-01-06,North Macedonia,0,0,0,"rgb(220, 176, 242)"
17722,2020-01-07,North Macedonia,0,0,0,"rgb(220, 176, 242)"
17723,2020-01-08,North Macedonia,0,0,0,"rgb(220, 176, 242)"
17724,2020-01-09,North Macedonia,0,0,0,"rgb(220, 176, 242)"
17725,2020-01-10,North Macedonia,0,0,0,"rgb(220, 176, 242)"
17726,2020-01-11,North Macedonia,0,0,0,"rgb(220, 176, 242)"
17727,2020-01-12,North Macedonia,0,0,0,"rgb(220, 176, 242)"
17728,2020-01-13,North Macedonia,0,0,0,"rgb(220, 176, 242)"
17729,2020-01-14,North Macedonia,0,0,0,"rgb(220, 176, 242)"
17730,2020-01-15,North Macedonia,0,0,0,"rgb(220, 176, 242)"
17731,2020-01-16,North Macedonia,0,0,0,"rgb(220, 176, 242)"
17732,2020-01-17,North Macedonia,0,0,0,"rgb(220, 176, 242)"
17733,2020-01-18,North Macedonia,0,0,0,"rgb(220, 176, 242)"
17734,2020-01-19,North Macedonia,0,0,0,"rgb(220, 176, 242)"
17735,2020-01-20,North Macedonia,0,0,0,"rgb(220, 176, 242)"
17736,2020-01-21,North Macedonia,0,0,0,"rgb(220, 176, 242)"
17737,2020-01-22,North Macedonia,0,0,0,"rgb(220, 176, 242)"
17738,2020-01-23,North Macedonia,0,0,0,"rgb(220, 176, 242)"
17739,2020-01-24,North Macedonia,0,0,0,"rgb(220, 176, 242)"
17740,2020-01-25,North Macedonia,0,0,0,"rgb(220, 176, 242)"
17741,2020-01-26,North Macedonia,0,0,0,"rgb(220, 176, 242)"
17742,2020-01-27,North Macedonia,0,0,0,"rgb(220, 176, 242)"
17743,2020-01-28,North Macedonia,0,0,0,"rgb(220, 176, 242)"
17744,2020-01-29,North Macedonia,0,0,0,"rgb(220, 176, 242)"
17745,2020-01-30,North Macedonia,0,0,0,"rgb(220, 176, 242)"
17746,2020-01-31,North Macedonia,0,0,0,"rgb(220, 176, 242)"
17747,2020-02-01,North Macedonia,0,0,0,"rgb(220, 176, 242)"
17748,2020-02-02,North Macedonia,0,0,0,"rgb(220, 176, 242)"
17749,2020-02-03,North Macedonia,0,0,0,"rgb(220, 176, 242)"
17750,2020-02-04,North Macedonia,0,0,0,"rgb(220, 176, 242)"
17751,2020-02-05,North Macedonia,0,0,0,"rgb(220, 176, 242)"
17752,2020-02-06,North Macedonia,0,0,0,"rgb(220, 176, 242)"
17753,2020-02-07,North Macedonia,0,0,0,"rgb(220, 176, 242)"
17754,2020-02-08,North Macedonia,0,0,0,"rgb(220, 176, 242)"
17755,2020-02-09,North Macedonia,0,0,0,"rgb(220, 176, 242)"
17756,2020-02-10,North Macedonia,0,0,0,"rgb(220, 176, 242)"
17757,2020-02-11,North Macedonia,0,0,0,"rgb(220, 176, 242)"
17758,2020-02-12,North Macedonia,0,0,0,"rgb(220, 176, 242)"
17759,2020-02-13,North Macedonia,0,0,0,"rgb(220, 176, 242)"
17760,2020-02-14,North Macedonia,0,0,0,"rgb(220, 176, 242)"
17761,2020-02-15,North Macedonia,0,0,0,"rgb(220, 176, 242)"
17762,2020-02-16,North Macedonia,0,0,0,"rgb(220, 176, 242)"
17763,2020-02-17,North Macedonia,0,0,0,"rgb(220, 176, 242)"
17764,2020-02-18,North Macedonia,0,0,0,"rgb(220, 176, 242)"
17765,2020-02-19,North Macedonia,0,0,0,"rgb(220, 176, 242)"
17766,2020-02-20,North Macedonia,0,0,0,"rgb(220, 176, 242)"
17767,2020-02-21,North Macedonia,0,0,0,"rgb(220, 176, 242)"
17768,2020-02-22,North Macedonia,0,0,0,"rgb(220, 176, 242)"
17769,2020-02-23,North Macedonia,0,0,0,"rgb(220, 176, 242)"
17770,2020-02-24,North Macedonia,0,0,0,"rgb(220, 176, 242)"
17771,2020-02-25,North Macedonia,0,0,0,"rgb(220, 176, 242)"
17772,2020-02-26,North Macedonia,0,0,0,"rgb(220, 176, 242)"
17773,2020-02-27,North Macedonia,0,1,1,"rgb(220, 176, 242)"
17774,2020-02-28,North Macedonia,0,0,1,"rgb(220, 176, 242)"
17775,2020-02-29,North Macedonia,0,0,1,"rgb(220, 176, 242)"
17776,2020-03-01,North Macedonia,0,0,1,"rgb(220, 176, 242)"
17777,2020-03-02,North Macedonia,0,0,1,"rgb(220, 176, 242)"
17778,2020-03-07,North Macedonia,0,2,3,"rgb(220, 176, 242)"
17779,2020-03-11,North Macedonia,0,4,7,"rgb(220, 176, 242)"
17780,2020-03-13,North Macedonia,0,2,9,"rgb(220, 176, 242)"
17781,2020-03-14,North Macedonia,0,4,13,"rgb(220, 176, 242)"
17782,2020-03-16,North Macedonia,0,0,13,"rgb(220, 176, 242)"
17783,2020-03-17,North Macedonia,0,6,19,"rgb(220, 176, 242)"
17784,2020-03-18,North Macedonia,0,12,31,"rgb(220, 176, 242)"
17785,2020-03-19,North Macedonia,0,11,42,"rgb(220, 176, 242)"
17786,2020-03-20,North Macedonia,0,6,48,"rgb(220, 176, 242)"
17787,2020-03-21,North Macedonia,0,22,70,"rgb(220, 176, 242)"
17788,2020-03-22,North Macedonia,0,15,85,"rgb(220, 176, 242)"
17789,2020-03-23,North Macedonia,1,29,114,"rgb(220, 176, 242)"
17790,2020-03-24,North Macedonia,1,22,136,"rgb(220, 176, 242)"
17791,2020-03-25,North Macedonia,0,12,148,"rgb(220, 176, 242)"
17792,2020-03-26,North Macedonia,0,29,177,"rgb(220, 176, 242)"
17793,2020-03-27,North Macedonia,1,24,201,"rgb(220, 176, 242)"
17794,2020-03-28,North Macedonia,0,18,219,"rgb(220, 176, 242)"
17795,2020-03-29,North Macedonia,1,22,241,"rgb(220, 176, 242)"
17796,2020-03-30,North Macedonia,2,18,259,"rgb(220, 176, 242)"
17797,2020-03-31,North Macedonia,1,26,285,"rgb(220, 176, 242)"
17798,2020-04-01,North Macedonia,2,44,329,"rgb(220, 176, 242)"
17799,2020-04-02,North Macedonia,1,25,354,"rgb(220, 176, 242)"
17800,2020-04-03,North Macedonia,1,0,354,"rgb(220, 176, 242)"
17801,2020-04-04,North Macedonia,1,76,430,"rgb(220, 176, 242)"
17802,2020-04-05,North Macedonia,5,53,483,"rgb(220, 176, 242)"
17803,2020-04-06,North Macedonia,0,0,483,"rgb(220, 176, 242)"
17804,2020-04-07,North Macedonia,4,87,570,"rgb(220, 176, 242)"
17805,2020-04-08,North Macedonia,5,29,599,"rgb(220, 176, 242)"
17806,2020-04-09,North Macedonia,4,18,617,"rgb(220, 176, 242)"
17807,2020-04-10,North Macedonia,2,46,663,"rgb(220, 176, 242)"
17808,2020-04-11,North Macedonia,0,48,711,"rgb(220, 176, 242)"
17809,2020-04-12,North Macedonia,2,49,760,"rgb(220, 176, 242)"
17810,2020-04-13,North Macedonia,0,68,828,"rgb(220, 176, 242)"
17811,2020-04-14,North Macedonia,4,26,854,"rgb(220, 176, 242)"
17812,2020-04-15,North Macedonia,6,54,908,"rgb(220, 176, 242)"
17813,2020-04-16,North Macedonia,1,66,974,"rgb(220, 176, 242)"
17814,2020-04-17,North Macedonia,1,107,1081,"rgb(220, 176, 242)"
17815,2020-04-18,North Macedonia,3,36,1117,"rgb(220, 176, 242)"
17816,2020-04-19,North Macedonia,0,53,1170,"rgb(220, 176, 242)"
17817,2020-04-20,North Macedonia,2,37,1207,"rgb(220, 176, 242)"
17818,2020-04-21,North Macedonia,3,18,1225,"rgb(220, 176, 242)"
17819,2020-04-22,North Macedonia,1,6,1231,"rgb(220, 176, 242)"
17820,2020-04-23,North Macedonia,1,28,1259,"rgb(220, 176, 242)"
17821,2020-04-24,North Macedonia,0,41,1300,"rgb(220, 176, 242)"
17822,2020-04-25,North Macedonia,1,26,1326,"rgb(220, 176, 242)"
17823,2020-04-26,North Macedonia,2,41,1367,"rgb(220, 176, 242)"
17824,2020-04-27,North Macedonia,2,19,1386,"rgb(220, 176, 242)"
17825,2020-04-28,North Macedonia,4,13,1399,"rgb(220, 176, 242)"
17826,2020-04-29,North Macedonia,6,22,1421,"rgb(220, 176, 242)"
17827,2020-04-30,North Macedonia,2,21,1442,"rgb(220, 176, 242)"
17828,2020-05-01,North Macedonia,4,23,1465,"rgb(220, 176, 242)"
17829,2020-05-02,North Macedonia,4,29,1494,"rgb(220, 176, 242)"
17830,2020-05-03,North Macedonia,1,12,1506,"rgb(220, 176, 242)"
17831,2020-05-04,North Macedonia,2,5,1511,"rgb(220, 176, 242)"
17832,2020-05-05,North Macedonia,1,7,1518,"rgb(220, 176, 242)"
17833,2020-05-06,North Macedonia,1,8,1526,"rgb(220, 176, 242)"
17834,2020-05-07,North Macedonia,2,13,1539,"rgb(220, 176, 242)"
17835,2020-05-08,North Macedonia,1,33,1572,"rgb(220, 176, 242)"
17836,2020-05-09,North Macedonia,1,14,1586,"rgb(220, 176, 242)"
17837,2020-05-10,North Macedonia,1,36,1622,"rgb(220, 176, 242)"
17838,2020-05-11,North Macedonia,0,20,1642,"rgb(220, 176, 242)"
17839,2020-05-12,North Macedonia,0,22,1664,"rgb(220, 176, 242)"
17840,2020-05-13,North Macedonia,1,10,1674,"rgb(220, 176, 242)"
17841,2020-05-14,North Macedonia,3,20,1694,"rgb(220, 176, 242)"
17842,2020-05-15,North Macedonia,0,29,1723,"rgb(220, 176, 242)"
17843,2020-05-16,North Macedonia,2,17,1740,"rgb(220, 176, 242)"
17844,2020-05-17,North Macedonia,1,22,1762,"rgb(220, 176, 242)"
17845,2020-05-18,North Macedonia,3,30,1792,"rgb(220, 176, 242)"
17846,2020-05-19,North Macedonia,3,25,1817,"rgb(220, 176, 242)"
17847,2020-05-20,North Macedonia,2,22,1839,"rgb(220, 176, 242)"
17848,2020-05-21,North Macedonia,4,19,1858,"rgb(220, 176, 242)"
17849,2020-05-22,North Macedonia,1,40,1898,"rgb(220, 176, 242)"
17850,2020-05-23,North Macedonia,1,23,1921,"rgb(220, 176, 242)"
17851,2020-05-24,North Macedonia,1,20,1941,"rgb(220, 176, 242)"
17852,2020-05-25,North Macedonia,0,37,1978,"rgb(220, 176, 242)"
17853,2020-05-26,North Macedonia,0,21,1999,"rgb(220, 176, 242)"
17854,2020-05-27,North Macedonia,3,16,2015,"rgb(220, 176, 242)"
17855,2020-05-28,North Macedonia,3,25,2040,"rgb(220, 176, 242)"
17856,2020-05-29,North Macedonia,3,38,2078,"rgb(220, 176, 242)"
17857,2020-05-30,North Macedonia,4,52,2130,"rgb(220, 176, 242)"
17858,2020-05-31,North Macedonia,5,34,2164,"rgb(220, 176, 242)"
17859,2020-06-01,North Macedonia,2,62,2226,"rgb(220, 176, 242)"
17860,2020-06-02,North Macedonia,7,89,2315,"rgb(220, 176, 242)"
17861,2020-06-03,North Macedonia,1,76,2391,"rgb(220, 176, 242)"
17862,2020-06-04,North Macedonia,4,101,2492,"rgb(220, 176, 242)"
17863,2020-06-05,North Macedonia,2,120,2612,"rgb(220, 176, 242)"
17864,2020-06-06,North Macedonia,2,180,2792,"rgb(220, 176, 242)"
17865,2020-06-07,North Macedonia,2,125,2917,"rgb(220, 176, 242)"
17866,2020-06-08,North Macedonia,2,111,3028,"rgb(220, 176, 242)"
17867,2020-06-09,North Macedonia,3,127,3155,"rgb(220, 176, 242)"
17868,2020-06-10,North Macedonia,1,87,3242,"rgb(220, 176, 242)"
17869,2020-06-11,North Macedonia,7,125,3367,"rgb(220, 176, 242)"
17870,2020-06-12,North Macedonia,5,175,3542,"rgb(220, 176, 242)"
17871,2020-06-13,North Macedonia,2,164,3706,"rgb(220, 176, 242)"
17872,2020-06-14,North Macedonia,8,196,3902,"rgb(220, 176, 242)"
17873,2020-06-15,North Macedonia,9,155,4057,"rgb(220, 176, 242)"
17874,2020-06-16,North Macedonia,5,100,4157,"rgb(220, 176, 242)"
17875,2020-06-17,North Macedonia,8,132,4289,"rgb(220, 176, 242)"
17876,2020-06-18,North Macedonia,9,193,4482,"rgb(220, 176, 242)"
17877,2020-06-19,North Macedonia,6,182,4664,"rgb(220, 176, 242)"
17878,2020-06-20,North Macedonia,6,156,4820,"rgb(220, 176, 242)"
17879,2020-06-21,North Macedonia,11,185,5005,"rgb(220, 176, 242)"
17880,2020-06-22,North Macedonia,5,101,5106,"rgb(220, 176, 242)"
17881,2020-06-23,North Macedonia,9,90,5196,"rgb(220, 176, 242)"
17882,2020-06-24,North Macedonia,4,118,5314,"rgb(220, 176, 242)"
17883,2020-06-25,North Macedonia,8,136,5450,"rgb(220, 176, 242)"
17884,2020-06-26,North Macedonia,6,153,5603,"rgb(220, 176, 242)"
17885,2020-06-27,North Macedonia,3,163,5766,"rgb(220, 176, 242)"
17886,2020-06-28,North Macedonia,9,150,5916,"rgb(220, 176, 242)"
17887,2020-06-29,North Macedonia,9,176,6092,"rgb(220, 176, 242)"
17888,2020-06-30,North Macedonia,12,132,6224,"rgb(220, 176, 242)"
17889,2020-07-01,North Macedonia,4,126,6350,"rgb(220, 176, 242)"
17890,2020-07-02,North Macedonia,4,120,6470,"rgb(220, 176, 242)"
17891,2020-07-03,North Macedonia,15,173,6643,"rgb(220, 176, 242)"
17892,2020-07-04,North Macedonia,0,0,6643,"rgb(220, 176, 242)"
17893,2020-07-05,North Macedonia,13,289,6932,"rgb(220, 176, 242)"
17894,2020-07-06,North Macedonia,7,114,7046,"rgb(220, 176, 242)"
17895,2020-07-07,North Macedonia,5,76,7122,"rgb(220, 176, 242)"
17896,2020-07-08,North Macedonia,5,118,7240,"rgb(220, 176, 242)"
17897,2020-07-09,North Macedonia,8,161,7401,"rgb(220, 176, 242)"
17898,2020-07-10,North Macedonia,2,166,7567,"rgb(220, 176, 242)"
17899,2020-07-11,North Macedonia,6,203,7770,"rgb(220, 176, 242)"
17900,2020-07-12,North Macedonia,8,197,7967,"rgb(220, 176, 242)"
17901,2020-07-13,North Macedonia,7,144,8111,"rgb(220, 176, 242)"
17902,2020-03-26,Mali,0,2,2,"rgb(135, 197, 95)"
17903,2020-03-27,Mali,0,2,4,"rgb(135, 197, 95)"
17904,2020-03-28,Mali,0,0,4,"rgb(135, 197, 95)"
17905,2020-03-29,Mali,0,5,9,"rgb(135, 197, 95)"
17906,2020-03-30,Mali,0,9,18,"rgb(135, 197, 95)"
17907,2020-03-31,Mali,0,0,18,"rgb(135, 197, 95)"
17908,2020-04-01,Mali,1,0,18,"rgb(135, 197, 95)"
17909,2020-04-02,Mali,0,10,28,"rgb(135, 197, 95)"
17910,2020-04-03,Mali,2,8,36,"rgb(135, 197, 95)"
17911,2020-04-04,Mali,0,3,39,"rgb(135, 197, 95)"
17912,2020-04-05,Mali,0,2,41,"rgb(135, 197, 95)"
17913,2020-04-06,Mali,2,4,45,"rgb(135, 197, 95)"
17914,2020-04-07,Mali,0,2,47,"rgb(135, 197, 95)"
17915,2020-04-08,Mali,0,9,56,"rgb(135, 197, 95)"
17916,2020-04-09,Mali,2,3,59,"rgb(135, 197, 95)"
17917,2020-04-10,Mali,0,0,59,"rgb(135, 197, 95)"
17918,2020-04-11,Mali,0,28,87,"rgb(135, 197, 95)"
17919,2020-04-12,Mali,2,18,105,"rgb(135, 197, 95)"
17920,2020-04-13,Mali,0,11,116,"rgb(135, 197, 95)"
17921,2020-04-14,Mali,1,7,123,"rgb(135, 197, 95)"
17922,2020-04-15,Mali,3,21,144,"rgb(135, 197, 95)"
17923,2020-04-16,Mali,0,4,148,"rgb(135, 197, 95)"
17924,2020-04-17,Mali,0,23,171,"rgb(135, 197, 95)"
17925,2020-04-18,Mali,0,19,190,"rgb(135, 197, 95)"
17926,2020-04-19,Mali,0,26,216,"rgb(135, 197, 95)"
17927,2020-04-20,Mali,1,8,224,"rgb(135, 197, 95)"
17928,2020-04-21,Mali,0,22,246,"rgb(135, 197, 95)"
17929,2020-04-22,Mali,0,12,258,"rgb(135, 197, 95)"
17930,2020-04-23,Mali,3,35,293,"rgb(135, 197, 95)"
17931,2020-04-24,Mali,4,16,309,"rgb(135, 197, 95)"
17932,2020-04-25,Mali,0,16,325,"rgb(135, 197, 95)"
17933,2020-04-26,Mali,0,45,370,"rgb(135, 197, 95)"
17934,2020-04-27,Mali,2,19,389,"rgb(135, 197, 95)"
17935,2020-04-28,Mali,0,19,408,"rgb(135, 197, 95)"
17936,2020-04-29,Mali,1,16,424,"rgb(135, 197, 95)"
17937,2020-04-30,Mali,1,58,482,"rgb(135, 197, 95)"
17938,2020-05-01,Mali,1,8,490,"rgb(135, 197, 95)"
17939,2020-05-02,Mali,0,18,508,"rgb(135, 197, 95)"
17940,2020-05-03,Mali,0,36,544,"rgb(135, 197, 95)"
17941,2020-05-04,Mali,1,19,563,"rgb(135, 197, 95)"
17942,2020-05-05,Mali,2,17,580,"rgb(135, 197, 95)"
17943,2020-05-06,Mali,3,32,612,"rgb(135, 197, 95)"
17944,2020-05-07,Mali,0,19,631,"rgb(135, 197, 95)"
17945,2020-05-08,Mali,0,19,650,"rgb(135, 197, 95)"
17946,2020-05-09,Mali,3,18,668,"rgb(135, 197, 95)"
17947,2020-05-10,Mali,2,24,692,"rgb(135, 197, 95)"
17948,2020-05-11,Mali,1,12,704,"rgb(135, 197, 95)"
17949,2020-05-12,Mali,1,8,712,"rgb(135, 197, 95)"
17950,2020-05-13,Mali,1,18,730,"rgb(135, 197, 95)"
17951,2020-05-14,Mali,4,28,758,"rgb(135, 197, 95)"
17952,2020-05-15,Mali,2,21,779,"rgb(135, 197, 95)"
17953,2020-05-16,Mali,0,27,806,"rgb(135, 197, 95)"
17954,2020-05-17,Mali,2,29,835,"rgb(135, 197, 95)"
17955,2020-05-18,Mali,4,25,860,"rgb(135, 197, 95)"
17956,2020-05-19,Mali,0,14,874,"rgb(135, 197, 95)"
17957,2020-05-20,Mali,1,27,901,"rgb(135, 197, 95)"
17958,2020-05-21,Mali,2,30,931,"rgb(135, 197, 95)"
17959,2020-05-22,Mali,5,16,947,"rgb(135, 197, 95)"
17960,2020-05-23,Mali,2,22,969,"rgb(135, 197, 95)"
17961,2020-05-24,Mali,1,46,1015,"rgb(135, 197, 95)"
17962,2020-05-25,Mali,2,15,1030,"rgb(135, 197, 95)"
17963,2020-05-26,Mali,2,29,1059,"rgb(135, 197, 95)"
17964,2020-05-27,Mali,3,18,1077,"rgb(135, 197, 95)"
17965,2020-05-28,Mali,0,39,1116,"rgb(135, 197, 95)"
17966,2020-05-29,Mali,2,78,1194,"rgb(135, 197, 95)"
17967,2020-05-30,Mali,1,32,1226,"rgb(135, 197, 95)"
17968,2020-05-31,Mali,3,24,1250,"rgb(135, 197, 95)"
17969,2020-06-01,Mali,1,15,1265,"rgb(135, 197, 95)"
17970,2020-06-02,Mali,1,50,1315,"rgb(135, 197, 95)"
17971,2020-06-03,Mali,0,36,1351,"rgb(135, 197, 95)"
17972,2020-06-04,Mali,0,0,1351,"rgb(135, 197, 95)"
17973,2020-06-05,Mali,7,110,1461,"rgb(135, 197, 95)"
17974,2020-06-06,Mali,2,24,1485,"rgb(135, 197, 95)"
17975,2020-06-07,Mali,3,38,1523,"rgb(135, 197, 95)"
17976,2020-06-08,Mali,2,10,1533,"rgb(135, 197, 95)"
17977,2020-06-09,Mali,0,14,1547,"rgb(135, 197, 95)"
17978,2020-06-10,Mali,2,39,1586,"rgb(135, 197, 95)"
17979,2020-06-11,Mali,2,81,1667,"rgb(135, 197, 95)"
17980,2020-06-12,Mali,1,55,1722,"rgb(135, 197, 95)"
17981,2020-06-13,Mali,4,30,1752,"rgb(135, 197, 95)"
17982,2020-06-14,Mali,3,24,1776,"rgb(135, 197, 95)"
17983,2020-06-15,Mali,0,33,1809,"rgb(135, 197, 95)"
17984,2020-06-16,Mali,0,51,1860,"rgb(135, 197, 95)"
17985,2020-06-17,Mali,2,25,1885,"rgb(135, 197, 95)"
17986,2020-06-18,Mali,1,5,1890,"rgb(135, 197, 95)"
17987,2020-06-19,Mali,0,16,1906,"rgb(135, 197, 95)"
17988,2020-06-20,Mali,1,17,1923,"rgb(135, 197, 95)"
17989,2020-06-21,Mali,1,10,1933,"rgb(135, 197, 95)"
17990,2020-06-22,Mali,2,28,1961,"rgb(135, 197, 95)"
17991,2020-06-23,Mali,0,0,1961,"rgb(135, 197, 95)"
17992,2020-06-24,Mali,0,17,1978,"rgb(135, 197, 95)"
17993,2020-06-25,Mali,1,23,2001,"rgb(135, 197, 95)"
17994,2020-06-26,Mali,1,6,2007,"rgb(135, 197, 95)"
17995,2020-06-27,Mali,0,32,2039,"rgb(135, 197, 95)"
17996,2020-06-28,Mali,0,79,2118,"rgb(135, 197, 95)"
17997,2020-06-29,Mali,1,29,2147,"rgb(135, 197, 95)"
17998,2020-06-30,Mali,1,26,2173,"rgb(135, 197, 95)"
17999,2020-07-01,Mali,1,8,2181,"rgb(135, 197, 95)"
18000,2020-07-02,Mali,0,21,2202,"rgb(135, 197, 95)"
18001,2020-07-03,Mali,1,58,2260,"rgb(135, 197, 95)"
18002,2020-07-04,Mali,0,25,2285,"rgb(135, 197, 95)"
18003,2020-07-05,Mali,1,18,2303,"rgb(135, 197, 95)"
18004,2020-07-06,Mali,1,27,2330,"rgb(135, 197, 95)"
18005,2020-07-07,Mali,0,1,2331,"rgb(135, 197, 95)"
18006,2020-07-08,Mali,0,17,2348,"rgb(135, 197, 95)"
18007,2020-07-09,Mali,1,10,2358,"rgb(135, 197, 95)"
18008,2020-07-10,Mali,0,0,2358,"rgb(135, 197, 95)"
18009,2020-07-11,Mali,1,46,2404,"rgb(135, 197, 95)"
18010,2020-07-12,Mali,0,2,2406,"rgb(135, 197, 95)"
18011,2020-07-13,Mali,0,5,2411,"rgb(135, 197, 95)"
18012,2020-03-17,Myanmar,0,0,0,"rgb(158, 185, 243)"
18013,2020-03-24,Myanmar,0,2,2,"rgb(158, 185, 243)"
18014,2020-03-25,Myanmar,0,1,3,"rgb(158, 185, 243)"
18015,2020-03-26,Myanmar,0,0,3,"rgb(158, 185, 243)"
18016,2020-03-27,Myanmar,0,2,5,"rgb(158, 185, 243)"
18017,2020-03-28,Myanmar,0,0,5,"rgb(158, 185, 243)"
18018,2020-03-29,Myanmar,0,3,8,"rgb(158, 185, 243)"
18019,2020-03-30,Myanmar,0,0,8,"rgb(158, 185, 243)"
18020,2020-03-31,Myanmar,0,6,14,"rgb(158, 185, 243)"
18021,2020-04-01,Myanmar,1,1,15,"rgb(158, 185, 243)"
18022,2020-04-02,Myanmar,0,1,16,"rgb(158, 185, 243)"
18023,2020-04-03,Myanmar,0,4,20,"rgb(158, 185, 243)"
18024,2020-04-04,Myanmar,0,0,20,"rgb(158, 185, 243)"
18025,2020-04-05,Myanmar,0,1,21,"rgb(158, 185, 243)"
18026,2020-04-06,Myanmar,0,0,21,"rgb(158, 185, 243)"
18027,2020-04-07,Myanmar,0,1,22,"rgb(158, 185, 243)"
18028,2020-04-08,Myanmar,0,0,22,"rgb(158, 185, 243)"
18029,2020-04-09,Myanmar,2,0,22,"rgb(158, 185, 243)"
18030,2020-04-10,Myanmar,0,5,27,"rgb(158, 185, 243)"
18031,2020-04-11,Myanmar,0,1,28,"rgb(158, 185, 243)"
18032,2020-04-12,Myanmar,0,3,31,"rgb(158, 185, 243)"
18033,2020-04-13,Myanmar,1,10,41,"rgb(158, 185, 243)"
18034,2020-04-14,Myanmar,0,21,62,"rgb(158, 185, 243)"
18035,2020-04-15,Myanmar,0,12,74,"rgb(158, 185, 243)"
18036,2020-04-16,Myanmar,0,0,74,"rgb(158, 185, 243)"
18037,2020-04-17,Myanmar,0,11,85,"rgb(158, 185, 243)"
18038,2020-04-18,Myanmar,1,9,94,"rgb(158, 185, 243)"
18039,2020-04-19,Myanmar,0,13,107,"rgb(158, 185, 243)"
18040,2020-04-20,Myanmar,0,4,111,"rgb(158, 185, 243)"
18041,2020-04-21,Myanmar,0,8,119,"rgb(158, 185, 243)"
18042,2020-04-22,Myanmar,0,2,121,"rgb(158, 185, 243)"
18043,2020-04-23,Myanmar,0,6,127,"rgb(158, 185, 243)"
18044,2020-04-24,Myanmar,0,5,132,"rgb(158, 185, 243)"
18045,2020-04-25,Myanmar,0,12,144,"rgb(158, 185, 243)"
18046,2020-04-26,Myanmar,0,2,146,"rgb(158, 185, 243)"
18047,2020-04-27,Myanmar,0,0,146,"rgb(158, 185, 243)"
18048,2020-04-28,Myanmar,0,0,146,"rgb(158, 185, 243)"
18049,2020-04-29,Myanmar,0,4,150,"rgb(158, 185, 243)"
18050,2020-04-30,Myanmar,1,0,150,"rgb(158, 185, 243)"
18051,2020-05-01,Myanmar,0,1,151,"rgb(158, 185, 243)"
18052,2020-05-02,Myanmar,0,0,151,"rgb(158, 185, 243)"
18053,2020-05-03,Myanmar,0,0,151,"rgb(158, 185, 243)"
18054,2020-05-04,Myanmar,0,4,155,"rgb(158, 185, 243)"
18055,2020-05-05,Myanmar,0,6,161,"rgb(158, 185, 243)"
18056,2020-05-06,Myanmar,0,0,161,"rgb(158, 185, 243)"
18057,2020-05-07,Myanmar,0,1,162,"rgb(158, 185, 243)"
18058,2020-05-08,Myanmar,0,14,176,"rgb(158, 185, 243)"
18059,2020-05-09,Myanmar,0,1,177,"rgb(158, 185, 243)"
18060,2020-05-10,Myanmar,0,1,178,"rgb(158, 185, 243)"
18061,2020-05-11,Myanmar,0,2,180,"rgb(158, 185, 243)"
18062,2020-05-12,Myanmar,0,0,180,"rgb(158, 185, 243)"
18063,2020-05-13,Myanmar,0,0,180,"rgb(158, 185, 243)"
18064,2020-05-14,Myanmar,0,1,181,"rgb(158, 185, 243)"
18065,2020-05-15,Myanmar,0,0,181,"rgb(158, 185, 243)"
18066,2020-05-16,Myanmar,0,1,182,"rgb(158, 185, 243)"
18067,2020-05-17,Myanmar,0,0,182,"rgb(158, 185, 243)"
18068,2020-05-18,Myanmar,0,5,187,"rgb(158, 185, 243)"
18069,2020-05-19,Myanmar,0,4,191,"rgb(158, 185, 243)"
18070,2020-05-20,Myanmar,0,2,193,"rgb(158, 185, 243)"
18071,2020-05-21,Myanmar,0,6,199,"rgb(158, 185, 243)"
18072,2020-05-22,Myanmar,0,0,199,"rgb(158, 185, 243)"
18073,2020-05-23,Myanmar,0,2,201,"rgb(158, 185, 243)"
18074,2020-05-24,Myanmar,0,0,201,"rgb(158, 185, 243)"
18075,2020-05-25,Myanmar,0,0,201,"rgb(158, 185, 243)"
18076,2020-05-26,Myanmar,0,2,203,"rgb(158, 185, 243)"
18077,2020-05-27,Myanmar,0,3,206,"rgb(158, 185, 243)"
18078,2020-05-28,Myanmar,0,0,206,"rgb(158, 185, 243)"
18079,2020-05-29,Myanmar,0,0,206,"rgb(158, 185, 243)"
18080,2020-05-30,Myanmar,0,18,224,"rgb(158, 185, 243)"
18081,2020-05-31,Myanmar,0,0,224,"rgb(158, 185, 243)"
18082,2020-06-01,Myanmar,0,4,228,"rgb(158, 185, 243)"
18083,2020-06-02,Myanmar,0,0,228,"rgb(158, 185, 243)"
18084,2020-06-03,Myanmar,0,5,233,"rgb(158, 185, 243)"
18085,2020-06-04,Myanmar,0,1,234,"rgb(158, 185, 243)"
18086,2020-06-05,Myanmar,0,2,236,"rgb(158, 185, 243)"
18087,2020-06-06,Myanmar,0,0,236,"rgb(158, 185, 243)"
18088,2020-06-07,Myanmar,0,4,240,"rgb(158, 185, 243)"
18089,2020-06-08,Myanmar,0,3,243,"rgb(158, 185, 243)"
18090,2020-06-09,Myanmar,0,1,244,"rgb(158, 185, 243)"
18091,2020-06-10,Myanmar,0,2,246,"rgb(158, 185, 243)"
18092,2020-06-11,Myanmar,0,3,249,"rgb(158, 185, 243)"
18093,2020-06-12,Myanmar,0,12,261,"rgb(158, 185, 243)"
18094,2020-06-13,Myanmar,0,0,261,"rgb(158, 185, 243)"
18095,2020-06-14,Myanmar,0,0,261,"rgb(158, 185, 243)"
18096,2020-06-15,Myanmar,0,1,262,"rgb(158, 185, 243)"
18097,2020-06-16,Myanmar,0,0,262,"rgb(158, 185, 243)"
18098,2020-06-17,Myanmar,0,0,262,"rgb(158, 185, 243)"
18099,2020-06-18,Myanmar,0,1,263,"rgb(158, 185, 243)"
18100,2020-06-19,Myanmar,0,23,286,"rgb(158, 185, 243)"
18101,2020-06-20,Myanmar,0,0,286,"rgb(158, 185, 243)"
18102,2020-06-21,Myanmar,0,1,287,"rgb(158, 185, 243)"
18103,2020-06-22,Myanmar,0,3,290,"rgb(158, 185, 243)"
18104,2020-06-23,Myanmar,0,1,291,"rgb(158, 185, 243)"
18105,2020-06-24,Myanmar,0,1,292,"rgb(158, 185, 243)"
18106,2020-06-25,Myanmar,0,1,293,"rgb(158, 185, 243)"
18107,2020-06-26,Myanmar,0,0,293,"rgb(158, 185, 243)"
18108,2020-06-27,Myanmar,0,0,293,"rgb(158, 185, 243)"
18109,2020-06-28,Myanmar,0,3,296,"rgb(158, 185, 243)"
18110,2020-06-29,Myanmar,0,3,299,"rgb(158, 185, 243)"
18111,2020-06-30,Myanmar,0,0,299,"rgb(158, 185, 243)"
18112,2020-07-01,Myanmar,0,0,299,"rgb(158, 185, 243)"
18113,2020-07-02,Myanmar,0,5,304,"rgb(158, 185, 243)"
18114,2020-07-03,Myanmar,0,0,304,"rgb(158, 185, 243)"
18115,2020-07-04,Myanmar,0,2,306,"rgb(158, 185, 243)"
18116,2020-07-05,Myanmar,0,7,313,"rgb(158, 185, 243)"
18117,2020-07-06,Myanmar,0,0,313,"rgb(158, 185, 243)"
18118,2020-07-07,Myanmar,0,3,316,"rgb(158, 185, 243)"
18119,2020-07-08,Myanmar,0,0,316,"rgb(158, 185, 243)"
18120,2020-07-09,Myanmar,0,2,318,"rgb(158, 185, 243)"
18121,2020-07-10,Myanmar,0,3,321,"rgb(158, 185, 243)"
18122,2020-07-11,Myanmar,0,5,326,"rgb(158, 185, 243)"
18123,2020-07-12,Myanmar,0,4,330,"rgb(158, 185, 243)"
18124,2020-07-13,Myanmar,0,1,331,"rgb(158, 185, 243)"
18125,2020-03-10,Mongolia,0,1,1,"rgb(254, 136, 177)"
18126,2020-03-15,Mongolia,0,0,1,"rgb(254, 136, 177)"
18127,2020-03-18,Mongolia,0,3,4,"rgb(254, 136, 177)"
18128,2020-03-19,Mongolia,0,1,5,"rgb(254, 136, 177)"
18129,2020-03-20,Mongolia,0,0,5,"rgb(254, 136, 177)"
18130,2020-03-21,Mongolia,0,1,6,"rgb(254, 136, 177)"
18131,2020-03-22,Mongolia,0,4,10,"rgb(254, 136, 177)"
18132,2020-03-23,Mongolia,0,0,10,"rgb(254, 136, 177)"
18133,2020-03-24,Mongolia,0,0,10,"rgb(254, 136, 177)"
18134,2020-03-25,Mongolia,0,0,10,"rgb(254, 136, 177)"
18135,2020-03-26,Mongolia,0,0,10,"rgb(254, 136, 177)"
18136,2020-03-27,Mongolia,0,1,11,"rgb(254, 136, 177)"
18137,2020-03-28,Mongolia,0,0,11,"rgb(254, 136, 177)"
18138,2020-03-29,Mongolia,0,1,12,"rgb(254, 136, 177)"
18139,2020-03-30,Mongolia,0,0,12,"rgb(254, 136, 177)"
18140,2020-03-31,Mongolia,0,0,12,"rgb(254, 136, 177)"
18141,2020-04-01,Mongolia,0,0,12,"rgb(254, 136, 177)"
18142,2020-04-02,Mongolia,0,2,14,"rgb(254, 136, 177)"
18143,2020-04-03,Mongolia,0,0,14,"rgb(254, 136, 177)"
18144,2020-04-04,Mongolia,0,0,14,"rgb(254, 136, 177)"
18145,2020-04-05,Mongolia,0,0,14,"rgb(254, 136, 177)"
18146,2020-04-06,Mongolia,0,0,14,"rgb(254, 136, 177)"
18147,2020-04-07,Mongolia,0,1,15,"rgb(254, 136, 177)"
18148,2020-04-08,Mongolia,0,0,15,"rgb(254, 136, 177)"
18149,2020-04-09,Mongolia,0,1,16,"rgb(254, 136, 177)"
18150,2020-04-10,Mongolia,0,0,16,"rgb(254, 136, 177)"
18151,2020-04-11,Mongolia,0,0,16,"rgb(254, 136, 177)"
18152,2020-04-12,Mongolia,0,0,16,"rgb(254, 136, 177)"
18153,2020-04-13,Mongolia,0,0,16,"rgb(254, 136, 177)"
18154,2020-04-14,Mongolia,0,0,16,"rgb(254, 136, 177)"
18155,2020-04-15,Mongolia,0,14,30,"rgb(254, 136, 177)"
18156,2020-04-16,Mongolia,0,0,30,"rgb(254, 136, 177)"
18157,2020-04-17,Mongolia,0,1,31,"rgb(254, 136, 177)"
18158,2020-04-18,Mongolia,0,0,31,"rgb(254, 136, 177)"
18159,2020-04-19,Mongolia,0,0,31,"rgb(254, 136, 177)"
18160,2020-04-20,Mongolia,0,1,32,"rgb(254, 136, 177)"
18161,2020-04-21,Mongolia,0,2,34,"rgb(254, 136, 177)"
18162,2020-04-22,Mongolia,0,1,35,"rgb(254, 136, 177)"
18163,2020-04-23,Mongolia,0,0,35,"rgb(254, 136, 177)"
18164,2020-04-24,Mongolia,0,1,36,"rgb(254, 136, 177)"
18165,2020-04-25,Mongolia,0,0,36,"rgb(254, 136, 177)"
18166,2020-04-26,Mongolia,0,2,38,"rgb(254, 136, 177)"
18167,2020-04-27,Mongolia,0,0,38,"rgb(254, 136, 177)"
18168,2020-04-28,Mongolia,0,0,38,"rgb(254, 136, 177)"
18169,2020-04-29,Mongolia,0,0,38,"rgb(254, 136, 177)"
18170,2020-04-30,Mongolia,0,0,38,"rgb(254, 136, 177)"
18171,2020-05-01,Mongolia,0,0,38,"rgb(254, 136, 177)"
18172,2020-05-02,Mongolia,0,1,39,"rgb(254, 136, 177)"
18173,2020-05-03,Mongolia,0,0,39,"rgb(254, 136, 177)"
18174,2020-05-04,Mongolia,0,1,40,"rgb(254, 136, 177)"
18175,2020-05-05,Mongolia,0,1,41,"rgb(254, 136, 177)"
18176,2020-05-06,Mongolia,0,0,41,"rgb(254, 136, 177)"
18177,2020-05-07,Mongolia,0,0,41,"rgb(254, 136, 177)"
18178,2020-05-08,Mongolia,0,1,42,"rgb(254, 136, 177)"
18179,2020-05-09,Mongolia,0,0,42,"rgb(254, 136, 177)"
18180,2020-05-10,Mongolia,0,0,42,"rgb(254, 136, 177)"
18181,2020-05-11,Mongolia,0,0,42,"rgb(254, 136, 177)"
18182,2020-05-12,Mongolia,0,0,42,"rgb(254, 136, 177)"
18183,2020-05-13,Mongolia,0,0,42,"rgb(254, 136, 177)"
18184,2020-05-14,Mongolia,0,19,61,"rgb(254, 136, 177)"
18185,2020-05-15,Mongolia,0,0,61,"rgb(254, 136, 177)"
18186,2020-05-16,Mongolia,0,74,135,"rgb(254, 136, 177)"
18187,2020-05-17,Mongolia,0,1,136,"rgb(254, 136, 177)"
18188,2020-05-18,Mongolia,0,4,140,"rgb(254, 136, 177)"
18189,2020-05-19,Mongolia,0,0,140,"rgb(254, 136, 177)"
18190,2020-05-20,Mongolia,0,0,140,"rgb(254, 136, 177)"
18191,2020-05-21,Mongolia,0,0,140,"rgb(254, 136, 177)"
18192,2020-05-22,Mongolia,0,1,141,"rgb(254, 136, 177)"
18193,2020-05-23,Mongolia,0,0,141,"rgb(254, 136, 177)"
18194,2020-05-24,Mongolia,0,0,141,"rgb(254, 136, 177)"
18195,2020-05-25,Mongolia,0,0,141,"rgb(254, 136, 177)"
18196,2020-05-26,Mongolia,0,0,141,"rgb(254, 136, 177)"
18197,2020-05-27,Mongolia,0,7,148,"rgb(254, 136, 177)"
18198,2020-05-28,Mongolia,0,13,161,"rgb(254, 136, 177)"
18199,2020-05-29,Mongolia,0,18,179,"rgb(254, 136, 177)"
18200,2020-05-30,Mongolia,0,0,179,"rgb(254, 136, 177)"
18201,2020-05-31,Mongolia,0,0,179,"rgb(254, 136, 177)"
18202,2020-06-01,Mongolia,0,6,185,"rgb(254, 136, 177)"
18203,2020-06-02,Mongolia,0,0,185,"rgb(254, 136, 177)"
18204,2020-06-03,Mongolia,0,0,185,"rgb(254, 136, 177)"
18205,2020-06-04,Mongolia,0,1,186,"rgb(254, 136, 177)"
18206,2020-06-05,Mongolia,0,5,191,"rgb(254, 136, 177)"
18207,2020-06-06,Mongolia,0,0,191,"rgb(254, 136, 177)"
18208,2020-06-07,Mongolia,0,2,193,"rgb(254, 136, 177)"
18209,2020-06-08,Mongolia,0,1,194,"rgb(254, 136, 177)"
18210,2020-06-09,Mongolia,0,0,194,"rgb(254, 136, 177)"
18211,2020-06-10,Mongolia,0,0,194,"rgb(254, 136, 177)"
18212,2020-06-11,Mongolia,0,0,194,"rgb(254, 136, 177)"
18213,2020-06-12,Mongolia,0,3,197,"rgb(254, 136, 177)"
18214,2020-06-13,Mongolia,0,0,197,"rgb(254, 136, 177)"
18215,2020-06-14,Mongolia,0,0,197,"rgb(254, 136, 177)"
18216,2020-06-15,Mongolia,0,0,197,"rgb(254, 136, 177)"
18217,2020-06-16,Mongolia,0,0,197,"rgb(254, 136, 177)"
18218,2020-06-17,Mongolia,0,0,197,"rgb(254, 136, 177)"
18219,2020-06-18,Mongolia,0,4,201,"rgb(254, 136, 177)"
18220,2020-06-19,Mongolia,0,3,204,"rgb(254, 136, 177)"
18221,2020-06-20,Mongolia,0,0,204,"rgb(254, 136, 177)"
18222,2020-06-21,Mongolia,0,2,206,"rgb(254, 136, 177)"
18223,2020-06-22,Mongolia,0,7,213,"rgb(254, 136, 177)"
18224,2020-06-23,Mongolia,0,2,215,"rgb(254, 136, 177)"
18225,2020-06-24,Mongolia,0,0,215,"rgb(254, 136, 177)"
18226,2020-06-25,Mongolia,0,1,216,"rgb(254, 136, 177)"
18227,2020-06-26,Mongolia,0,3,219,"rgb(254, 136, 177)"
18228,2020-06-27,Mongolia,0,0,219,"rgb(254, 136, 177)"
18229,2020-06-28,Mongolia,0,0,219,"rgb(254, 136, 177)"
18230,2020-06-29,Mongolia,0,1,220,"rgb(254, 136, 177)"
18231,2020-06-30,Mongolia,0,0,220,"rgb(254, 136, 177)"
18232,2020-07-01,Mongolia,0,0,220,"rgb(254, 136, 177)"
18233,2020-07-02,Mongolia,0,0,220,"rgb(254, 136, 177)"
18234,2020-07-03,Mongolia,0,0,220,"rgb(254, 136, 177)"
18235,2020-07-04,Mongolia,0,0,220,"rgb(254, 136, 177)"
18236,2020-07-05,Mongolia,0,0,220,"rgb(254, 136, 177)"
18237,2020-07-06,Mongolia,0,0,220,"rgb(254, 136, 177)"
18238,2020-07-07,Mongolia,0,0,220,"rgb(254, 136, 177)"
18239,2020-07-08,Mongolia,0,0,220,"rgb(254, 136, 177)"
18240,2020-07-09,Mongolia,0,7,227,"rgb(254, 136, 177)"
18241,2020-07-10,Mongolia,0,0,227,"rgb(254, 136, 177)"
18242,2020-07-11,Mongolia,0,0,227,"rgb(254, 136, 177)"
18243,2020-07-12,Mongolia,0,3,230,"rgb(254, 136, 177)"
18244,2020-07-13,Mongolia,0,0,230,"rgb(254, 136, 177)"
18245,2020-03-31,Northern Marianas,0,2,2,"rgb(201, 219, 116)"
18246,2020-04-01,Northern Marianas,0,4,6,"rgb(201, 219, 116)"
18247,2020-04-02,Northern Marianas,1,0,6,"rgb(201, 219, 116)"
18248,2020-04-03,Northern Marianas,0,2,8,"rgb(201, 219, 116)"
18249,2020-04-04,Northern Marianas,0,0,8,"rgb(201, 219, 116)"
18250,2020-04-05,Northern Marianas,0,0,8,"rgb(201, 219, 116)"
18251,2020-04-06,Northern Marianas,0,0,8,"rgb(201, 219, 116)"
18252,2020-04-07,Northern Marianas,0,0,8,"rgb(201, 219, 116)"
18253,2020-04-08,Northern Marianas,1,0,8,"rgb(201, 219, 116)"
18254,2020-04-09,Northern Marianas,0,3,11,"rgb(201, 219, 116)"
18255,2020-04-10,Northern Marianas,0,0,11,"rgb(201, 219, 116)"
18256,2020-04-11,Northern Marianas,0,0,11,"rgb(201, 219, 116)"
18257,2020-04-12,Northern Marianas,0,0,11,"rgb(201, 219, 116)"
18258,2020-04-13,Northern Marianas,0,0,11,"rgb(201, 219, 116)"
18259,2020-04-14,Northern Marianas,0,0,11,"rgb(201, 219, 116)"
18260,2020-04-15,Northern Marianas,0,2,13,"rgb(201, 219, 116)"
18261,2020-04-16,Northern Marianas,0,0,13,"rgb(201, 219, 116)"
18262,2020-04-17,Northern Marianas,0,0,13,"rgb(201, 219, 116)"
18263,2020-04-18,Northern Marianas,0,1,14,"rgb(201, 219, 116)"
18264,2020-04-19,Northern Marianas,0,0,14,"rgb(201, 219, 116)"
18265,2020-04-20,Northern Marianas,0,0,14,"rgb(201, 219, 116)"
18266,2020-04-21,Northern Marianas,0,0,14,"rgb(201, 219, 116)"
18267,2020-04-22,Northern Marianas,0,0,14,"rgb(201, 219, 116)"
18268,2020-04-23,Northern Marianas,0,0,14,"rgb(201, 219, 116)"
18269,2020-04-24,Northern Marianas,0,0,14,"rgb(201, 219, 116)"
18270,2020-04-25,Northern Marianas,0,0,14,"rgb(201, 219, 116)"
18271,2020-04-26,Northern Marianas,0,0,14,"rgb(201, 219, 116)"
18272,2020-04-27,Northern Marianas,0,0,14,"rgb(201, 219, 116)"
18273,2020-04-28,Northern Marianas,0,0,14,"rgb(201, 219, 116)"
18274,2020-04-29,Northern Marianas,0,0,14,"rgb(201, 219, 116)"
18275,2020-04-30,Northern Marianas,0,0,14,"rgb(201, 219, 116)"
18276,2020-05-01,Northern Marianas,0,0,14,"rgb(201, 219, 116)"
18277,2020-05-02,Northern Marianas,0,0,14,"rgb(201, 219, 116)"
18278,2020-05-03,Northern Marianas,0,0,14,"rgb(201, 219, 116)"
18279,2020-05-04,Northern Marianas,0,0,14,"rgb(201, 219, 116)"
18280,2020-05-05,Northern Marianas,0,0,14,"rgb(201, 219, 116)"
18281,2020-05-06,Northern Marianas,0,0,14,"rgb(201, 219, 116)"
18282,2020-05-07,Northern Marianas,0,1,15,"rgb(201, 219, 116)"
18283,2020-05-08,Northern Marianas,0,0,15,"rgb(201, 219, 116)"
18284,2020-05-09,Northern Marianas,0,0,15,"rgb(201, 219, 116)"
18285,2020-05-10,Northern Marianas,0,1,16,"rgb(201, 219, 116)"
18286,2020-05-11,Northern Marianas,0,0,16,"rgb(201, 219, 116)"
18287,2020-05-12,Northern Marianas,0,3,19,"rgb(201, 219, 116)"
18288,2020-05-13,Northern Marianas,0,0,19,"rgb(201, 219, 116)"
18289,2020-05-14,Northern Marianas,0,0,19,"rgb(201, 219, 116)"
18290,2020-05-15,Northern Marianas,0,0,19,"rgb(201, 219, 116)"
18291,2020-05-16,Northern Marianas,0,0,19,"rgb(201, 219, 116)"
18292,2020-05-17,Northern Marianas,0,2,21,"rgb(201, 219, 116)"
18293,2020-05-18,Northern Marianas,0,0,21,"rgb(201, 219, 116)"
18294,2020-05-19,Northern Marianas,0,0,21,"rgb(201, 219, 116)"
18295,2020-05-20,Northern Marianas,0,0,21,"rgb(201, 219, 116)"
18296,2020-05-21,Northern Marianas,0,1,22,"rgb(201, 219, 116)"
18297,2020-05-22,Northern Marianas,0,0,22,"rgb(201, 219, 116)"
18298,2020-05-23,Northern Marianas,0,0,22,"rgb(201, 219, 116)"
18299,2020-05-24,Northern Marianas,0,0,22,"rgb(201, 219, 116)"
18300,2020-05-25,Northern Marianas,0,0,22,"rgb(201, 219, 116)"
18301,2020-05-26,Northern Marianas,0,0,22,"rgb(201, 219, 116)"
18302,2020-05-27,Northern Marianas,0,0,22,"rgb(201, 219, 116)"
18303,2020-05-28,Northern Marianas,0,0,22,"rgb(201, 219, 116)"
18304,2020-05-29,Northern Marianas,0,0,22,"rgb(201, 219, 116)"
18305,2020-05-30,Northern Marianas,0,0,22,"rgb(201, 219, 116)"
18306,2020-05-31,Northern Marianas,0,0,22,"rgb(201, 219, 116)"
18307,2020-06-01,Northern Marianas,0,0,22,"rgb(201, 219, 116)"
18308,2020-06-02,Northern Marianas,0,0,22,"rgb(201, 219, 116)"
18309,2020-06-03,Northern Marianas,0,1,23,"rgb(201, 219, 116)"
18310,2020-06-04,Northern Marianas,0,1,24,"rgb(201, 219, 116)"
18311,2020-06-05,Northern Marianas,0,2,26,"rgb(201, 219, 116)"
18312,2020-06-06,Northern Marianas,0,0,26,"rgb(201, 219, 116)"
18313,2020-06-07,Northern Marianas,0,1,27,"rgb(201, 219, 116)"
18314,2020-06-08,Northern Marianas,0,0,27,"rgb(201, 219, 116)"
18315,2020-06-09,Northern Marianas,0,1,28,"rgb(201, 219, 116)"
18316,2020-06-10,Northern Marianas,0,2,30,"rgb(201, 219, 116)"
18317,2020-06-11,Northern Marianas,0,0,30,"rgb(201, 219, 116)"
18318,2020-06-12,Northern Marianas,0,0,30,"rgb(201, 219, 116)"
18319,2020-06-13,Northern Marianas,0,0,30,"rgb(201, 219, 116)"
18320,2020-06-14,Northern Marianas,0,0,30,"rgb(201, 219, 116)"
18321,2020-06-15,Northern Marianas,0,0,30,"rgb(201, 219, 116)"
18322,2020-06-16,Northern Marianas,0,0,30,"rgb(201, 219, 116)"
18323,2020-06-17,Northern Marianas,0,0,30,"rgb(201, 219, 116)"
18324,2020-06-18,Northern Marianas,0,0,30,"rgb(201, 219, 116)"
18325,2020-06-19,Northern Marianas,0,0,30,"rgb(201, 219, 116)"
18326,2020-06-20,Northern Marianas,0,0,30,"rgb(201, 219, 116)"
18327,2020-06-21,Northern Marianas,0,0,30,"rgb(201, 219, 116)"
18328,2020-06-22,Northern Marianas,0,0,30,"rgb(201, 219, 116)"
18329,2020-06-23,Northern Marianas,0,0,30,"rgb(201, 219, 116)"
18330,2020-06-24,Northern Marianas,0,0,30,"rgb(201, 219, 116)"
18331,2020-06-25,Northern Marianas,0,0,30,"rgb(201, 219, 116)"
18332,2020-06-26,Northern Marianas,0,0,30,"rgb(201, 219, 116)"
18333,2020-06-27,Northern Marianas,0,0,30,"rgb(201, 219, 116)"
18334,2020-06-28,Northern Marianas,0,0,30,"rgb(201, 219, 116)"
18335,2020-06-29,Northern Marianas,0,0,30,"rgb(201, 219, 116)"
18336,2020-06-30,Northern Marianas,0,0,30,"rgb(201, 219, 116)"
18337,2020-07-01,Northern Marianas,0,0,30,"rgb(201, 219, 116)"
18338,2020-07-02,Northern Marianas,0,0,30,"rgb(201, 219, 116)"
18339,2020-07-03,Northern Marianas,0,1,31,"rgb(201, 219, 116)"
18340,2020-07-04,Northern Marianas,0,0,31,"rgb(201, 219, 116)"
18341,2020-07-05,Northern Marianas,0,0,31,"rgb(201, 219, 116)"
18342,2020-07-06,Northern Marianas,0,0,31,"rgb(201, 219, 116)"
18343,2020-07-07,Northern Marianas,0,0,31,"rgb(201, 219, 116)"
18344,2020-07-08,Northern Marianas,0,0,31,"rgb(201, 219, 116)"
18345,2020-07-09,Northern Marianas,0,0,31,"rgb(201, 219, 116)"
18346,2020-07-10,Northern Marianas,0,0,31,"rgb(201, 219, 116)"
18347,2020-07-11,Northern Marianas,0,0,31,"rgb(201, 219, 116)"
18348,2020-07-12,Northern Marianas,0,2,33,"rgb(201, 219, 116)"
18349,2020-07-13,Northern Marianas,0,0,33,"rgb(201, 219, 116)"
18350,2020-03-15,Mauritania,0,1,1,"rgb(139, 224, 164)"
18351,2020-03-16,Mauritania,0,0,1,"rgb(139, 224, 164)"
18352,2020-03-17,Mauritania,0,0,1,"rgb(139, 224, 164)"
18353,2020-03-18,Mauritania,0,0,1,"rgb(139, 224, 164)"
18354,2020-03-19,Mauritania,0,0,1,"rgb(139, 224, 164)"
18355,2020-03-20,Mauritania,0,1,2,"rgb(139, 224, 164)"
18356,2020-03-21,Mauritania,0,0,2,"rgb(139, 224, 164)"
18357,2020-03-22,Mauritania,0,0,2,"rgb(139, 224, 164)"
18358,2020-03-23,Mauritania,0,0,2,"rgb(139, 224, 164)"
18359,2020-03-24,Mauritania,0,0,2,"rgb(139, 224, 164)"
18360,2020-03-25,Mauritania,0,0,2,"rgb(139, 224, 164)"
18361,2020-03-26,Mauritania,0,0,2,"rgb(139, 224, 164)"
18362,2020-03-27,Mauritania,0,1,3,"rgb(139, 224, 164)"
18363,2020-03-28,Mauritania,0,0,3,"rgb(139, 224, 164)"
18364,2020-03-29,Mauritania,0,2,5,"rgb(139, 224, 164)"
18365,2020-03-30,Mauritania,0,0,5,"rgb(139, 224, 164)"
18366,2020-03-31,Mauritania,0,0,5,"rgb(139, 224, 164)"
18367,2020-04-01,Mauritania,0,0,5,"rgb(139, 224, 164)"
18368,2020-04-02,Mauritania,0,0,5,"rgb(139, 224, 164)"
18369,2020-04-03,Mauritania,1,1,6,"rgb(139, 224, 164)"
18370,2020-04-04,Mauritania,0,0,6,"rgb(139, 224, 164)"
18371,2020-04-05,Mauritania,0,0,6,"rgb(139, 224, 164)"
18372,2020-04-06,Mauritania,0,0,6,"rgb(139, 224, 164)"
18373,2020-04-07,Mauritania,0,0,6,"rgb(139, 224, 164)"
18374,2020-04-08,Mauritania,0,0,6,"rgb(139, 224, 164)"
18375,2020-04-09,Mauritania,0,0,6,"rgb(139, 224, 164)"
18376,2020-04-10,Mauritania,0,1,7,"rgb(139, 224, 164)"
18377,2020-04-11,Mauritania,0,0,7,"rgb(139, 224, 164)"
18378,2020-04-12,Mauritania,0,0,7,"rgb(139, 224, 164)"
18379,2020-04-13,Mauritania,0,0,7,"rgb(139, 224, 164)"
18380,2020-04-14,Mauritania,0,0,7,"rgb(139, 224, 164)"
18381,2020-04-15,Mauritania,0,0,7,"rgb(139, 224, 164)"
18382,2020-04-16,Mauritania,0,0,7,"rgb(139, 224, 164)"
18383,2020-04-17,Mauritania,0,0,7,"rgb(139, 224, 164)"
18384,2020-04-18,Mauritania,0,0,7,"rgb(139, 224, 164)"
18385,2020-04-19,Mauritania,0,0,7,"rgb(139, 224, 164)"
18386,2020-04-20,Mauritania,0,0,7,"rgb(139, 224, 164)"
18387,2020-04-21,Mauritania,0,0,7,"rgb(139, 224, 164)"
18388,2020-04-22,Mauritania,0,0,7,"rgb(139, 224, 164)"
18389,2020-04-23,Mauritania,0,0,7,"rgb(139, 224, 164)"
18390,2020-04-24,Mauritania,0,0,7,"rgb(139, 224, 164)"
18391,2020-04-25,Mauritania,0,0,7,"rgb(139, 224, 164)"
18392,2020-04-26,Mauritania,0,0,7,"rgb(139, 224, 164)"
18393,2020-04-27,Mauritania,0,0,7,"rgb(139, 224, 164)"
18394,2020-04-28,Mauritania,0,0,7,"rgb(139, 224, 164)"
18395,2020-04-29,Mauritania,0,0,7,"rgb(139, 224, 164)"
18396,2020-04-30,Mauritania,0,0,7,"rgb(139, 224, 164)"
18397,2020-05-01,Mauritania,0,1,8,"rgb(139, 224, 164)"
18398,2020-05-02,Mauritania,0,0,8,"rgb(139, 224, 164)"
18399,2020-05-03,Mauritania,0,0,8,"rgb(139, 224, 164)"
18400,2020-05-04,Mauritania,0,0,8,"rgb(139, 224, 164)"
18401,2020-05-05,Mauritania,0,0,8,"rgb(139, 224, 164)"
18402,2020-05-06,Mauritania,0,0,8,"rgb(139, 224, 164)"
18403,2020-05-07,Mauritania,0,0,8,"rgb(139, 224, 164)"
18404,2020-05-08,Mauritania,0,0,8,"rgb(139, 224, 164)"
18405,2020-05-09,Mauritania,0,0,8,"rgb(139, 224, 164)"
18406,2020-05-10,Mauritania,0,0,8,"rgb(139, 224, 164)"
18407,2020-05-11,Mauritania,0,0,8,"rgb(139, 224, 164)"
18408,2020-05-12,Mauritania,0,0,8,"rgb(139, 224, 164)"
18409,2020-05-13,Mauritania,0,0,8,"rgb(139, 224, 164)"
18410,2020-05-14,Mauritania,1,1,9,"rgb(139, 224, 164)"
18411,2020-05-15,Mauritania,0,7,16,"rgb(139, 224, 164)"
18412,2020-05-16,Mauritania,1,13,29,"rgb(139, 224, 164)"
18413,2020-05-17,Mauritania,0,0,29,"rgb(139, 224, 164)"
18414,2020-05-18,Mauritania,1,33,62,"rgb(139, 224, 164)"
18415,2020-05-19,Mauritania,0,19,81,"rgb(139, 224, 164)"
18416,2020-05-20,Mauritania,0,0,81,"rgb(139, 224, 164)"
18417,2020-05-21,Mauritania,0,50,131,"rgb(139, 224, 164)"
18418,2020-05-22,Mauritania,1,42,173,"rgb(139, 224, 164)"
18419,2020-05-23,Mauritania,0,0,173,"rgb(139, 224, 164)"
18420,2020-05-24,Mauritania,1,54,227,"rgb(139, 224, 164)"
18421,2020-05-25,Mauritania,0,10,237,"rgb(139, 224, 164)"
18422,2020-05-26,Mauritania,0,0,237,"rgb(139, 224, 164)"
18423,2020-05-27,Mauritania,3,25,262,"rgb(139, 224, 164)"
18424,2020-05-28,Mauritania,7,30,292,"rgb(139, 224, 164)"
18425,2020-05-29,Mauritania,0,0,292,"rgb(139, 224, 164)"
18426,2020-05-30,Mauritania,4,131,423,"rgb(139, 224, 164)"
18427,2020-05-31,Mauritania,1,60,483,"rgb(139, 224, 164)"
18428,2020-06-01,Mauritania,2,47,530,"rgb(139, 224, 164)"
18429,2020-06-02,Mauritania,0,0,530,"rgb(139, 224, 164)"
18430,2020-06-03,Mauritania,8,138,668,"rgb(139, 224, 164)"
18431,2020-06-04,Mauritania,0,0,668,"rgb(139, 224, 164)"
18432,2020-06-05,Mauritania,8,116,784,"rgb(139, 224, 164)"
18433,2020-06-06,Mauritania,4,99,883,"rgb(139, 224, 164)"
18434,2020-06-07,Mauritania,0,64,947,"rgb(139, 224, 164)"
18435,2020-06-08,Mauritania,0,0,947,"rgb(139, 224, 164)"
18436,2020-06-09,Mauritania,0,0,947,"rgb(139, 224, 164)"
18437,2020-06-10,Mauritania,18,215,1162,"rgb(139, 224, 164)"
18438,2020-06-11,Mauritania,0,0,1162,"rgb(139, 224, 164)"
18439,2020-06-12,Mauritania,0,0,1162,"rgb(139, 224, 164)"
18440,2020-06-13,Mauritania,13,277,1439,"rgb(139, 224, 164)"
18441,2020-06-14,Mauritania,0,0,1439,"rgb(139, 224, 164)"
18442,2020-06-15,Mauritania,13,344,1783,"rgb(139, 224, 164)"
18443,2020-06-16,Mauritania,4,104,1887,"rgb(139, 224, 164)"
18444,2020-06-17,Mauritania,2,170,2057,"rgb(139, 224, 164)"
18445,2020-06-18,Mauritania,0,0,2057,"rgb(139, 224, 164)"
18446,2020-06-19,Mauritania,2,166,2223,"rgb(139, 224, 164)"
18447,2020-06-20,Mauritania,0,0,2223,"rgb(139, 224, 164)"
18448,2020-06-21,Mauritania,13,590,2813,"rgb(139, 224, 164)"
18449,2020-06-22,Mauritania,0,0,2813,"rgb(139, 224, 164)"
18450,2020-06-23,Mauritania,3,171,2984,"rgb(139, 224, 164)"
18451,2020-06-24,Mauritania,0,0,2984,"rgb(139, 224, 164)"
18452,2020-06-25,Mauritania,3,308,3292,"rgb(139, 224, 164)"
18453,2020-06-26,Mauritania,5,447,3739,"rgb(139, 224, 164)"
18454,2020-06-27,Mauritania,0,0,3739,"rgb(139, 224, 164)"
18455,2020-06-28,Mauritania,1,168,3907,"rgb(139, 224, 164)"
18456,2020-06-29,Mauritania,0,0,3907,"rgb(139, 224, 164)"
18457,2020-06-30,Mauritania,6,242,4149,"rgb(139, 224, 164)"
18458,2020-07-01,Mauritania,0,0,4149,"rgb(139, 224, 164)"
18459,2020-07-02,Mauritania,0,0,4149,"rgb(139, 224, 164)"
18460,2020-07-03,Mauritania,3,323,4472,"rgb(139, 224, 164)"
18461,2020-07-04,Mauritania,0,0,4472,"rgb(139, 224, 164)"
18462,2020-07-05,Mauritania,0,355,4827,"rgb(139, 224, 164)"
18463,2020-07-06,Mauritania,1,52,4879,"rgb(139, 224, 164)"
18464,2020-07-07,Mauritania,0,0,4879,"rgb(139, 224, 164)"
18465,2020-07-08,Mauritania,0,0,4879,"rgb(139, 224, 164)"
18466,2020-07-09,Mauritania,5,145,5024,"rgb(139, 224, 164)"
18467,2020-07-10,Mauritania,4,63,5087,"rgb(139, 224, 164)"
18468,2020-07-11,Mauritania,5,39,5126,"rgb(139, 224, 164)"
18469,2020-07-12,Mauritania,0,0,5126,"rgb(139, 224, 164)"
18470,2020-07-13,Mauritania,0,0,5126,"rgb(139, 224, 164)"
18471,2020-03-21,Montserrat,0,1,1,"rgb(180, 151, 231)"
18472,2020-03-22,Montserrat,0,0,1,"rgb(180, 151, 231)"
18473,2020-03-23,Montserrat,0,0,1,"rgb(180, 151, 231)"
18474,2020-03-24,Montserrat,0,0,1,"rgb(180, 151, 231)"
18475,2020-03-25,Montserrat,0,0,1,"rgb(180, 151, 231)"
18476,2020-03-26,Montserrat,0,0,1,"rgb(180, 151, 231)"
18477,2020-03-27,Montserrat,0,4,5,"rgb(180, 151, 231)"
18478,2020-03-28,Montserrat,0,0,5,"rgb(180, 151, 231)"
18479,2020-03-29,Montserrat,0,0,5,"rgb(180, 151, 231)"
18480,2020-03-30,Montserrat,0,0,5,"rgb(180, 151, 231)"
18481,2020-03-31,Montserrat,0,0,5,"rgb(180, 151, 231)"
18482,2020-04-02,Montserrat,0,0,5,"rgb(180, 151, 231)"
18483,2020-04-03,Montserrat,0,0,5,"rgb(180, 151, 231)"
18484,2020-04-04,Montserrat,0,0,5,"rgb(180, 151, 231)"
18485,2020-04-05,Montserrat,0,1,6,"rgb(180, 151, 231)"
18486,2020-04-06,Montserrat,0,0,6,"rgb(180, 151, 231)"
18487,2020-04-07,Montserrat,0,0,6,"rgb(180, 151, 231)"
18488,2020-04-08,Montserrat,0,0,6,"rgb(180, 151, 231)"
18489,2020-04-09,Montserrat,0,3,9,"rgb(180, 151, 231)"
18490,2020-04-10,Montserrat,0,0,9,"rgb(180, 151, 231)"
18491,2020-04-11,Montserrat,0,0,9,"rgb(180, 151, 231)"
18492,2020-04-12,Montserrat,0,0,9,"rgb(180, 151, 231)"
18493,2020-04-13,Montserrat,0,2,11,"rgb(180, 151, 231)"
18494,2020-04-14,Montserrat,0,0,11,"rgb(180, 151, 231)"
18495,2020-04-15,Montserrat,0,0,11,"rgb(180, 151, 231)"
18496,2020-04-16,Montserrat,0,0,11,"rgb(180, 151, 231)"
18497,2020-04-17,Montserrat,0,0,11,"rgb(180, 151, 231)"
18498,2020-04-18,Montserrat,0,0,11,"rgb(180, 151, 231)"
18499,2020-04-19,Montserrat,0,0,11,"rgb(180, 151, 231)"
18500,2020-04-20,Montserrat,0,0,11,"rgb(180, 151, 231)"
18501,2020-04-21,Montserrat,0,0,11,"rgb(180, 151, 231)"
18502,2020-04-22,Montserrat,0,0,11,"rgb(180, 151, 231)"
18503,2020-04-23,Montserrat,0,0,11,"rgb(180, 151, 231)"
18504,2020-04-24,Montserrat,0,0,11,"rgb(180, 151, 231)"
18505,2020-04-25,Montserrat,0,0,11,"rgb(180, 151, 231)"
18506,2020-04-26,Montserrat,1,0,11,"rgb(180, 151, 231)"
18507,2020-04-27,Montserrat,0,0,11,"rgb(180, 151, 231)"
18508,2020-04-28,Montserrat,0,0,11,"rgb(180, 151, 231)"
18509,2020-04-29,Montserrat,0,0,11,"rgb(180, 151, 231)"
18510,2020-04-30,Montserrat,0,0,11,"rgb(180, 151, 231)"
18511,2020-05-01,Montserrat,0,0,11,"rgb(180, 151, 231)"
18512,2020-05-02,Montserrat,0,0,11,"rgb(180, 151, 231)"
18513,2020-05-03,Montserrat,0,0,11,"rgb(180, 151, 231)"
18514,2020-05-04,Montserrat,0,0,11,"rgb(180, 151, 231)"
18515,2020-05-05,Montserrat,0,0,11,"rgb(180, 151, 231)"
18516,2020-05-06,Montserrat,0,0,11,"rgb(180, 151, 231)"
18517,2020-05-07,Montserrat,0,0,11,"rgb(180, 151, 231)"
18518,2020-05-08,Montserrat,0,0,11,"rgb(180, 151, 231)"
18519,2020-05-09,Montserrat,0,0,11,"rgb(180, 151, 231)"
18520,2020-05-10,Montserrat,0,0,11,"rgb(180, 151, 231)"
18521,2020-05-11,Montserrat,0,0,11,"rgb(180, 151, 231)"
18522,2020-05-12,Montserrat,0,0,11,"rgb(180, 151, 231)"
18523,2020-05-13,Montserrat,0,0,11,"rgb(180, 151, 231)"
18524,2020-05-14,Montserrat,0,0,11,"rgb(180, 151, 231)"
18525,2020-05-15,Montserrat,0,0,11,"rgb(180, 151, 231)"
18526,2020-05-16,Montserrat,0,0,11,"rgb(180, 151, 231)"
18527,2020-05-17,Montserrat,0,0,11,"rgb(180, 151, 231)"
18528,2020-05-18,Montserrat,0,0,11,"rgb(180, 151, 231)"
18529,2020-05-19,Montserrat,0,0,11,"rgb(180, 151, 231)"
18530,2020-05-20,Montserrat,0,0,11,"rgb(180, 151, 231)"
18531,2020-05-21,Montserrat,0,0,11,"rgb(180, 151, 231)"
18532,2020-05-22,Montserrat,0,0,11,"rgb(180, 151, 231)"
18533,2020-05-23,Montserrat,0,0,11,"rgb(180, 151, 231)"
18534,2020-05-24,Montserrat,0,0,11,"rgb(180, 151, 231)"
18535,2020-05-25,Montserrat,0,0,11,"rgb(180, 151, 231)"
18536,2020-05-26,Montserrat,0,0,11,"rgb(180, 151, 231)"
18537,2020-05-27,Montserrat,0,0,11,"rgb(180, 151, 231)"
18538,2020-05-28,Montserrat,0,0,11,"rgb(180, 151, 231)"
18539,2020-05-29,Montserrat,0,0,11,"rgb(180, 151, 231)"
18540,2020-05-30,Montserrat,0,0,11,"rgb(180, 151, 231)"
18541,2020-05-31,Montserrat,0,0,11,"rgb(180, 151, 231)"
18542,2020-06-01,Montserrat,0,0,11,"rgb(180, 151, 231)"
18543,2020-06-02,Montserrat,0,0,11,"rgb(180, 151, 231)"
18544,2020-06-03,Montserrat,0,0,11,"rgb(180, 151, 231)"
18545,2020-06-04,Montserrat,0,0,11,"rgb(180, 151, 231)"
18546,2020-06-05,Montserrat,0,0,11,"rgb(180, 151, 231)"
18547,2020-06-06,Montserrat,0,0,11,"rgb(180, 151, 231)"
18548,2020-06-07,Montserrat,0,0,11,"rgb(180, 151, 231)"
18549,2020-06-08,Montserrat,0,0,11,"rgb(180, 151, 231)"
18550,2020-06-09,Montserrat,0,0,11,"rgb(180, 151, 231)"
18551,2020-06-10,Montserrat,0,0,11,"rgb(180, 151, 231)"
18552,2020-06-11,Montserrat,0,0,11,"rgb(180, 151, 231)"
18553,2020-06-12,Montserrat,0,0,11,"rgb(180, 151, 231)"
18554,2020-06-13,Montserrat,0,0,11,"rgb(180, 151, 231)"
18555,2020-06-14,Montserrat,0,0,11,"rgb(180, 151, 231)"
18556,2020-06-15,Montserrat,0,0,11,"rgb(180, 151, 231)"
18557,2020-06-16,Montserrat,0,0,11,"rgb(180, 151, 231)"
18558,2020-06-17,Montserrat,0,0,11,"rgb(180, 151, 231)"
18559,2020-06-18,Montserrat,0,0,11,"rgb(180, 151, 231)"
18560,2020-06-19,Montserrat,0,0,11,"rgb(180, 151, 231)"
18561,2020-06-20,Montserrat,0,0,11,"rgb(180, 151, 231)"
18562,2020-06-21,Montserrat,0,0,11,"rgb(180, 151, 231)"
18563,2020-06-22,Montserrat,0,0,11,"rgb(180, 151, 231)"
18564,2020-06-23,Montserrat,0,0,11,"rgb(180, 151, 231)"
18565,2020-06-24,Montserrat,0,0,11,"rgb(180, 151, 231)"
18566,2020-06-25,Montserrat,0,0,11,"rgb(180, 151, 231)"
18567,2020-06-26,Montserrat,0,0,11,"rgb(180, 151, 231)"
18568,2020-06-27,Montserrat,0,0,11,"rgb(180, 151, 231)"
18569,2020-06-28,Montserrat,0,0,11,"rgb(180, 151, 231)"
18570,2020-06-29,Montserrat,0,0,11,"rgb(180, 151, 231)"
18571,2020-06-30,Montserrat,0,0,11,"rgb(180, 151, 231)"
18572,2020-07-01,Montserrat,0,0,11,"rgb(180, 151, 231)"
18573,2020-07-02,Montserrat,0,0,11,"rgb(180, 151, 231)"
18574,2020-07-03,Montserrat,0,0,11,"rgb(180, 151, 231)"
18575,2020-07-04,Montserrat,0,0,11,"rgb(180, 151, 231)"
18576,2020-07-05,Montserrat,0,0,11,"rgb(180, 151, 231)"
18577,2020-07-06,Montserrat,0,0,11,"rgb(180, 151, 231)"
18578,2020-07-07,Montserrat,0,0,11,"rgb(180, 151, 231)"
18579,2020-07-08,Montserrat,0,0,11,"rgb(180, 151, 231)"
18580,2020-07-09,Montserrat,0,0,11,"rgb(180, 151, 231)"
18581,2020-07-10,Montserrat,0,0,11,"rgb(180, 151, 231)"
18582,2020-07-11,Montserrat,0,1,12,"rgb(180, 151, 231)"
18583,2020-07-12,Montserrat,0,0,12,"rgb(180, 151, 231)"
18584,2020-07-13,Montserrat,0,0,12,"rgb(180, 151, 231)"
18585,2020-03-07,Malta,0,1,1,"rgb(179, 179, 179)"
18586,2020-03-08,Malta,0,2,3,"rgb(179, 179, 179)"
18587,2020-03-09,Malta,0,0,3,"rgb(179, 179, 179)"
18588,2020-03-10,Malta,0,2,5,"rgb(179, 179, 179)"
18589,2020-03-11,Malta,0,1,6,"rgb(179, 179, 179)"
18590,2020-03-12,Malta,0,1,7,"rgb(179, 179, 179)"
18591,2020-03-13,Malta,0,1,8,"rgb(179, 179, 179)"
18592,2020-03-14,Malta,0,10,18,"rgb(179, 179, 179)"
18593,2020-03-15,Malta,0,2,20,"rgb(179, 179, 179)"
18594,2020-03-16,Malta,0,10,30,"rgb(179, 179, 179)"
18595,2020-03-17,Malta,0,8,38,"rgb(179, 179, 179)"
18596,2020-03-18,Malta,0,10,48,"rgb(179, 179, 179)"
18597,2020-03-19,Malta,0,4,52,"rgb(179, 179, 179)"
18598,2020-03-20,Malta,0,12,64,"rgb(179, 179, 179)"
18599,2020-03-21,Malta,0,9,73,"rgb(179, 179, 179)"
18600,2020-03-22,Malta,0,17,90,"rgb(179, 179, 179)"
18601,2020-03-23,Malta,0,17,107,"rgb(179, 179, 179)"
18602,2020-03-24,Malta,0,5,112,"rgb(179, 179, 179)"
18603,2020-03-25,Malta,0,17,129,"rgb(179, 179, 179)"
18604,2020-03-26,Malta,0,5,134,"rgb(179, 179, 179)"
18605,2020-03-27,Malta,0,5,139,"rgb(179, 179, 179)"
18606,2020-03-28,Malta,0,10,149,"rgb(179, 179, 179)"
18607,2020-03-29,Malta,0,2,151,"rgb(179, 179, 179)"
18608,2020-03-30,Malta,0,5,156,"rgb(179, 179, 179)"
18609,2020-03-31,Malta,0,9,165,"rgb(179, 179, 179)"
18610,2020-04-01,Malta,0,19,184,"rgb(179, 179, 179)"
18611,2020-04-02,Malta,0,10,194,"rgb(179, 179, 179)"
18612,2020-04-03,Malta,0,7,201,"rgb(179, 179, 179)"
18613,2020-04-04,Malta,0,5,206,"rgb(179, 179, 179)"
18614,2020-04-05,Malta,0,12,218,"rgb(179, 179, 179)"
18615,2020-04-06,Malta,0,17,235,"rgb(179, 179, 179)"
18616,2020-04-07,Malta,0,19,254,"rgb(179, 179, 179)"
18617,2020-04-08,Malta,0,44,298,"rgb(179, 179, 179)"
18618,2020-04-09,Malta,1,9,307,"rgb(179, 179, 179)"
18619,2020-04-10,Malta,1,35,342,"rgb(179, 179, 179)"
18620,2020-04-11,Malta,0,18,360,"rgb(179, 179, 179)"
18621,2020-04-12,Malta,1,13,373,"rgb(179, 179, 179)"
18622,2020-04-13,Malta,0,11,384,"rgb(179, 179, 179)"
18623,2020-04-14,Malta,0,1,385,"rgb(179, 179, 179)"
18624,2020-04-15,Malta,0,8,393,"rgb(179, 179, 179)"
18625,2020-04-16,Malta,0,15,408,"rgb(179, 179, 179)"
18626,2020-04-17,Malta,0,5,413,"rgb(179, 179, 179)"
18627,2020-04-18,Malta,0,9,422,"rgb(179, 179, 179)"
18628,2020-04-19,Malta,0,4,426,"rgb(179, 179, 179)"
18629,2020-04-20,Malta,0,2,428,"rgb(179, 179, 179)"
18630,2020-04-21,Malta,0,5,433,"rgb(179, 179, 179)"
18631,2020-04-22,Malta,0,11,444,"rgb(179, 179, 179)"
18632,2020-04-23,Malta,0,1,445,"rgb(179, 179, 179)"
18633,2020-04-24,Malta,0,1,446,"rgb(179, 179, 179)"
18634,2020-04-25,Malta,0,1,447,"rgb(179, 179, 179)"
18635,2020-04-26,Malta,1,1,448,"rgb(179, 179, 179)"
18636,2020-04-27,Malta,0,0,448,"rgb(179, 179, 179)"
18637,2020-04-28,Malta,0,2,450,"rgb(179, 179, 179)"
18638,2020-04-29,Malta,0,0,450,"rgb(179, 179, 179)"
18639,2020-04-30,Malta,0,13,463,"rgb(179, 179, 179)"
18640,2020-05-01,Malta,0,2,465,"rgb(179, 179, 179)"
18641,2020-05-02,Malta,0,2,467,"rgb(179, 179, 179)"
18642,2020-05-03,Malta,0,0,467,"rgb(179, 179, 179)"
18643,2020-05-04,Malta,0,10,477,"rgb(179, 179, 179)"
18644,2020-05-05,Malta,0,3,480,"rgb(179, 179, 179)"
18645,2020-05-06,Malta,1,2,482,"rgb(179, 179, 179)"
18646,2020-05-07,Malta,0,2,484,"rgb(179, 179, 179)"
18647,2020-05-08,Malta,0,2,486,"rgb(179, 179, 179)"
18648,2020-05-09,Malta,0,3,489,"rgb(179, 179, 179)"
18649,2020-05-10,Malta,0,1,490,"rgb(179, 179, 179)"
18650,2020-05-11,Malta,0,6,496,"rgb(179, 179, 179)"
18651,2020-05-12,Malta,0,7,503,"rgb(179, 179, 179)"
18652,2020-05-13,Malta,0,0,503,"rgb(179, 179, 179)"
18653,2020-05-14,Malta,1,5,508,"rgb(179, 179, 179)"
18654,2020-05-15,Malta,0,14,522,"rgb(179, 179, 179)"
18655,2020-05-16,Malta,0,10,532,"rgb(179, 179, 179)"
18656,2020-05-17,Malta,0,14,546,"rgb(179, 179, 179)"
18657,2020-05-18,Malta,0,7,553,"rgb(179, 179, 179)"
18658,2020-05-19,Malta,0,5,558,"rgb(179, 179, 179)"
18659,2020-05-20,Malta,0,2,560,"rgb(179, 179, 179)"
18660,2020-05-21,Malta,0,24,584,"rgb(179, 179, 179)"
18661,2020-05-22,Malta,0,15,599,"rgb(179, 179, 179)"
18662,2020-05-23,Malta,0,1,600,"rgb(179, 179, 179)"
18663,2020-05-24,Malta,0,9,609,"rgb(179, 179, 179)"
18664,2020-05-25,Malta,0,1,610,"rgb(179, 179, 179)"
18665,2020-05-26,Malta,0,1,611,"rgb(179, 179, 179)"
18666,2020-05-27,Malta,0,0,611,"rgb(179, 179, 179)"
18667,2020-05-28,Malta,1,4,615,"rgb(179, 179, 179)"
18668,2020-05-29,Malta,0,1,616,"rgb(179, 179, 179)"
18669,2020-05-30,Malta,0,0,616,"rgb(179, 179, 179)"
18670,2020-05-31,Malta,0,0,616,"rgb(179, 179, 179)"
18671,2020-06-01,Malta,0,0,616,"rgb(179, 179, 179)"
18672,2020-06-02,Malta,2,3,619,"rgb(179, 179, 179)"
18673,2020-06-03,Malta,0,1,620,"rgb(179, 179, 179)"
18674,2020-06-04,Malta,0,2,622,"rgb(179, 179, 179)"
18675,2020-06-05,Malta,0,0,622,"rgb(179, 179, 179)"
18676,2020-06-06,Malta,0,0,622,"rgb(179, 179, 179)"
18677,2020-06-07,Malta,0,0,622,"rgb(179, 179, 179)"
18678,2020-06-08,Malta,0,7,629,"rgb(179, 179, 179)"
18679,2020-06-09,Malta,0,1,630,"rgb(179, 179, 179)"
18680,2020-06-10,Malta,0,2,632,"rgb(179, 179, 179)"
18681,2020-06-11,Malta,0,3,635,"rgb(179, 179, 179)"
18682,2020-06-12,Malta,0,5,640,"rgb(179, 179, 179)"
18683,2020-06-13,Malta,0,5,645,"rgb(179, 179, 179)"
18684,2020-06-14,Malta,0,1,646,"rgb(179, 179, 179)"
18685,2020-06-15,Malta,0,2,648,"rgb(179, 179, 179)"
18686,2020-06-16,Malta,0,2,650,"rgb(179, 179, 179)"
18687,2020-06-17,Malta,0,6,656,"rgb(179, 179, 179)"
18688,2020-06-18,Malta,0,6,662,"rgb(179, 179, 179)"
18689,2020-06-19,Malta,0,1,663,"rgb(179, 179, 179)"
18690,2020-06-20,Malta,0,0,663,"rgb(179, 179, 179)"
18691,2020-06-21,Malta,0,1,664,"rgb(179, 179, 179)"
18692,2020-06-22,Malta,0,1,665,"rgb(179, 179, 179)"
18693,2020-06-23,Malta,0,0,665,"rgb(179, 179, 179)"
18694,2020-06-24,Malta,0,0,665,"rgb(179, 179, 179)"
18695,2020-06-25,Malta,0,0,665,"rgb(179, 179, 179)"
18696,2020-06-26,Malta,0,3,668,"rgb(179, 179, 179)"
18697,2020-06-27,Malta,0,2,670,"rgb(179, 179, 179)"
18698,2020-06-28,Malta,0,0,670,"rgb(179, 179, 179)"
18699,2020-06-29,Malta,0,0,670,"rgb(179, 179, 179)"
18700,2020-06-30,Malta,0,0,670,"rgb(179, 179, 179)"
18701,2020-07-01,Malta,0,0,670,"rgb(179, 179, 179)"
18702,2020-07-02,Malta,0,0,670,"rgb(179, 179, 179)"
18703,2020-07-03,Malta,0,0,670,"rgb(179, 179, 179)"
18704,2020-07-04,Malta,0,2,672,"rgb(179, 179, 179)"
18705,2020-07-05,Malta,0,0,672,"rgb(179, 179, 179)"
18706,2020-07-06,Malta,0,0,672,"rgb(179, 179, 179)"
18707,2020-07-07,Malta,0,0,672,"rgb(179, 179, 179)"
18708,2020-07-08,Malta,0,1,673,"rgb(179, 179, 179)"
18709,2020-07-09,Malta,0,0,673,"rgb(179, 179, 179)"
18710,2020-07-10,Malta,0,1,674,"rgb(179, 179, 179)"
18711,2020-07-11,Malta,0,0,674,"rgb(179, 179, 179)"
18712,2020-07-12,Malta,0,0,674,"rgb(179, 179, 179)"
18713,2020-07-13,Malta,0,0,674,"rgb(179, 179, 179)"
18714,2020-03-20,Mauritius,0,3,3,"rgb(229, 134, 6)"
18715,2020-03-21,Mauritius,0,9,12,"rgb(229, 134, 6)"
18716,2020-03-22,Mauritius,1,2,14,"rgb(229, 134, 6)"
18717,2020-03-23,Mauritius,1,14,28,"rgb(229, 134, 6)"
18718,2020-03-24,Mauritius,0,8,36,"rgb(229, 134, 6)"
18719,2020-03-25,Mauritius,0,6,42,"rgb(229, 134, 6)"
18720,2020-03-26,Mauritius,0,6,48,"rgb(229, 134, 6)"
18721,2020-03-27,Mauritius,0,33,81,"rgb(229, 134, 6)"
18722,2020-03-28,Mauritius,0,13,94,"rgb(229, 134, 6)"
18723,2020-03-29,Mauritius,0,8,102,"rgb(229, 134, 6)"
18724,2020-03-30,Mauritius,1,8,110,"rgb(229, 134, 6)"
18725,2020-03-31,Mauritius,0,18,128,"rgb(229, 134, 6)"
18726,2020-04-01,Mauritius,0,15,143,"rgb(229, 134, 6)"
18727,2020-04-02,Mauritius,2,11,154,"rgb(229, 134, 6)"
18728,2020-04-03,Mauritius,2,15,169,"rgb(229, 134, 6)"
18729,2020-04-04,Mauritius,0,17,186,"rgb(229, 134, 6)"
18730,2020-04-05,Mauritius,0,10,196,"rgb(229, 134, 6)"
18731,2020-04-06,Mauritius,0,31,227,"rgb(229, 134, 6)"
18732,2020-04-07,Mauritius,0,17,244,"rgb(229, 134, 6)"
18733,2020-04-08,Mauritius,0,24,268,"rgb(229, 134, 6)"
18734,2020-04-09,Mauritius,0,5,273,"rgb(229, 134, 6)"
18735,2020-04-10,Mauritius,0,41,314,"rgb(229, 134, 6)"
18736,2020-04-11,Mauritius,2,4,318,"rgb(229, 134, 6)"
18737,2020-04-12,Mauritius,0,1,319,"rgb(229, 134, 6)"
18738,2020-04-13,Mauritius,0,5,324,"rgb(229, 134, 6)"
18739,2020-04-14,Mauritius,0,0,324,"rgb(229, 134, 6)"
18740,2020-04-15,Mauritius,0,0,324,"rgb(229, 134, 6)"
18741,2020-04-16,Mauritius,0,0,324,"rgb(229, 134, 6)"
18742,2020-04-17,Mauritius,0,0,324,"rgb(229, 134, 6)"
18743,2020-04-18,Mauritius,0,0,324,"rgb(229, 134, 6)"
18744,2020-04-19,Mauritius,0,1,325,"rgb(229, 134, 6)"
18745,2020-04-20,Mauritius,0,3,328,"rgb(229, 134, 6)"
18746,2020-04-21,Mauritius,0,0,328,"rgb(229, 134, 6)"
18747,2020-04-22,Mauritius,0,0,328,"rgb(229, 134, 6)"
18748,2020-04-23,Mauritius,0,1,329,"rgb(229, 134, 6)"
18749,2020-04-24,Mauritius,0,2,331,"rgb(229, 134, 6)"
18750,2020-04-25,Mauritius,0,0,331,"rgb(229, 134, 6)"
18751,2020-04-26,Mauritius,0,0,331,"rgb(229, 134, 6)"
18752,2020-04-27,Mauritius,0,1,332,"rgb(229, 134, 6)"
18753,2020-04-28,Mauritius,1,0,332,"rgb(229, 134, 6)"
18754,2020-04-29,Mauritius,0,0,332,"rgb(229, 134, 6)"
18755,2020-04-30,Mauritius,0,0,332,"rgb(229, 134, 6)"
18756,2020-05-01,Mauritius,0,0,332,"rgb(229, 134, 6)"
18757,2020-05-02,Mauritius,0,0,332,"rgb(229, 134, 6)"
18758,2020-05-03,Mauritius,0,0,332,"rgb(229, 134, 6)"
18759,2020-05-04,Mauritius,0,0,332,"rgb(229, 134, 6)"
18760,2020-05-05,Mauritius,0,0,332,"rgb(229, 134, 6)"
18761,2020-05-06,Mauritius,0,0,332,"rgb(229, 134, 6)"
18762,2020-05-07,Mauritius,0,0,332,"rgb(229, 134, 6)"
18763,2020-05-08,Mauritius,0,0,332,"rgb(229, 134, 6)"
18764,2020-05-09,Mauritius,0,0,332,"rgb(229, 134, 6)"
18765,2020-05-10,Mauritius,0,0,332,"rgb(229, 134, 6)"
18766,2020-05-11,Mauritius,0,0,332,"rgb(229, 134, 6)"
18767,2020-05-12,Mauritius,0,0,332,"rgb(229, 134, 6)"
18768,2020-05-13,Mauritius,0,0,332,"rgb(229, 134, 6)"
18769,2020-05-14,Mauritius,0,0,332,"rgb(229, 134, 6)"
18770,2020-05-15,Mauritius,0,0,332,"rgb(229, 134, 6)"
18771,2020-05-16,Mauritius,0,0,332,"rgb(229, 134, 6)"
18772,2020-05-17,Mauritius,0,0,332,"rgb(229, 134, 6)"
18773,2020-05-18,Mauritius,0,0,332,"rgb(229, 134, 6)"
18774,2020-05-19,Mauritius,0,0,332,"rgb(229, 134, 6)"
18775,2020-05-20,Mauritius,0,0,332,"rgb(229, 134, 6)"
18776,2020-05-21,Mauritius,0,0,332,"rgb(229, 134, 6)"
18777,2020-05-22,Mauritius,0,0,332,"rgb(229, 134, 6)"
18778,2020-05-23,Mauritius,0,0,332,"rgb(229, 134, 6)"
18779,2020-05-24,Mauritius,0,0,332,"rgb(229, 134, 6)"
18780,2020-05-25,Mauritius,0,2,334,"rgb(229, 134, 6)"
18781,2020-05-26,Mauritius,0,0,334,"rgb(229, 134, 6)"
18782,2020-05-27,Mauritius,0,0,334,"rgb(229, 134, 6)"
18783,2020-05-28,Mauritius,0,0,334,"rgb(229, 134, 6)"
18784,2020-05-29,Mauritius,0,0,334,"rgb(229, 134, 6)"
18785,2020-05-30,Mauritius,0,1,335,"rgb(229, 134, 6)"
18786,2020-05-31,Mauritius,0,0,335,"rgb(229, 134, 6)"
18787,2020-06-01,Mauritius,0,0,335,"rgb(229, 134, 6)"
18788,2020-06-02,Mauritius,0,0,335,"rgb(229, 134, 6)"
18789,2020-06-03,Mauritius,0,0,335,"rgb(229, 134, 6)"
18790,2020-06-04,Mauritius,0,0,335,"rgb(229, 134, 6)"
18791,2020-06-05,Mauritius,0,0,335,"rgb(229, 134, 6)"
18792,2020-06-06,Mauritius,0,2,337,"rgb(229, 134, 6)"
18793,2020-06-07,Mauritius,0,0,337,"rgb(229, 134, 6)"
18794,2020-06-08,Mauritius,0,0,337,"rgb(229, 134, 6)"
18795,2020-06-09,Mauritius,0,0,337,"rgb(229, 134, 6)"
18796,2020-06-10,Mauritius,0,0,337,"rgb(229, 134, 6)"
18797,2020-06-11,Mauritius,0,0,337,"rgb(229, 134, 6)"
18798,2020-06-12,Mauritius,0,0,337,"rgb(229, 134, 6)"
18799,2020-06-13,Mauritius,0,0,337,"rgb(229, 134, 6)"
18800,2020-06-14,Mauritius,0,0,337,"rgb(229, 134, 6)"
18801,2020-06-15,Mauritius,0,0,337,"rgb(229, 134, 6)"
18802,2020-06-16,Mauritius,0,0,337,"rgb(229, 134, 6)"
18803,2020-06-17,Mauritius,0,0,337,"rgb(229, 134, 6)"
18804,2020-06-18,Mauritius,0,0,337,"rgb(229, 134, 6)"
18805,2020-06-19,Mauritius,0,0,337,"rgb(229, 134, 6)"
18806,2020-06-20,Mauritius,0,0,337,"rgb(229, 134, 6)"
18807,2020-06-21,Mauritius,0,0,337,"rgb(229, 134, 6)"
18808,2020-06-22,Mauritius,0,0,337,"rgb(229, 134, 6)"
18809,2020-06-23,Mauritius,0,3,340,"rgb(229, 134, 6)"
18810,2020-06-24,Mauritius,0,0,340,"rgb(229, 134, 6)"
18811,2020-06-25,Mauritius,0,1,341,"rgb(229, 134, 6)"
18812,2020-06-26,Mauritius,0,0,341,"rgb(229, 134, 6)"
18813,2020-06-27,Mauritius,0,0,341,"rgb(229, 134, 6)"
18814,2020-06-28,Mauritius,0,0,341,"rgb(229, 134, 6)"
18815,2020-06-29,Mauritius,0,0,341,"rgb(229, 134, 6)"
18816,2020-06-30,Mauritius,0,0,341,"rgb(229, 134, 6)"
18817,2020-07-01,Mauritius,0,0,341,"rgb(229, 134, 6)"
18818,2020-07-02,Mauritius,0,0,341,"rgb(229, 134, 6)"
18819,2020-07-03,Mauritius,0,0,341,"rgb(229, 134, 6)"
18820,2020-07-04,Mauritius,0,0,341,"rgb(229, 134, 6)"
18821,2020-07-05,Mauritius,0,0,341,"rgb(229, 134, 6)"
18822,2020-07-06,Mauritius,0,0,341,"rgb(229, 134, 6)"
18823,2020-07-07,Mauritius,0,1,342,"rgb(229, 134, 6)"
18824,2020-07-08,Mauritius,0,0,342,"rgb(229, 134, 6)"
18825,2020-07-09,Mauritius,0,0,342,"rgb(229, 134, 6)"
18826,2020-07-10,Mauritius,0,0,342,"rgb(229, 134, 6)"
18827,2020-07-11,Mauritius,0,0,342,"rgb(229, 134, 6)"
18828,2020-07-12,Mauritius,0,0,342,"rgb(229, 134, 6)"
18829,2020-07-13,Mauritius,0,0,342,"rgb(229, 134, 6)"
18830,2020-03-08,Maldives,0,2,2,"rgb(93, 105, 177)"
18831,2020-03-09,Maldives,0,2,4,"rgb(93, 105, 177)"
18832,2020-03-11,Maldives,0,2,6,"rgb(93, 105, 177)"
18833,2020-03-12,Maldives,0,2,8,"rgb(93, 105, 177)"
18834,2020-03-14,Maldives,0,1,9,"rgb(93, 105, 177)"
18835,2020-03-15,Maldives,0,0,9,"rgb(93, 105, 177)"
18836,2020-03-16,Maldives,0,4,13,"rgb(93, 105, 177)"
18837,2020-03-17,Maldives,0,0,13,"rgb(93, 105, 177)"
18838,2020-03-18,Maldives,0,0,13,"rgb(93, 105, 177)"
18839,2020-03-19,Maldives,0,0,13,"rgb(93, 105, 177)"
18840,2020-03-20,Maldives,0,0,13,"rgb(93, 105, 177)"
18841,2020-03-21,Maldives,0,0,13,"rgb(93, 105, 177)"
18842,2020-03-22,Maldives,0,0,13,"rgb(93, 105, 177)"
18843,2020-03-23,Maldives,0,0,13,"rgb(93, 105, 177)"
18844,2020-03-24,Maldives,0,0,13,"rgb(93, 105, 177)"
18845,2020-03-25,Maldives,0,0,13,"rgb(93, 105, 177)"
18846,2020-03-26,Maldives,0,0,13,"rgb(93, 105, 177)"
18847,2020-03-27,Maldives,0,0,13,"rgb(93, 105, 177)"
18848,2020-03-28,Maldives,0,1,14,"rgb(93, 105, 177)"
18849,2020-03-29,Maldives,0,2,16,"rgb(93, 105, 177)"
18850,2020-03-30,Maldives,0,1,17,"rgb(93, 105, 177)"
18851,2020-03-31,Maldives,0,0,17,"rgb(93, 105, 177)"
18852,2020-04-01,Maldives,0,1,18,"rgb(93, 105, 177)"
18853,2020-04-02,Maldives,0,1,19,"rgb(93, 105, 177)"
18854,2020-04-03,Maldives,0,0,19,"rgb(93, 105, 177)"
18855,2020-04-04,Maldives,0,0,19,"rgb(93, 105, 177)"
18856,2020-04-05,Maldives,0,0,19,"rgb(93, 105, 177)"
18857,2020-04-06,Maldives,0,0,19,"rgb(93, 105, 177)"
18858,2020-04-07,Maldives,0,0,19,"rgb(93, 105, 177)"
18859,2020-04-08,Maldives,0,0,19,"rgb(93, 105, 177)"
18860,2020-04-09,Maldives,0,0,19,"rgb(93, 105, 177)"
18861,2020-04-10,Maldives,0,0,19,"rgb(93, 105, 177)"
18862,2020-04-11,Maldives,0,0,19,"rgb(93, 105, 177)"
18863,2020-04-12,Maldives,0,0,19,"rgb(93, 105, 177)"
18864,2020-04-13,Maldives,0,1,20,"rgb(93, 105, 177)"
18865,2020-04-14,Maldives,0,0,20,"rgb(93, 105, 177)"
18866,2020-04-15,Maldives,0,1,21,"rgb(93, 105, 177)"
18867,2020-04-16,Maldives,0,0,21,"rgb(93, 105, 177)"
18868,2020-04-17,Maldives,0,4,25,"rgb(93, 105, 177)"
18869,2020-04-18,Maldives,0,4,29,"rgb(93, 105, 177)"
18870,2020-04-19,Maldives,0,6,35,"rgb(93, 105, 177)"
18871,2020-04-20,Maldives,0,17,52,"rgb(93, 105, 177)"
18872,2020-04-21,Maldives,0,17,69,"rgb(93, 105, 177)"
18873,2020-04-22,Maldives,0,16,85,"rgb(93, 105, 177)"
18874,2020-04-23,Maldives,0,0,85,"rgb(93, 105, 177)"
18875,2020-04-24,Maldives,0,25,110,"rgb(93, 105, 177)"
18876,2020-04-25,Maldives,0,18,128,"rgb(93, 105, 177)"
18877,2020-04-26,Maldives,0,9,137,"rgb(93, 105, 177)"
18878,2020-04-27,Maldives,0,77,214,"rgb(93, 105, 177)"
18879,2020-04-28,Maldives,0,0,214,"rgb(93, 105, 177)"
18880,2020-04-29,Maldives,0,31,245,"rgb(93, 105, 177)"
18881,2020-04-30,Maldives,0,32,277,"rgb(93, 105, 177)"
18882,2020-05-01,Maldives,1,191,468,"rgb(93, 105, 177)"
18883,2020-05-02,Maldives,0,23,491,"rgb(93, 105, 177)"
18884,2020-05-03,Maldives,0,28,519,"rgb(93, 105, 177)"
18885,2020-05-04,Maldives,0,8,527,"rgb(93, 105, 177)"
18886,2020-05-05,Maldives,0,24,551,"rgb(93, 105, 177)"
18887,2020-05-06,Maldives,0,22,573,"rgb(93, 105, 177)"
18888,2020-05-07,Maldives,1,44,617,"rgb(93, 105, 177)"
18889,2020-05-08,Maldives,1,25,642,"rgb(93, 105, 177)"
18890,2020-05-09,Maldives,0,2,644,"rgb(93, 105, 177)"
18891,2020-05-10,Maldives,0,146,790,"rgb(93, 105, 177)"
18892,2020-05-11,Maldives,0,45,835,"rgb(93, 105, 177)"
18893,2020-05-12,Maldives,0,62,897,"rgb(93, 105, 177)"
18894,2020-05-13,Maldives,0,7,904,"rgb(93, 105, 177)"
18895,2020-05-14,Maldives,1,51,955,"rgb(93, 105, 177)"
18896,2020-05-15,Maldives,0,27,982,"rgb(93, 105, 177)"
18897,2020-05-16,Maldives,0,49,1031,"rgb(93, 105, 177)"
18898,2020-05-17,Maldives,0,47,1078,"rgb(93, 105, 177)"
18899,2020-05-18,Maldives,0,16,1094,"rgb(93, 105, 177)"
18900,2020-05-19,Maldives,0,12,1106,"rgb(93, 105, 177)"
18901,2020-05-20,Maldives,0,37,1143,"rgb(93, 105, 177)"
18902,2020-05-21,Maldives,0,43,1186,"rgb(93, 105, 177)"
18903,2020-05-22,Maldives,0,30,1216,"rgb(93, 105, 177)"
18904,2020-05-23,Maldives,0,58,1274,"rgb(93, 105, 177)"
18905,2020-05-24,Maldives,0,29,1303,"rgb(93, 105, 177)"
18906,2020-05-25,Maldives,0,68,1371,"rgb(93, 105, 177)"
18907,2020-05-26,Maldives,0,24,1395,"rgb(93, 105, 177)"
18908,2020-05-27,Maldives,1,43,1438,"rgb(93, 105, 177)"
18909,2020-05-28,Maldives,0,19,1457,"rgb(93, 105, 177)"
18910,2020-05-29,Maldives,0,56,1513,"rgb(93, 105, 177)"
18911,2020-05-30,Maldives,0,78,1591,"rgb(93, 105, 177)"
18912,2020-05-31,Maldives,0,81,1672,"rgb(93, 105, 177)"
18913,2020-06-01,Maldives,0,101,1773,"rgb(93, 105, 177)"
18914,2020-06-02,Maldives,1,56,1829,"rgb(93, 105, 177)"
18915,2020-06-03,Maldives,1,12,1841,"rgb(93, 105, 177)"
18916,2020-06-04,Maldives,0,9,1850,"rgb(93, 105, 177)"
18917,2020-06-05,Maldives,0,22,1872,"rgb(93, 105, 177)"
18918,2020-06-06,Maldives,0,11,1883,"rgb(93, 105, 177)"
18919,2020-06-07,Maldives,0,18,1901,"rgb(93, 105, 177)"
18920,2020-06-08,Maldives,1,2,1903,"rgb(93, 105, 177)"
18921,2020-06-09,Maldives,0,13,1916,"rgb(93, 105, 177)"
18922,2020-06-10,Maldives,0,26,1942,"rgb(93, 105, 177)"
18923,2020-06-11,Maldives,0,20,1962,"rgb(93, 105, 177)"
18924,2020-06-12,Maldives,0,14,1976,"rgb(93, 105, 177)"
18925,2020-06-13,Maldives,0,27,2003,"rgb(93, 105, 177)"
18926,2020-06-14,Maldives,0,10,2013,"rgb(93, 105, 177)"
18927,2020-06-15,Maldives,0,22,2035,"rgb(93, 105, 177)"
18928,2020-06-16,Maldives,0,30,2065,"rgb(93, 105, 177)"
18929,2020-06-17,Maldives,0,29,2094,"rgb(93, 105, 177)"
18930,2020-06-18,Maldives,0,26,2120,"rgb(93, 105, 177)"
18931,2020-06-19,Maldives,0,17,2137,"rgb(93, 105, 177)"
18932,2020-06-20,Maldives,0,13,2150,"rgb(93, 105, 177)"
18933,2020-06-21,Maldives,0,37,2187,"rgb(93, 105, 177)"
18934,2020-06-22,Maldives,0,16,2203,"rgb(93, 105, 177)"
18935,2020-06-23,Maldives,0,14,2217,"rgb(93, 105, 177)"
18936,2020-06-24,Maldives,0,21,2238,"rgb(93, 105, 177)"
18937,2020-06-25,Maldives,0,23,2261,"rgb(93, 105, 177)"
18938,2020-06-26,Maldives,0,16,2277,"rgb(93, 105, 177)"
18939,2020-06-27,Maldives,0,6,2283,"rgb(93, 105, 177)"
18940,2020-06-28,Maldives,0,22,2305,"rgb(93, 105, 177)"
18941,2020-06-29,Maldives,0,18,2323,"rgb(93, 105, 177)"
18942,2020-06-30,Maldives,0,13,2336,"rgb(93, 105, 177)"
18943,2020-07-01,Maldives,1,25,2361,"rgb(93, 105, 177)"
18944,2020-07-02,Maldives,0,21,2382,"rgb(93, 105, 177)"
18945,2020-07-03,Maldives,1,18,2400,"rgb(93, 105, 177)"
18946,2020-07-04,Maldives,0,10,2410,"rgb(93, 105, 177)"
18947,2020-07-05,Maldives,0,25,2435,"rgb(93, 105, 177)"
18948,2020-07-06,Maldives,1,33,2468,"rgb(93, 105, 177)"
18949,2020-07-07,Maldives,1,23,2491,"rgb(93, 105, 177)"
18950,2020-07-08,Maldives,0,10,2501,"rgb(93, 105, 177)"
18951,2020-07-09,Maldives,1,16,2517,"rgb(93, 105, 177)"
18952,2020-07-10,Maldives,0,36,2553,"rgb(93, 105, 177)"
18953,2020-07-11,Maldives,0,64,2617,"rgb(93, 105, 177)"
18954,2020-07-12,Maldives,0,47,2664,"rgb(93, 105, 177)"
18955,2020-07-13,Maldives,0,67,2731,"rgb(93, 105, 177)"
18956,2020-04-03,Malawi,0,3,3,"rgb(82, 188, 163)"
18957,2020-04-04,Malawi,0,0,3,"rgb(82, 188, 163)"
18958,2020-04-05,Malawi,0,1,4,"rgb(82, 188, 163)"
18959,2020-04-06,Malawi,0,0,4,"rgb(82, 188, 163)"
18960,2020-04-07,Malawi,0,1,5,"rgb(82, 188, 163)"
18961,2020-04-08,Malawi,1,3,8,"rgb(82, 188, 163)"
18962,2020-04-09,Malawi,0,0,8,"rgb(82, 188, 163)"
18963,2020-04-10,Malawi,0,0,8,"rgb(82, 188, 163)"
18964,2020-04-11,Malawi,0,1,9,"rgb(82, 188, 163)"
18965,2020-04-12,Malawi,1,3,12,"rgb(82, 188, 163)"
18966,2020-04-13,Malawi,0,1,13,"rgb(82, 188, 163)"
18967,2020-04-14,Malawi,0,3,16,"rgb(82, 188, 163)"
18968,2020-04-15,Malawi,0,0,16,"rgb(82, 188, 163)"
18969,2020-04-16,Malawi,0,0,16,"rgb(82, 188, 163)"
18970,2020-04-17,Malawi,0,0,16,"rgb(82, 188, 163)"
18971,2020-04-18,Malawi,0,1,17,"rgb(82, 188, 163)"
18972,2020-04-19,Malawi,0,0,17,"rgb(82, 188, 163)"
18973,2020-04-20,Malawi,0,0,17,"rgb(82, 188, 163)"
18974,2020-04-21,Malawi,0,0,17,"rgb(82, 188, 163)"
18975,2020-04-22,Malawi,0,1,18,"rgb(82, 188, 163)"
18976,2020-04-23,Malawi,1,5,23,"rgb(82, 188, 163)"
18977,2020-04-24,Malawi,0,10,33,"rgb(82, 188, 163)"
18978,2020-04-25,Malawi,0,0,33,"rgb(82, 188, 163)"
18979,2020-04-26,Malawi,0,0,33,"rgb(82, 188, 163)"
18980,2020-04-27,Malawi,0,1,34,"rgb(82, 188, 163)"
18981,2020-04-28,Malawi,0,2,36,"rgb(82, 188, 163)"
18982,2020-04-29,Malawi,0,0,36,"rgb(82, 188, 163)"
18983,2020-04-30,Malawi,0,0,36,"rgb(82, 188, 163)"
18984,2020-05-01,Malawi,0,1,37,"rgb(82, 188, 163)"
18985,2020-05-02,Malawi,0,0,37,"rgb(82, 188, 163)"
18986,2020-05-03,Malawi,0,1,38,"rgb(82, 188, 163)"
18987,2020-05-04,Malawi,0,1,39,"rgb(82, 188, 163)"
18988,2020-05-05,Malawi,0,2,41,"rgb(82, 188, 163)"
18989,2020-05-06,Malawi,0,0,41,"rgb(82, 188, 163)"
18990,2020-05-07,Malawi,0,2,43,"rgb(82, 188, 163)"
18991,2020-05-08,Malawi,0,0,43,"rgb(82, 188, 163)"
18992,2020-05-09,Malawi,0,0,43,"rgb(82, 188, 163)"
18993,2020-05-10,Malawi,0,13,56,"rgb(82, 188, 163)"
18994,2020-05-11,Malawi,0,0,56,"rgb(82, 188, 163)"
18995,2020-05-12,Malawi,0,1,57,"rgb(82, 188, 163)"
18996,2020-05-13,Malawi,0,1,58,"rgb(82, 188, 163)"
18997,2020-05-14,Malawi,0,5,63,"rgb(82, 188, 163)"
18998,2020-05-15,Malawi,0,0,63,"rgb(82, 188, 163)"
18999,2020-05-16,Malawi,0,0,63,"rgb(82, 188, 163)"
19000,2020-05-17,Malawi,0,2,65,"rgb(82, 188, 163)"
19001,2020-05-18,Malawi,0,5,70,"rgb(82, 188, 163)"
19002,2020-05-19,Malawi,0,0,70,"rgb(82, 188, 163)"
19003,2020-05-20,Malawi,0,1,71,"rgb(82, 188, 163)"
19004,2020-05-21,Malawi,0,1,72,"rgb(82, 188, 163)"
19005,2020-05-22,Malawi,0,0,72,"rgb(82, 188, 163)"
19006,2020-05-23,Malawi,0,10,82,"rgb(82, 188, 163)"
19007,2020-05-24,Malawi,1,1,83,"rgb(82, 188, 163)"
19008,2020-05-25,Malawi,0,0,83,"rgb(82, 188, 163)"
19009,2020-05-26,Malawi,0,18,101,"rgb(82, 188, 163)"
19010,2020-05-27,Malawi,0,0,101,"rgb(82, 188, 163)"
19011,2020-05-28,Malawi,0,0,101,"rgb(82, 188, 163)"
19012,2020-05-29,Malawi,0,102,203,"rgb(82, 188, 163)"
19013,2020-05-30,Malawi,0,70,273,"rgb(82, 188, 163)"
19014,2020-05-31,Malawi,0,6,279,"rgb(82, 188, 163)"
19015,2020-06-01,Malawi,0,5,284,"rgb(82, 188, 163)"
19016,2020-06-02,Malawi,0,52,336,"rgb(82, 188, 163)"
19017,2020-06-03,Malawi,0,22,358,"rgb(82, 188, 163)"
19018,2020-06-04,Malawi,0,11,369,"rgb(82, 188, 163)"
19019,2020-06-05,Malawi,0,24,393,"rgb(82, 188, 163)"
19020,2020-06-06,Malawi,0,16,409,"rgb(82, 188, 163)"
19021,2020-06-07,Malawi,0,0,409,"rgb(82, 188, 163)"
19022,2020-06-08,Malawi,0,29,438,"rgb(82, 188, 163)"
19023,2020-06-09,Malawi,0,5,443,"rgb(82, 188, 163)"
19024,2020-06-10,Malawi,0,12,455,"rgb(82, 188, 163)"
19025,2020-06-11,Malawi,0,0,455,"rgb(82, 188, 163)"
19026,2020-06-12,Malawi,0,26,481,"rgb(82, 188, 163)"
19027,2020-06-13,Malawi,0,0,481,"rgb(82, 188, 163)"
19028,2020-06-14,Malawi,1,48,529,"rgb(82, 188, 163)"
19029,2020-06-15,Malawi,1,18,547,"rgb(82, 188, 163)"
19030,2020-06-16,Malawi,0,9,556,"rgb(82, 188, 163)"
19031,2020-06-17,Malawi,0,8,564,"rgb(82, 188, 163)"
19032,2020-06-18,Malawi,0,8,572,"rgb(82, 188, 163)"
19033,2020-06-19,Malawi,2,20,592,"rgb(82, 188, 163)"
19034,2020-06-20,Malawi,0,28,620,"rgb(82, 188, 163)"
19035,2020-06-21,Malawi,0,0,620,"rgb(82, 188, 163)"
19036,2020-06-22,Malawi,3,110,730,"rgb(82, 188, 163)"
19037,2020-06-23,Malawi,0,73,803,"rgb(82, 188, 163)"
19038,2020-06-24,Malawi,0,45,848,"rgb(82, 188, 163)"
19039,2020-06-25,Malawi,0,93,941,"rgb(82, 188, 163)"
19040,2020-06-26,Malawi,1,19,960,"rgb(82, 188, 163)"
19041,2020-06-27,Malawi,1,45,1005,"rgb(82, 188, 163)"
19042,2020-06-28,Malawi,0,33,1038,"rgb(82, 188, 163)"
19043,2020-06-29,Malawi,0,108,1146,"rgb(82, 188, 163)"
19044,2020-06-30,Malawi,1,78,1224,"rgb(82, 188, 163)"
19045,2020-07-01,Malawi,2,41,1265,"rgb(82, 188, 163)"
19046,2020-07-02,Malawi,0,77,1342,"rgb(82, 188, 163)"
19047,2020-07-03,Malawi,0,60,1402,"rgb(82, 188, 163)"
19048,2020-07-04,Malawi,0,96,1498,"rgb(82, 188, 163)"
19049,2020-07-05,Malawi,1,115,1613,"rgb(82, 188, 163)"
19050,2020-07-06,Malawi,2,129,1742,"rgb(82, 188, 163)"
19051,2020-07-07,Malawi,0,76,1818,"rgb(82, 188, 163)"
19052,2020-07-08,Malawi,5,59,1877,"rgb(82, 188, 163)"
19053,2020-07-09,Malawi,1,52,1929,"rgb(82, 188, 163)"
19054,2020-07-10,Malawi,4,55,1984,"rgb(82, 188, 163)"
19055,2020-07-11,Malawi,2,85,2069,"rgb(82, 188, 163)"
19056,2020-07-12,Malawi,2,192,2261,"rgb(82, 188, 163)"
19057,2020-07-13,Malawi,5,103,2364,"rgb(82, 188, 163)"
19058,2019-12-31,Mexico,0,0,0,"rgb(153, 201, 69)"
19059,2020-01-01,Mexico,0,0,0,"rgb(153, 201, 69)"
19060,2020-01-02,Mexico,0,0,0,"rgb(153, 201, 69)"
19061,2020-01-03,Mexico,0,0,0,"rgb(153, 201, 69)"
19062,2020-01-04,Mexico,0,0,0,"rgb(153, 201, 69)"
19063,2020-01-05,Mexico,0,0,0,"rgb(153, 201, 69)"
19064,2020-01-06,Mexico,0,0,0,"rgb(153, 201, 69)"
19065,2020-01-07,Mexico,0,0,0,"rgb(153, 201, 69)"
19066,2020-01-08,Mexico,0,0,0,"rgb(153, 201, 69)"
19067,2020-01-09,Mexico,0,0,0,"rgb(153, 201, 69)"
19068,2020-01-10,Mexico,0,0,0,"rgb(153, 201, 69)"
19069,2020-01-11,Mexico,0,0,0,"rgb(153, 201, 69)"
19070,2020-01-12,Mexico,0,0,0,"rgb(153, 201, 69)"
19071,2020-01-13,Mexico,0,0,0,"rgb(153, 201, 69)"
19072,2020-01-14,Mexico,0,0,0,"rgb(153, 201, 69)"
19073,2020-01-15,Mexico,0,0,0,"rgb(153, 201, 69)"
19074,2020-01-16,Mexico,0,0,0,"rgb(153, 201, 69)"
19075,2020-01-17,Mexico,0,0,0,"rgb(153, 201, 69)"
19076,2020-01-18,Mexico,0,0,0,"rgb(153, 201, 69)"
19077,2020-01-19,Mexico,0,0,0,"rgb(153, 201, 69)"
19078,2020-01-20,Mexico,0,0,0,"rgb(153, 201, 69)"
19079,2020-01-21,Mexico,0,0,0,"rgb(153, 201, 69)"
19080,2020-01-22,Mexico,0,0,0,"rgb(153, 201, 69)"
19081,2020-01-23,Mexico,0,0,0,"rgb(153, 201, 69)"
19082,2020-01-24,Mexico,0,0,0,"rgb(153, 201, 69)"
19083,2020-01-25,Mexico,0,0,0,"rgb(153, 201, 69)"
19084,2020-01-26,Mexico,0,0,0,"rgb(153, 201, 69)"
19085,2020-01-27,Mexico,0,0,0,"rgb(153, 201, 69)"
19086,2020-01-28,Mexico,0,0,0,"rgb(153, 201, 69)"
19087,2020-01-29,Mexico,0,0,0,"rgb(153, 201, 69)"
19088,2020-01-30,Mexico,0,0,0,"rgb(153, 201, 69)"
19089,2020-01-31,Mexico,0,0,0,"rgb(153, 201, 69)"
19090,2020-02-01,Mexico,0,0,0,"rgb(153, 201, 69)"
19091,2020-02-02,Mexico,0,0,0,"rgb(153, 201, 69)"
19092,2020-02-03,Mexico,0,0,0,"rgb(153, 201, 69)"
19093,2020-02-04,Mexico,0,0,0,"rgb(153, 201, 69)"
19094,2020-02-05,Mexico,0,0,0,"rgb(153, 201, 69)"
19095,2020-02-06,Mexico,0,0,0,"rgb(153, 201, 69)"
19096,2020-02-07,Mexico,0,0,0,"rgb(153, 201, 69)"
19097,2020-02-08,Mexico,0,0,0,"rgb(153, 201, 69)"
19098,2020-02-09,Mexico,0,0,0,"rgb(153, 201, 69)"
19099,2020-02-10,Mexico,0,0,0,"rgb(153, 201, 69)"
19100,2020-02-11,Mexico,0,0,0,"rgb(153, 201, 69)"
19101,2020-02-12,Mexico,0,0,0,"rgb(153, 201, 69)"
19102,2020-02-13,Mexico,0,0,0,"rgb(153, 201, 69)"
19103,2020-02-14,Mexico,0,0,0,"rgb(153, 201, 69)"
19104,2020-02-15,Mexico,0,0,0,"rgb(153, 201, 69)"
19105,2020-02-16,Mexico,0,0,0,"rgb(153, 201, 69)"
19106,2020-02-17,Mexico,0,0,0,"rgb(153, 201, 69)"
19107,2020-02-18,Mexico,0,0,0,"rgb(153, 201, 69)"
19108,2020-02-19,Mexico,0,0,0,"rgb(153, 201, 69)"
19109,2020-02-20,Mexico,0,0,0,"rgb(153, 201, 69)"
19110,2020-02-21,Mexico,0,0,0,"rgb(153, 201, 69)"
19111,2020-02-22,Mexico,0,0,0,"rgb(153, 201, 69)"
19112,2020-02-23,Mexico,0,0,0,"rgb(153, 201, 69)"
19113,2020-02-24,Mexico,0,0,0,"rgb(153, 201, 69)"
19114,2020-02-25,Mexico,0,0,0,"rgb(153, 201, 69)"
19115,2020-02-26,Mexico,0,0,0,"rgb(153, 201, 69)"
19116,2020-02-27,Mexico,0,0,0,"rgb(153, 201, 69)"
19117,2020-02-28,Mexico,0,0,0,"rgb(153, 201, 69)"
19118,2020-02-29,Mexico,0,2,2,"rgb(153, 201, 69)"
19119,2020-03-01,Mexico,0,2,4,"rgb(153, 201, 69)"
19120,2020-03-02,Mexico,0,1,5,"rgb(153, 201, 69)"
19121,2020-03-09,Mexico,0,2,7,"rgb(153, 201, 69)"
19122,2020-03-12,Mexico,0,4,11,"rgb(153, 201, 69)"
19123,2020-03-13,Mexico,0,5,16,"rgb(153, 201, 69)"
19124,2020-03-14,Mexico,0,10,26,"rgb(153, 201, 69)"
19125,2020-03-15,Mexico,0,15,41,"rgb(153, 201, 69)"
19126,2020-03-16,Mexico,0,12,53,"rgb(153, 201, 69)"
19127,2020-03-17,Mexico,0,29,82,"rgb(153, 201, 69)"
19128,2020-03-18,Mexico,0,11,93,"rgb(153, 201, 69)"
19129,2020-03-19,Mexico,0,25,118,"rgb(153, 201, 69)"
19130,2020-03-20,Mexico,0,46,164,"rgb(153, 201, 69)"
19131,2020-03-21,Mexico,2,39,203,"rgb(153, 201, 69)"
19132,2020-03-22,Mexico,0,48,251,"rgb(153, 201, 69)"
19133,2020-03-23,Mexico,0,65,316,"rgb(153, 201, 69)"
19134,2020-03-24,Mexico,2,51,367,"rgb(153, 201, 69)"
19135,2020-03-25,Mexico,1,38,405,"rgb(153, 201, 69)"
19136,2020-03-26,Mexico,0,70,475,"rgb(153, 201, 69)"
19137,2020-03-27,Mexico,3,110,585,"rgb(153, 201, 69)"
19138,2020-03-28,Mexico,4,132,717,"rgb(153, 201, 69)"
19139,2020-03-29,Mexico,4,131,848,"rgb(153, 201, 69)"
19140,2020-03-30,Mexico,4,145,993,"rgb(153, 201, 69)"
19141,2020-03-31,Mexico,8,101,1094,"rgb(153, 201, 69)"
19142,2020-04-01,Mexico,1,121,1215,"rgb(153, 201, 69)"
19143,2020-04-02,Mexico,8,163,1378,"rgb(153, 201, 69)"
19144,2020-04-03,Mexico,13,132,1510,"rgb(153, 201, 69)"
19145,2020-04-04,Mexico,10,178,1688,"rgb(153, 201, 69)"
19146,2020-04-05,Mexico,19,202,1890,"rgb(153, 201, 69)"
19147,2020-04-06,Mexico,15,253,2143,"rgb(153, 201, 69)"
19148,2020-04-07,Mexico,31,296,2439,"rgb(153, 201, 69)"
19149,2020-04-08,Mexico,16,346,2785,"rgb(153, 201, 69)"
19150,2020-04-09,Mexico,33,396,3181,"rgb(153, 201, 69)"
19151,2020-04-10,Mexico,20,260,3441,"rgb(153, 201, 69)"
19152,2020-04-11,Mexico,39,403,3844,"rgb(153, 201, 69)"
19153,2020-04-12,Mexico,40,375,4219,"rgb(153, 201, 69)"
19154,2020-04-13,Mexico,23,442,4661,"rgb(153, 201, 69)"
19155,2020-04-14,Mexico,36,353,5014,"rgb(153, 201, 69)"
19156,2020-04-15,Mexico,74,385,5399,"rgb(153, 201, 69)"
19157,2020-04-16,Mexico,43,448,5847,"rgb(153, 201, 69)"
19158,2020-04-17,Mexico,37,450,6297,"rgb(153, 201, 69)"
19159,2020-04-18,Mexico,60,578,6875,"rgb(153, 201, 69)"
19160,2020-04-19,Mexico,104,622,7497,"rgb(153, 201, 69)"
19161,2020-04-20,Mexico,36,764,8261,"rgb(153, 201, 69)"
19162,2020-04-21,Mexico,26,511,8772,"rgb(153, 201, 69)"
19163,2020-04-22,Mexico,145,729,9501,"rgb(153, 201, 69)"
19164,2020-04-23,Mexico,113,1043,10544,"rgb(153, 201, 69)"
19165,2020-04-24,Mexico,99,1089,11633,"rgb(153, 201, 69)"
19166,2020-04-25,Mexico,152,1239,12872,"rgb(153, 201, 69)"
19167,2020-04-26,Mexico,84,970,13842,"rgb(153, 201, 69)"
19168,2020-04-27,Mexico,46,835,14677,"rgb(153, 201, 69)"
19169,2020-04-28,Mexico,83,852,15529,"rgb(153, 201, 69)"
19170,2020-04-29,Mexico,135,1223,16752,"rgb(153, 201, 69)"
19171,2020-04-30,Mexico,163,1047,17799,"rgb(153, 201, 69)"
19172,2020-05-01,Mexico,127,1425,19224,"rgb(153, 201, 69)"
19173,2020-05-02,Mexico,113,1515,20739,"rgb(153, 201, 69)"
19174,2020-05-03,Mexico,89,1349,22088,"rgb(153, 201, 69)"
19175,2020-05-04,Mexico,93,1383,23471,"rgb(153, 201, 69)"
19176,2020-05-05,Mexico,117,1434,24905,"rgb(153, 201, 69)"
19177,2020-05-06,Mexico,236,1120,26025,"rgb(153, 201, 69)"
19178,2020-05-07,Mexico,197,1609,27634,"rgb(153, 201, 69)"
19179,2020-05-08,Mexico,257,1982,29616,"rgb(153, 201, 69)"
19180,2020-05-09,Mexico,199,1906,31522,"rgb(153, 201, 69)"
19181,2020-05-10,Mexico,193,1938,33460,"rgb(153, 201, 69)"
19182,2020-05-11,Mexico,112,1562,35022,"rgb(153, 201, 69)"
19183,2020-05-12,Mexico,108,1305,36327,"rgb(153, 201, 69)"
19184,2020-05-13,Mexico,353,1997,38324,"rgb(153, 201, 69)"
19185,2020-05-14,Mexico,294,1862,40186,"rgb(153, 201, 69)"
19186,2020-05-15,Mexico,257,2409,42595,"rgb(153, 201, 69)"
19187,2020-05-16,Mexico,290,2437,45032,"rgb(153, 201, 69)"
19188,2020-05-17,Mexico,278,2112,47144,"rgb(153, 201, 69)"
19189,2020-05-18,Mexico,132,2075,49219,"rgb(153, 201, 69)"
19190,2020-05-19,Mexico,155,2414,51633,"rgb(153, 201, 69)"
19191,2020-05-20,Mexico,334,2713,54346,"rgb(153, 201, 69)"
19192,2020-05-21,Mexico,424,2248,56594,"rgb(153, 201, 69)"
19193,2020-05-22,Mexico,420,2973,59567,"rgb(153, 201, 69)"
19194,2020-05-23,Mexico,479,2960,62527,"rgb(153, 201, 69)"
19195,2020-05-24,Mexico,190,3329,65856,"rgb(153, 201, 69)"
19196,2020-05-25,Mexico,215,2764,68620,"rgb(153, 201, 69)"
19197,2020-05-26,Mexico,239,2485,71105,"rgb(153, 201, 69)"
19198,2020-05-27,Mexico,501,3455,74560,"rgb(153, 201, 69)"
19199,2020-05-28,Mexico,463,3463,78023,"rgb(153, 201, 69)"
19200,2020-05-29,Mexico,447,3377,81400,"rgb(153, 201, 69)"
19201,2020-05-30,Mexico,371,3227,84627,"rgb(153, 201, 69)"
19202,2020-05-31,Mexico,364,2885,87512,"rgb(153, 201, 69)"
19203,2020-06-01,Mexico,151,3152,90664,"rgb(153, 201, 69)"
19204,2020-06-02,Mexico,237,2771,93435,"rgb(153, 201, 69)"
19205,2020-06-03,Mexico,470,3891,97326,"rgb(153, 201, 69)"
19206,2020-06-04,Mexico,1091,3912,101238,"rgb(153, 201, 69)"
19207,2020-06-05,Mexico,817,4442,105680,"rgb(153, 201, 69)"
19208,2020-06-06,Mexico,625,4346,110026,"rgb(153, 201, 69)"
19209,2020-06-07,Mexico,341,3593,113619,"rgb(153, 201, 69)"
19210,2020-06-08,Mexico,188,3484,117103,"rgb(153, 201, 69)"
19211,2020-06-09,Mexico,354,2999,120102,"rgb(153, 201, 69)"
19212,2020-06-10,Mexico,596,4199,124301,"rgb(153, 201, 69)"
19213,2020-06-11,Mexico,708,4883,129184,"rgb(153, 201, 69)"
19214,2020-06-12,Mexico,587,4790,133974,"rgb(153, 201, 69)"
19215,2020-06-13,Mexico,504,5222,139196,"rgb(153, 201, 69)"
19216,2020-06-14,Mexico,424,3494,142690,"rgb(153, 201, 69)"
19217,2020-06-15,Mexico,269,4147,146837,"rgb(153, 201, 69)"
19218,2020-06-16,Mexico,439,3427,150264,"rgb(153, 201, 69)"
19219,2020-06-17,Mexico,730,4599,154863,"rgb(153, 201, 69)"
19220,2020-06-18,Mexico,770,4930,159793,"rgb(153, 201, 69)"
19221,2020-06-19,Mexico,667,5662,165455,"rgb(153, 201, 69)"
19222,2020-06-20,Mexico,647,5030,170485,"rgb(153, 201, 69)"
19223,2020-06-21,Mexico,387,4717,175202,"rgb(153, 201, 69)"
19224,2020-06-22,Mexico,1044,5343,180545,"rgb(153, 201, 69)"
19225,2020-06-23,Mexico,759,4577,185122,"rgb(153, 201, 69)"
19226,2020-06-24,Mexico,793,6288,191410,"rgb(153, 201, 69)"
19227,2020-06-25,Mexico,965,5437,196847,"rgb(153, 201, 69)"
19228,2020-06-26,Mexico,718,6104,202951,"rgb(153, 201, 69)"
19229,2020-06-27,Mexico,719,5441,208392,"rgb(153, 201, 69)"
19230,2020-06-28,Mexico,602,4410,212802,"rgb(153, 201, 69)"
19231,2020-06-29,Mexico,267,4050,216852,"rgb(153, 201, 69)"
19232,2020-06-30,Mexico,473,3805,220657,"rgb(153, 201, 69)"
19233,2020-07-01,Mexico,648,5432,226089,"rgb(153, 201, 69)"
19234,2020-07-02,Mexico,741,5681,231770,"rgb(153, 201, 69)"
19235,2020-07-03,Mexico,679,6741,238511,"rgb(153, 201, 69)"
19236,2020-07-04,Mexico,654,6740,245251,"rgb(153, 201, 69)"
19237,2020-07-05,Mexico,523,6914,252165,"rgb(153, 201, 69)"
19238,2020-07-06,Mexico,273,4683,256848,"rgb(153, 201, 69)"
19239,2020-07-07,Mexico,480,4902,261750,"rgb(153, 201, 69)"
19240,2020-07-08,Mexico,895,6258,268008,"rgb(153, 201, 69)"
19241,2020-07-09,Mexico,782,6995,275003,"rgb(153, 201, 69)"
19242,2020-07-10,Mexico,730,7280,282283,"rgb(153, 201, 69)"
19243,2020-07-11,Mexico,665,6891,289174,"rgb(153, 201, 69)"
19244,2020-07-12,Mexico,539,6094,295268,"rgb(153, 201, 69)"
19245,2020-07-13,Mexico,276,4482,299750,"rgb(153, 201, 69)"
19246,2019-12-31,Malaysia,0,0,0,"rgb(204, 97, 176)"
19247,2020-01-01,Malaysia,0,0,0,"rgb(204, 97, 176)"
19248,2020-01-02,Malaysia,0,0,0,"rgb(204, 97, 176)"
19249,2020-01-03,Malaysia,0,0,0,"rgb(204, 97, 176)"
19250,2020-01-04,Malaysia,0,0,0,"rgb(204, 97, 176)"
19251,2020-01-05,Malaysia,0,0,0,"rgb(204, 97, 176)"
19252,2020-01-06,Malaysia,0,0,0,"rgb(204, 97, 176)"
19253,2020-01-07,Malaysia,0,0,0,"rgb(204, 97, 176)"
19254,2020-01-08,Malaysia,0,0,0,"rgb(204, 97, 176)"
19255,2020-01-09,Malaysia,0,0,0,"rgb(204, 97, 176)"
19256,2020-01-10,Malaysia,0,0,0,"rgb(204, 97, 176)"
19257,2020-01-11,Malaysia,0,0,0,"rgb(204, 97, 176)"
19258,2020-01-12,Malaysia,0,0,0,"rgb(204, 97, 176)"
19259,2020-01-13,Malaysia,0,0,0,"rgb(204, 97, 176)"
19260,2020-01-14,Malaysia,0,0,0,"rgb(204, 97, 176)"
19261,2020-01-15,Malaysia,0,0,0,"rgb(204, 97, 176)"
19262,2020-01-16,Malaysia,0,0,0,"rgb(204, 97, 176)"
19263,2020-01-17,Malaysia,0,0,0,"rgb(204, 97, 176)"
19264,2020-01-18,Malaysia,0,0,0,"rgb(204, 97, 176)"
19265,2020-01-19,Malaysia,0,0,0,"rgb(204, 97, 176)"
19266,2020-01-20,Malaysia,0,0,0,"rgb(204, 97, 176)"
19267,2020-01-21,Malaysia,0,0,0,"rgb(204, 97, 176)"
19268,2020-01-22,Malaysia,0,0,0,"rgb(204, 97, 176)"
19269,2020-01-23,Malaysia,0,0,0,"rgb(204, 97, 176)"
19270,2020-01-24,Malaysia,0,0,0,"rgb(204, 97, 176)"
19271,2020-01-25,Malaysia,0,3,3,"rgb(204, 97, 176)"
19272,2020-01-26,Malaysia,0,1,4,"rgb(204, 97, 176)"
19273,2020-01-27,Malaysia,0,0,4,"rgb(204, 97, 176)"
19274,2020-01-28,Malaysia,0,0,4,"rgb(204, 97, 176)"
19275,2020-01-29,Malaysia,0,3,7,"rgb(204, 97, 176)"
19276,2020-01-30,Malaysia,0,0,7,"rgb(204, 97, 176)"
19277,2020-01-31,Malaysia,0,1,8,"rgb(204, 97, 176)"
19278,2020-02-01,Malaysia,0,0,8,"rgb(204, 97, 176)"
19279,2020-02-02,Malaysia,0,0,8,"rgb(204, 97, 176)"
19280,2020-02-03,Malaysia,0,0,8,"rgb(204, 97, 176)"
19281,2020-02-04,Malaysia,0,0,8,"rgb(204, 97, 176)"
19282,2020-02-05,Malaysia,0,2,10,"rgb(204, 97, 176)"
19283,2020-02-06,Malaysia,0,2,12,"rgb(204, 97, 176)"
19284,2020-02-07,Malaysia,0,2,14,"rgb(204, 97, 176)"
19285,2020-02-08,Malaysia,0,1,15,"rgb(204, 97, 176)"
19286,2020-02-09,Malaysia,0,1,16,"rgb(204, 97, 176)"
19287,2020-02-10,Malaysia,0,2,18,"rgb(204, 97, 176)"
19288,2020-02-11,Malaysia,0,0,18,"rgb(204, 97, 176)"
19289,2020-02-12,Malaysia,0,0,18,"rgb(204, 97, 176)"
19290,2020-02-13,Malaysia,0,0,18,"rgb(204, 97, 176)"
19291,2020-02-14,Malaysia,0,1,19,"rgb(204, 97, 176)"
19292,2020-02-15,Malaysia,0,2,21,"rgb(204, 97, 176)"
19293,2020-02-16,Malaysia,0,1,22,"rgb(204, 97, 176)"
19294,2020-02-17,Malaysia,0,0,22,"rgb(204, 97, 176)"
19295,2020-02-18,Malaysia,0,0,22,"rgb(204, 97, 176)"
19296,2020-02-19,Malaysia,0,0,22,"rgb(204, 97, 176)"
19297,2020-02-20,Malaysia,0,0,22,"rgb(204, 97, 176)"
19298,2020-02-21,Malaysia,0,0,22,"rgb(204, 97, 176)"
19299,2020-02-22,Malaysia,0,0,22,"rgb(204, 97, 176)"
19300,2020-02-23,Malaysia,0,0,22,"rgb(204, 97, 176)"
19301,2020-02-24,Malaysia,0,0,22,"rgb(204, 97, 176)"
19302,2020-02-25,Malaysia,0,0,22,"rgb(204, 97, 176)"
19303,2020-02-26,Malaysia,0,0,22,"rgb(204, 97, 176)"
19304,2020-02-27,Malaysia,0,0,22,"rgb(204, 97, 176)"
19305,2020-02-28,Malaysia,0,1,23,"rgb(204, 97, 176)"
19306,2020-02-29,Malaysia,0,2,25,"rgb(204, 97, 176)"
19307,2020-03-01,Malaysia,0,0,25,"rgb(204, 97, 176)"
19308,2020-03-02,Malaysia,0,4,29,"rgb(204, 97, 176)"
19309,2020-03-04,Malaysia,0,7,36,"rgb(204, 97, 176)"
19310,2020-03-05,Malaysia,0,14,50,"rgb(204, 97, 176)"
19311,2020-03-06,Malaysia,0,0,50,"rgb(204, 97, 176)"
19312,2020-03-07,Malaysia,0,33,83,"rgb(204, 97, 176)"
19313,2020-03-08,Malaysia,0,10,93,"rgb(204, 97, 176)"
19314,2020-03-09,Malaysia,0,6,99,"rgb(204, 97, 176)"
19315,2020-03-10,Malaysia,0,18,117,"rgb(204, 97, 176)"
19316,2020-03-11,Malaysia,0,12,129,"rgb(204, 97, 176)"
19317,2020-03-12,Malaysia,0,20,149,"rgb(204, 97, 176)"
19318,2020-03-13,Malaysia,0,9,158,"rgb(204, 97, 176)"
19319,2020-03-14,Malaysia,0,39,197,"rgb(204, 97, 176)"
19320,2020-03-15,Malaysia,0,41,238,"rgb(204, 97, 176)"
19321,2020-03-16,Malaysia,0,190,428,"rgb(204, 97, 176)"
19322,2020-03-17,Malaysia,0,125,553,"rgb(204, 97, 176)"
19323,2020-03-18,Malaysia,2,120,673,"rgb(204, 97, 176)"
19324,2020-03-19,Malaysia,0,117,790,"rgb(204, 97, 176)"
19325,2020-03-20,Malaysia,0,110,900,"rgb(204, 97, 176)"
19326,2020-03-21,Malaysia,0,130,1030,"rgb(204, 97, 176)"
19327,2020-03-22,Malaysia,2,153,1183,"rgb(204, 97, 176)"
19328,2020-03-23,Malaysia,6,123,1306,"rgb(204, 97, 176)"
19329,2020-03-24,Malaysia,4,212,1518,"rgb(204, 97, 176)"
19330,2020-03-25,Malaysia,1,106,1624,"rgb(204, 97, 176)"
19331,2020-03-26,Malaysia,4,172,1796,"rgb(204, 97, 176)"
19332,2020-03-27,Malaysia,4,235,2031,"rgb(204, 97, 176)"
19333,2020-03-28,Malaysia,3,130,2161,"rgb(204, 97, 176)"
19334,2020-03-29,Malaysia,1,159,2320,"rgb(204, 97, 176)"
19335,2020-03-30,Malaysia,7,150,2470,"rgb(204, 97, 176)"
19336,2020-03-31,Malaysia,3,156,2626,"rgb(204, 97, 176)"
19337,2020-04-01,Malaysia,6,140,2766,"rgb(204, 97, 176)"
19338,2020-04-02,Malaysia,2,142,2908,"rgb(204, 97, 176)"
19339,2020-04-03,Malaysia,5,208,3116,"rgb(204, 97, 176)"
19340,2020-04-04,Malaysia,3,217,3333,"rgb(204, 97, 176)"
19341,2020-04-05,Malaysia,4,150,3483,"rgb(204, 97, 176)"
19342,2020-04-06,Malaysia,4,179,3662,"rgb(204, 97, 176)"
19343,2020-04-07,Malaysia,1,131,3793,"rgb(204, 97, 176)"
19344,2020-04-08,Malaysia,1,170,3963,"rgb(204, 97, 176)"
19345,2020-04-09,Malaysia,2,156,4119,"rgb(204, 97, 176)"
19346,2020-04-10,Malaysia,2,109,4228,"rgb(204, 97, 176)"
19347,2020-04-11,Malaysia,3,118,4346,"rgb(204, 97, 176)"
19348,2020-04-12,Malaysia,3,184,4530,"rgb(204, 97, 176)"
19349,2020-04-13,Malaysia,3,153,4683,"rgb(204, 97, 176)"
19350,2020-04-14,Malaysia,1,134,4817,"rgb(204, 97, 176)"
19351,2020-04-15,Malaysia,5,170,4987,"rgb(204, 97, 176)"
19352,2020-04-16,Malaysia,1,85,5072,"rgb(204, 97, 176)"
19353,2020-04-17,Malaysia,1,110,5182,"rgb(204, 97, 176)"
19354,2020-04-18,Malaysia,2,69,5251,"rgb(204, 97, 176)"
19355,2020-04-19,Malaysia,2,54,5305,"rgb(204, 97, 176)"
19356,2020-04-20,Malaysia,1,84,5389,"rgb(204, 97, 176)"
19357,2020-04-21,Malaysia,0,36,5425,"rgb(204, 97, 176)"
19358,2020-04-22,Malaysia,3,57,5482,"rgb(204, 97, 176)"
19359,2020-04-23,Malaysia,1,50,5532,"rgb(204, 97, 176)"
19360,2020-04-24,Malaysia,2,71,5603,"rgb(204, 97, 176)"
19361,2020-04-25,Malaysia,1,88,5691,"rgb(204, 97, 176)"
19362,2020-04-26,Malaysia,2,51,5742,"rgb(204, 97, 176)"
19363,2020-04-27,Malaysia,0,38,5780,"rgb(204, 97, 176)"
19364,2020-04-28,Malaysia,1,40,5820,"rgb(204, 97, 176)"
19365,2020-04-29,Malaysia,1,31,5851,"rgb(204, 97, 176)"
19366,2020-04-30,Malaysia,0,94,5945,"rgb(204, 97, 176)"
19367,2020-05-01,Malaysia,2,57,6002,"rgb(204, 97, 176)"
19368,2020-05-02,Malaysia,1,69,6071,"rgb(204, 97, 176)"
19369,2020-05-03,Malaysia,0,105,6176,"rgb(204, 97, 176)"
19370,2020-05-04,Malaysia,2,122,6298,"rgb(204, 97, 176)"
19371,2020-05-05,Malaysia,0,55,6353,"rgb(204, 97, 176)"
19372,2020-05-06,Malaysia,1,30,6383,"rgb(204, 97, 176)"
19373,2020-05-07,Malaysia,1,45,6428,"rgb(204, 97, 176)"
19374,2020-05-08,Malaysia,0,39,6467,"rgb(204, 97, 176)"
19375,2020-05-09,Malaysia,0,68,6535,"rgb(204, 97, 176)"
19376,2020-05-10,Malaysia,1,54,6589,"rgb(204, 97, 176)"
19377,2020-05-11,Malaysia,0,67,6656,"rgb(204, 97, 176)"
19378,2020-05-12,Malaysia,1,70,6726,"rgb(204, 97, 176)"
19379,2020-05-13,Malaysia,0,16,6742,"rgb(204, 97, 176)"
19380,2020-05-14,Malaysia,2,37,6779,"rgb(204, 97, 176)"
19381,2020-05-15,Malaysia,1,40,6819,"rgb(204, 97, 176)"
19382,2020-05-16,Malaysia,0,36,6855,"rgb(204, 97, 176)"
19383,2020-05-17,Malaysia,1,17,6872,"rgb(204, 97, 176)"
19384,2020-05-18,Malaysia,0,22,6894,"rgb(204, 97, 176)"
19385,2020-05-19,Malaysia,0,47,6941,"rgb(204, 97, 176)"
19386,2020-05-20,Malaysia,1,37,6978,"rgb(204, 97, 176)"
19387,2020-05-21,Malaysia,0,31,7009,"rgb(204, 97, 176)"
19388,2020-05-22,Malaysia,0,50,7059,"rgb(204, 97, 176)"
19389,2020-05-23,Malaysia,1,78,7137,"rgb(204, 97, 176)"
19390,2020-05-24,Malaysia,0,48,7185,"rgb(204, 97, 176)"
19391,2020-05-25,Malaysia,0,60,7245,"rgb(204, 97, 176)"
19392,2020-05-26,Malaysia,0,172,7417,"rgb(204, 97, 176)"
19393,2020-05-27,Malaysia,0,187,7604,"rgb(204, 97, 176)"
19394,2020-05-28,Malaysia,0,15,7619,"rgb(204, 97, 176)"
19395,2020-05-29,Malaysia,0,10,7629,"rgb(204, 97, 176)"
19396,2020-05-30,Malaysia,0,103,7732,"rgb(204, 97, 176)"
19397,2020-05-31,Malaysia,0,30,7762,"rgb(204, 97, 176)"
19398,2020-06-01,Malaysia,0,57,7819,"rgb(204, 97, 176)"
19399,2020-06-02,Malaysia,0,38,7857,"rgb(204, 97, 176)"
19400,2020-06-03,Malaysia,0,20,7877,"rgb(204, 97, 176)"
19401,2020-06-04,Malaysia,0,93,7970,"rgb(204, 97, 176)"
19402,2020-06-05,Malaysia,0,0,7970,"rgb(204, 97, 176)"
19403,2020-06-06,Malaysia,1,296,8266,"rgb(204, 97, 176)"
19404,2020-06-07,Malaysia,1,37,8303,"rgb(204, 97, 176)"
19405,2020-06-08,Malaysia,0,19,8322,"rgb(204, 97, 176)"
19406,2020-06-09,Malaysia,0,7,8329,"rgb(204, 97, 176)"
19407,2020-06-10,Malaysia,0,7,8336,"rgb(204, 97, 176)"
19408,2020-06-11,Malaysia,1,2,8338,"rgb(204, 97, 176)"
19409,2020-06-12,Malaysia,0,31,8369,"rgb(204, 97, 176)"
19410,2020-06-13,Malaysia,1,33,8402,"rgb(204, 97, 176)"
19411,2020-06-14,Malaysia,1,43,8445,"rgb(204, 97, 176)"
19412,2020-06-15,Malaysia,1,8,8453,"rgb(204, 97, 176)"
19413,2020-06-16,Malaysia,0,41,8494,"rgb(204, 97, 176)"
19414,2020-06-17,Malaysia,0,11,8505,"rgb(204, 97, 176)"
19415,2020-06-18,Malaysia,0,10,8515,"rgb(204, 97, 176)"
19416,2020-06-19,Malaysia,0,14,8529,"rgb(204, 97, 176)"
19417,2020-06-20,Malaysia,0,6,8535,"rgb(204, 97, 176)"
19418,2020-06-21,Malaysia,0,21,8556,"rgb(204, 97, 176)"
19419,2020-06-22,Malaysia,0,16,8572,"rgb(204, 97, 176)"
19420,2020-06-23,Malaysia,0,15,8587,"rgb(204, 97, 176)"
19421,2020-06-24,Malaysia,0,3,8590,"rgb(204, 97, 176)"
19422,2020-06-25,Malaysia,0,6,8596,"rgb(204, 97, 176)"
19423,2020-06-26,Malaysia,0,4,8600,"rgb(204, 97, 176)"
19424,2020-06-27,Malaysia,0,6,8606,"rgb(204, 97, 176)"
19425,2020-06-28,Malaysia,0,10,8616,"rgb(204, 97, 176)"
19426,2020-06-29,Malaysia,0,18,8634,"rgb(204, 97, 176)"
19427,2020-06-30,Malaysia,0,3,8637,"rgb(204, 97, 176)"
19428,2020-07-01,Malaysia,0,2,8639,"rgb(204, 97, 176)"
19429,2020-07-02,Malaysia,0,1,8640,"rgb(204, 97, 176)"
19430,2020-07-03,Malaysia,0,3,8643,"rgb(204, 97, 176)"
19431,2020-07-04,Malaysia,0,5,8648,"rgb(204, 97, 176)"
19432,2020-07-05,Malaysia,0,10,8658,"rgb(204, 97, 176)"
19433,2020-07-06,Malaysia,0,0,8658,"rgb(204, 97, 176)"
19434,2020-07-07,Malaysia,0,10,8668,"rgb(204, 97, 176)"
19435,2020-07-08,Malaysia,0,6,8674,"rgb(204, 97, 176)"
19436,2020-07-09,Malaysia,0,3,8677,"rgb(204, 97, 176)"
19437,2020-07-10,Malaysia,0,6,8683,"rgb(204, 97, 176)"
19438,2020-07-11,Malaysia,0,13,8696,"rgb(204, 97, 176)"
19439,2020-07-12,Malaysia,1,8,8704,"rgb(204, 97, 176)"
19440,2020-07-13,Malaysia,0,14,8718,"rgb(204, 97, 176)"
19441,2020-03-23,Mozambique,0,1,1,"rgb(36, 121, 108)"
19442,2020-03-24,Mozambique,0,0,1,"rgb(36, 121, 108)"
19443,2020-03-25,Mozambique,0,0,1,"rgb(36, 121, 108)"
19444,2020-03-26,Mozambique,0,4,5,"rgb(36, 121, 108)"
19445,2020-03-27,Mozambique,0,2,7,"rgb(36, 121, 108)"
19446,2020-03-28,Mozambique,0,0,7,"rgb(36, 121, 108)"
19447,2020-03-29,Mozambique,0,1,8,"rgb(36, 121, 108)"
19448,2020-03-30,Mozambique,0,0,8,"rgb(36, 121, 108)"
19449,2020-03-31,Mozambique,0,0,8,"rgb(36, 121, 108)"
19450,2020-04-01,Mozambique,0,0,8,"rgb(36, 121, 108)"
19451,2020-04-02,Mozambique,0,2,10,"rgb(36, 121, 108)"
19452,2020-04-03,Mozambique,0,0,10,"rgb(36, 121, 108)"
19453,2020-04-04,Mozambique,0,0,10,"rgb(36, 121, 108)"
19454,2020-04-05,Mozambique,0,0,10,"rgb(36, 121, 108)"
19455,2020-04-06,Mozambique,0,0,10,"rgb(36, 121, 108)"
19456,2020-04-07,Mozambique,0,0,10,"rgb(36, 121, 108)"
19457,2020-04-08,Mozambique,0,0,10,"rgb(36, 121, 108)"
19458,2020-04-09,Mozambique,0,7,17,"rgb(36, 121, 108)"
19459,2020-04-10,Mozambique,0,0,17,"rgb(36, 121, 108)"
19460,2020-04-11,Mozambique,0,3,20,"rgb(36, 121, 108)"
19461,2020-04-12,Mozambique,0,0,20,"rgb(36, 121, 108)"
19462,2020-04-13,Mozambique,0,1,21,"rgb(36, 121, 108)"
19463,2020-04-14,Mozambique,0,6,27,"rgb(36, 121, 108)"
19464,2020-04-15,Mozambique,0,1,28,"rgb(36, 121, 108)"
19465,2020-04-16,Mozambique,0,1,29,"rgb(36, 121, 108)"
19466,2020-04-17,Mozambique,0,2,31,"rgb(36, 121, 108)"
19467,2020-04-18,Mozambique,0,3,34,"rgb(36, 121, 108)"
19468,2020-04-19,Mozambique,0,1,35,"rgb(36, 121, 108)"
19469,2020-04-20,Mozambique,0,4,39,"rgb(36, 121, 108)"
19470,2020-04-21,Mozambique,0,0,39,"rgb(36, 121, 108)"
19471,2020-04-22,Mozambique,0,0,39,"rgb(36, 121, 108)"
19472,2020-04-23,Mozambique,0,2,41,"rgb(36, 121, 108)"
19473,2020-04-24,Mozambique,0,5,46,"rgb(36, 121, 108)"
19474,2020-04-25,Mozambique,0,19,65,"rgb(36, 121, 108)"
19475,2020-04-26,Mozambique,0,5,70,"rgb(36, 121, 108)"
19476,2020-04-27,Mozambique,0,6,76,"rgb(36, 121, 108)"
19477,2020-04-28,Mozambique,0,0,76,"rgb(36, 121, 108)"
19478,2020-04-29,Mozambique,0,0,76,"rgb(36, 121, 108)"
19479,2020-04-30,Mozambique,0,0,76,"rgb(36, 121, 108)"
19480,2020-05-01,Mozambique,0,0,76,"rgb(36, 121, 108)"
19481,2020-05-02,Mozambique,0,3,79,"rgb(36, 121, 108)"
19482,2020-05-03,Mozambique,0,0,79,"rgb(36, 121, 108)"
19483,2020-05-04,Mozambique,0,1,80,"rgb(36, 121, 108)"
19484,2020-05-05,Mozambique,0,0,80,"rgb(36, 121, 108)"
19485,2020-05-06,Mozambique,0,1,81,"rgb(36, 121, 108)"
19486,2020-05-07,Mozambique,0,0,81,"rgb(36, 121, 108)"
19487,2020-05-08,Mozambique,0,0,81,"rgb(36, 121, 108)"
19488,2020-05-09,Mozambique,0,1,82,"rgb(36, 121, 108)"
19489,2020-05-10,Mozambique,0,5,87,"rgb(36, 121, 108)"
19490,2020-05-11,Mozambique,0,4,91,"rgb(36, 121, 108)"
19491,2020-05-12,Mozambique,0,12,103,"rgb(36, 121, 108)"
19492,2020-05-13,Mozambique,0,1,104,"rgb(36, 121, 108)"
19493,2020-05-14,Mozambique,0,3,107,"rgb(36, 121, 108)"
19494,2020-05-15,Mozambique,0,8,115,"rgb(36, 121, 108)"
19495,2020-05-16,Mozambique,0,4,119,"rgb(36, 121, 108)"
19496,2020-05-17,Mozambique,0,10,129,"rgb(36, 121, 108)"
19497,2020-05-18,Mozambique,0,8,137,"rgb(36, 121, 108)"
19498,2020-05-19,Mozambique,0,8,145,"rgb(36, 121, 108)"
19499,2020-05-20,Mozambique,0,1,146,"rgb(36, 121, 108)"
19500,2020-05-21,Mozambique,0,10,156,"rgb(36, 121, 108)"
19501,2020-05-22,Mozambique,0,6,162,"rgb(36, 121, 108)"
19502,2020-05-23,Mozambique,0,2,164,"rgb(36, 121, 108)"
19503,2020-05-24,Mozambique,0,4,168,"rgb(36, 121, 108)"
19504,2020-05-25,Mozambique,0,26,194,"rgb(36, 121, 108)"
19505,2020-05-26,Mozambique,1,15,209,"rgb(36, 121, 108)"
19506,2020-05-27,Mozambique,0,4,213,"rgb(36, 121, 108)"
19507,2020-05-28,Mozambique,0,14,227,"rgb(36, 121, 108)"
19508,2020-05-29,Mozambique,1,6,233,"rgb(36, 121, 108)"
19509,2020-05-30,Mozambique,0,1,234,"rgb(36, 121, 108)"
19510,2020-05-31,Mozambique,0,10,244,"rgb(36, 121, 108)"
19511,2020-06-01,Mozambique,0,10,254,"rgb(36, 121, 108)"
19512,2020-06-02,Mozambique,0,0,254,"rgb(36, 121, 108)"
19513,2020-06-03,Mozambique,0,53,307,"rgb(36, 121, 108)"
19514,2020-06-04,Mozambique,0,9,316,"rgb(36, 121, 108)"
19515,2020-06-05,Mozambique,0,36,352,"rgb(36, 121, 108)"
19516,2020-06-06,Mozambique,0,2,354,"rgb(36, 121, 108)"
19517,2020-06-07,Mozambique,0,57,411,"rgb(36, 121, 108)"
19518,2020-06-08,Mozambique,0,15,426,"rgb(36, 121, 108)"
19519,2020-06-09,Mozambique,0,7,433,"rgb(36, 121, 108)"
19520,2020-06-10,Mozambique,0,20,453,"rgb(36, 121, 108)"
19521,2020-06-11,Mozambique,0,19,472,"rgb(36, 121, 108)"
19522,2020-06-12,Mozambique,0,17,489,"rgb(36, 121, 108)"
19523,2020-06-13,Mozambique,0,20,509,"rgb(36, 121, 108)"
19524,2020-06-14,Mozambique,0,44,553,"rgb(36, 121, 108)"
19525,2020-06-15,Mozambique,1,30,583,"rgb(36, 121, 108)"
19526,2020-06-16,Mozambique,0,26,609,"rgb(36, 121, 108)"
19527,2020-06-17,Mozambique,1,29,638,"rgb(36, 121, 108)"
19528,2020-06-18,Mozambique,0,13,651,"rgb(36, 121, 108)"
19529,2020-06-19,Mozambique,0,11,662,"rgb(36, 121, 108)"
19530,2020-06-20,Mozambique,0,6,668,"rgb(36, 121, 108)"
19531,2020-06-21,Mozambique,0,20,688,"rgb(36, 121, 108)"
19532,2020-06-22,Mozambique,1,45,733,"rgb(36, 121, 108)"
19533,2020-06-23,Mozambique,0,4,737,"rgb(36, 121, 108)"
19534,2020-06-24,Mozambique,0,20,757,"rgb(36, 121, 108)"
19535,2020-06-25,Mozambique,0,5,762,"rgb(36, 121, 108)"
19536,2020-06-26,Mozambique,0,26,788,"rgb(36, 121, 108)"
19537,2020-06-27,Mozambique,0,28,816,"rgb(36, 121, 108)"
19538,2020-06-28,Mozambique,0,23,839,"rgb(36, 121, 108)"
19539,2020-06-29,Mozambique,0,20,859,"rgb(36, 121, 108)"
19540,2020-06-30,Mozambique,1,24,883,"rgb(36, 121, 108)"
19541,2020-07-01,Mozambique,0,6,889,"rgb(36, 121, 108)"
19542,2020-07-02,Mozambique,0,14,903,"rgb(36, 121, 108)"
19543,2020-07-03,Mozambique,0,15,918,"rgb(36, 121, 108)"
19544,2020-07-04,Mozambique,0,21,939,"rgb(36, 121, 108)"
19545,2020-07-05,Mozambique,1,30,969,"rgb(36, 121, 108)"
19546,2020-07-06,Mozambique,1,18,987,"rgb(36, 121, 108)"
19547,2020-07-07,Mozambique,0,25,1012,"rgb(36, 121, 108)"
19548,2020-07-08,Mozambique,0,28,1040,"rgb(36, 121, 108)"
19549,2020-07-09,Mozambique,0,31,1071,"rgb(36, 121, 108)"
19550,2020-07-10,Mozambique,1,21,1092,"rgb(36, 121, 108)"
19551,2020-07-11,Mozambique,0,19,1111,"rgb(36, 121, 108)"
19552,2020-07-12,Mozambique,0,24,1135,"rgb(36, 121, 108)"
19553,2020-07-13,Mozambique,0,22,1157,"rgb(36, 121, 108)"
19554,2020-03-15,Namibia,0,2,2,"rgb(218, 165, 27)"
19555,2020-03-16,Namibia,0,0,2,"rgb(218, 165, 27)"
19556,2020-03-17,Namibia,0,0,2,"rgb(218, 165, 27)"
19557,2020-03-18,Namibia,0,0,2,"rgb(218, 165, 27)"
19558,2020-03-19,Namibia,0,0,2,"rgb(218, 165, 27)"
19559,2020-03-20,Namibia,0,0,2,"rgb(218, 165, 27)"
19560,2020-03-21,Namibia,0,1,3,"rgb(218, 165, 27)"
19561,2020-03-22,Namibia,0,0,3,"rgb(218, 165, 27)"
19562,2020-03-23,Namibia,0,0,3,"rgb(218, 165, 27)"
19563,2020-03-24,Namibia,0,0,3,"rgb(218, 165, 27)"
19564,2020-03-25,Namibia,0,0,3,"rgb(218, 165, 27)"
19565,2020-03-26,Namibia,0,1,4,"rgb(218, 165, 27)"
19566,2020-03-27,Namibia,0,4,8,"rgb(218, 165, 27)"
19567,2020-03-28,Namibia,0,0,8,"rgb(218, 165, 27)"
19568,2020-03-29,Namibia,0,0,8,"rgb(218, 165, 27)"
19569,2020-03-30,Namibia,0,3,11,"rgb(218, 165, 27)"
19570,2020-03-31,Namibia,0,0,11,"rgb(218, 165, 27)"
19571,2020-04-01,Namibia,0,0,11,"rgb(218, 165, 27)"
19572,2020-04-02,Namibia,0,2,13,"rgb(218, 165, 27)"
19573,2020-04-03,Namibia,0,0,13,"rgb(218, 165, 27)"
19574,2020-04-04,Namibia,0,1,14,"rgb(218, 165, 27)"
19575,2020-04-05,Namibia,0,0,14,"rgb(218, 165, 27)"
19576,2020-04-06,Namibia,0,2,16,"rgb(218, 165, 27)"
19577,2020-04-07,Namibia,0,0,16,"rgb(218, 165, 27)"
19578,2020-04-08,Namibia,0,0,16,"rgb(218, 165, 27)"
19579,2020-04-09,Namibia,0,0,16,"rgb(218, 165, 27)"
19580,2020-04-10,Namibia,0,0,16,"rgb(218, 165, 27)"
19581,2020-04-11,Namibia,0,0,16,"rgb(218, 165, 27)"
19582,2020-04-12,Namibia,0,0,16,"rgb(218, 165, 27)"
19583,2020-04-13,Namibia,0,0,16,"rgb(218, 165, 27)"
19584,2020-04-14,Namibia,0,0,16,"rgb(218, 165, 27)"
19585,2020-04-15,Namibia,0,0,16,"rgb(218, 165, 27)"
19586,2020-04-16,Namibia,0,0,16,"rgb(218, 165, 27)"
19587,2020-04-17,Namibia,0,0,16,"rgb(218, 165, 27)"
19588,2020-04-18,Namibia,0,0,16,"rgb(218, 165, 27)"
19589,2020-04-19,Namibia,0,0,16,"rgb(218, 165, 27)"
19590,2020-04-20,Namibia,0,0,16,"rgb(218, 165, 27)"
19591,2020-04-21,Namibia,0,0,16,"rgb(218, 165, 27)"
19592,2020-04-22,Namibia,0,0,16,"rgb(218, 165, 27)"
19593,2020-04-23,Namibia,0,0,16,"rgb(218, 165, 27)"
19594,2020-04-24,Namibia,0,0,16,"rgb(218, 165, 27)"
19595,2020-04-25,Namibia,0,0,16,"rgb(218, 165, 27)"
19596,2020-04-26,Namibia,0,0,16,"rgb(218, 165, 27)"
19597,2020-04-27,Namibia,0,0,16,"rgb(218, 165, 27)"
19598,2020-04-28,Namibia,0,0,16,"rgb(218, 165, 27)"
19599,2020-04-29,Namibia,0,0,16,"rgb(218, 165, 27)"
19600,2020-04-30,Namibia,0,0,16,"rgb(218, 165, 27)"
19601,2020-05-01,Namibia,0,0,16,"rgb(218, 165, 27)"
19602,2020-05-02,Namibia,0,0,16,"rgb(218, 165, 27)"
19603,2020-05-03,Namibia,0,0,16,"rgb(218, 165, 27)"
19604,2020-05-04,Namibia,0,0,16,"rgb(218, 165, 27)"
19605,2020-05-05,Namibia,0,0,16,"rgb(218, 165, 27)"
19606,2020-05-06,Namibia,0,0,16,"rgb(218, 165, 27)"
19607,2020-05-07,Namibia,0,0,16,"rgb(218, 165, 27)"
19608,2020-05-08,Namibia,0,0,16,"rgb(218, 165, 27)"
19609,2020-05-09,Namibia,0,0,16,"rgb(218, 165, 27)"
19610,2020-05-10,Namibia,0,0,16,"rgb(218, 165, 27)"
19611,2020-05-11,Namibia,0,0,16,"rgb(218, 165, 27)"
19612,2020-05-12,Namibia,0,0,16,"rgb(218, 165, 27)"
19613,2020-05-13,Namibia,0,0,16,"rgb(218, 165, 27)"
19614,2020-05-14,Namibia,0,0,16,"rgb(218, 165, 27)"
19615,2020-05-15,Namibia,0,0,16,"rgb(218, 165, 27)"
19616,2020-05-16,Namibia,0,0,16,"rgb(218, 165, 27)"
19617,2020-05-17,Namibia,0,0,16,"rgb(218, 165, 27)"
19618,2020-05-18,Namibia,0,0,16,"rgb(218, 165, 27)"
19619,2020-05-19,Namibia,0,0,16,"rgb(218, 165, 27)"
19620,2020-05-20,Namibia,0,0,16,"rgb(218, 165, 27)"
19621,2020-05-21,Namibia,0,0,16,"rgb(218, 165, 27)"
19622,2020-05-22,Namibia,0,2,18,"rgb(218, 165, 27)"
19623,2020-05-23,Namibia,0,1,19,"rgb(218, 165, 27)"
19624,2020-05-24,Namibia,0,1,20,"rgb(218, 165, 27)"
19625,2020-05-25,Namibia,0,1,21,"rgb(218, 165, 27)"
19626,2020-05-26,Namibia,0,0,21,"rgb(218, 165, 27)"
19627,2020-05-27,Namibia,0,0,21,"rgb(218, 165, 27)"
19628,2020-05-28,Namibia,0,1,22,"rgb(218, 165, 27)"
19629,2020-05-29,Namibia,0,0,22,"rgb(218, 165, 27)"
19630,2020-05-30,Namibia,0,1,23,"rgb(218, 165, 27)"
19631,2020-05-31,Namibia,0,0,23,"rgb(218, 165, 27)"
19632,2020-06-01,Namibia,0,1,24,"rgb(218, 165, 27)"
19633,2020-06-02,Namibia,0,1,25,"rgb(218, 165, 27)"
19634,2020-06-03,Namibia,0,0,25,"rgb(218, 165, 27)"
19635,2020-06-04,Namibia,0,0,25,"rgb(218, 165, 27)"
19636,2020-06-05,Namibia,0,0,25,"rgb(218, 165, 27)"
19637,2020-06-06,Namibia,0,0,25,"rgb(218, 165, 27)"
19638,2020-06-07,Namibia,0,4,29,"rgb(218, 165, 27)"
19639,2020-06-08,Namibia,0,0,29,"rgb(218, 165, 27)"
19640,2020-06-09,Namibia,0,2,31,"rgb(218, 165, 27)"
19641,2020-06-10,Namibia,0,0,31,"rgb(218, 165, 27)"
19642,2020-06-11,Namibia,0,0,31,"rgb(218, 165, 27)"
19643,2020-06-12,Namibia,0,0,31,"rgb(218, 165, 27)"
19644,2020-06-13,Namibia,0,0,31,"rgb(218, 165, 27)"
19645,2020-06-14,Namibia,0,1,32,"rgb(218, 165, 27)"
19646,2020-06-15,Namibia,0,0,32,"rgb(218, 165, 27)"
19647,2020-06-16,Namibia,0,0,32,"rgb(218, 165, 27)"
19648,2020-06-17,Namibia,0,2,34,"rgb(218, 165, 27)"
19649,2020-06-18,Namibia,0,2,36,"rgb(218, 165, 27)"
19650,2020-06-19,Namibia,0,3,39,"rgb(218, 165, 27)"
19651,2020-06-20,Namibia,0,6,45,"rgb(218, 165, 27)"
19652,2020-06-21,Namibia,0,1,46,"rgb(218, 165, 27)"
19653,2020-06-22,Namibia,0,9,55,"rgb(218, 165, 27)"
19654,2020-06-23,Namibia,0,8,63,"rgb(218, 165, 27)"
19655,2020-06-24,Namibia,0,9,72,"rgb(218, 165, 27)"
19656,2020-06-25,Namibia,0,4,76,"rgb(218, 165, 27)"
19657,2020-06-26,Namibia,0,5,81,"rgb(218, 165, 27)"
19658,2020-06-27,Namibia,0,40,121,"rgb(218, 165, 27)"
19659,2020-06-28,Namibia,0,0,121,"rgb(218, 165, 27)"
19660,2020-06-29,Namibia,0,62,183,"rgb(218, 165, 27)"
19661,2020-06-30,Namibia,0,13,196,"rgb(218, 165, 27)"
19662,2020-07-01,Namibia,0,7,203,"rgb(218, 165, 27)"
19663,2020-07-02,Namibia,0,82,285,"rgb(218, 165, 27)"
19664,2020-07-03,Namibia,0,8,293,"rgb(218, 165, 27)"
19665,2020-07-04,Namibia,0,57,350,"rgb(218, 165, 27)"
19666,2020-07-05,Namibia,0,25,375,"rgb(218, 165, 27)"
19667,2020-07-06,Namibia,0,37,412,"rgb(218, 165, 27)"
19668,2020-07-07,Namibia,0,73,485,"rgb(218, 165, 27)"
19669,2020-07-08,Namibia,0,54,539,"rgb(218, 165, 27)"
19670,2020-07-09,Namibia,0,54,593,"rgb(218, 165, 27)"
19671,2020-07-10,Namibia,0,22,615,"rgb(218, 165, 27)"
19672,2020-07-11,Namibia,1,53,668,"rgb(218, 165, 27)"
19673,2020-07-12,Namibia,0,0,668,"rgb(218, 165, 27)"
19674,2020-07-13,Namibia,0,117,785,"rgb(218, 165, 27)"
19675,2020-03-21,New Caledonia,0,2,2,"rgb(47, 138, 196)"
19676,2020-03-22,New Caledonia,0,2,4,"rgb(47, 138, 196)"
19677,2020-03-23,New Caledonia,0,1,5,"rgb(47, 138, 196)"
19678,2020-03-24,New Caledonia,0,2,7,"rgb(47, 138, 196)"
19679,2020-03-25,New Caledonia,0,2,9,"rgb(47, 138, 196)"
19680,2020-03-26,New Caledonia,0,5,14,"rgb(47, 138, 196)"
19681,2020-03-27,New Caledonia,0,1,15,"rgb(47, 138, 196)"
19682,2020-03-28,New Caledonia,0,0,15,"rgb(47, 138, 196)"
19683,2020-03-29,New Caledonia,0,0,15,"rgb(47, 138, 196)"
19684,2020-03-30,New Caledonia,0,0,15,"rgb(47, 138, 196)"
19685,2020-03-31,New Caledonia,0,1,16,"rgb(47, 138, 196)"
19686,2020-04-01,New Caledonia,0,0,16,"rgb(47, 138, 196)"
19687,2020-04-02,New Caledonia,0,0,16,"rgb(47, 138, 196)"
19688,2020-04-03,New Caledonia,0,0,16,"rgb(47, 138, 196)"
19689,2020-04-04,New Caledonia,0,2,18,"rgb(47, 138, 196)"
19690,2020-04-05,New Caledonia,0,0,18,"rgb(47, 138, 196)"
19691,2020-04-06,New Caledonia,0,0,18,"rgb(47, 138, 196)"
19692,2020-04-07,New Caledonia,0,0,18,"rgb(47, 138, 196)"
19693,2020-04-08,New Caledonia,0,0,18,"rgb(47, 138, 196)"
19694,2020-04-09,New Caledonia,0,0,18,"rgb(47, 138, 196)"
19695,2020-04-10,New Caledonia,0,0,18,"rgb(47, 138, 196)"
19696,2020-04-11,New Caledonia,0,0,18,"rgb(47, 138, 196)"
19697,2020-04-12,New Caledonia,0,0,18,"rgb(47, 138, 196)"
19698,2020-04-13,New Caledonia,0,0,18,"rgb(47, 138, 196)"
19699,2020-04-14,New Caledonia,0,0,18,"rgb(47, 138, 196)"
19700,2020-04-15,New Caledonia,0,0,18,"rgb(47, 138, 196)"
19701,2020-04-16,New Caledonia,0,0,18,"rgb(47, 138, 196)"
19702,2020-04-17,New Caledonia,0,0,18,"rgb(47, 138, 196)"
19703,2020-04-18,New Caledonia,0,0,18,"rgb(47, 138, 196)"
19704,2020-04-19,New Caledonia,0,0,18,"rgb(47, 138, 196)"
19705,2020-04-20,New Caledonia,0,0,18,"rgb(47, 138, 196)"
19706,2020-04-21,New Caledonia,0,0,18,"rgb(47, 138, 196)"
19707,2020-04-22,New Caledonia,0,0,18,"rgb(47, 138, 196)"
19708,2020-04-23,New Caledonia,0,0,18,"rgb(47, 138, 196)"
19709,2020-04-24,New Caledonia,0,0,18,"rgb(47, 138, 196)"
19710,2020-04-25,New Caledonia,0,0,18,"rgb(47, 138, 196)"
19711,2020-04-26,New Caledonia,0,0,18,"rgb(47, 138, 196)"
19712,2020-04-27,New Caledonia,0,0,18,"rgb(47, 138, 196)"
19713,2020-04-28,New Caledonia,0,0,18,"rgb(47, 138, 196)"
19714,2020-04-29,New Caledonia,0,0,18,"rgb(47, 138, 196)"
19715,2020-04-30,New Caledonia,0,0,18,"rgb(47, 138, 196)"
19716,2020-05-01,New Caledonia,0,0,18,"rgb(47, 138, 196)"
19717,2020-05-02,New Caledonia,0,0,18,"rgb(47, 138, 196)"
19718,2020-05-03,New Caledonia,0,0,18,"rgb(47, 138, 196)"
19719,2020-05-04,New Caledonia,0,0,18,"rgb(47, 138, 196)"
19720,2020-05-05,New Caledonia,0,0,18,"rgb(47, 138, 196)"
19721,2020-05-06,New Caledonia,0,0,18,"rgb(47, 138, 196)"
19722,2020-05-07,New Caledonia,0,0,18,"rgb(47, 138, 196)"
19723,2020-05-08,New Caledonia,0,0,18,"rgb(47, 138, 196)"
19724,2020-05-09,New Caledonia,0,0,18,"rgb(47, 138, 196)"
19725,2020-05-10,New Caledonia,0,0,18,"rgb(47, 138, 196)"
19726,2020-05-11,New Caledonia,0,0,18,"rgb(47, 138, 196)"
19727,2020-05-12,New Caledonia,0,0,18,"rgb(47, 138, 196)"
19728,2020-05-13,New Caledonia,0,0,18,"rgb(47, 138, 196)"
19729,2020-05-14,New Caledonia,0,0,18,"rgb(47, 138, 196)"
19730,2020-05-15,New Caledonia,0,0,18,"rgb(47, 138, 196)"
19731,2020-05-16,New Caledonia,0,0,18,"rgb(47, 138, 196)"
19732,2020-05-17,New Caledonia,0,0,18,"rgb(47, 138, 196)"
19733,2020-05-18,New Caledonia,0,0,18,"rgb(47, 138, 196)"
19734,2020-05-19,New Caledonia,0,0,18,"rgb(47, 138, 196)"
19735,2020-05-20,New Caledonia,0,0,18,"rgb(47, 138, 196)"
19736,2020-05-21,New Caledonia,0,0,18,"rgb(47, 138, 196)"
19737,2020-05-22,New Caledonia,0,0,18,"rgb(47, 138, 196)"
19738,2020-05-23,New Caledonia,0,0,18,"rgb(47, 138, 196)"
19739,2020-05-24,New Caledonia,0,0,18,"rgb(47, 138, 196)"
19740,2020-05-25,New Caledonia,0,0,18,"rgb(47, 138, 196)"
19741,2020-05-26,New Caledonia,0,0,18,"rgb(47, 138, 196)"
19742,2020-05-27,New Caledonia,0,0,18,"rgb(47, 138, 196)"
19743,2020-05-28,New Caledonia,0,0,18,"rgb(47, 138, 196)"
19744,2020-05-29,New Caledonia,0,1,19,"rgb(47, 138, 196)"
19745,2020-05-30,New Caledonia,0,0,19,"rgb(47, 138, 196)"
19746,2020-05-31,New Caledonia,0,0,19,"rgb(47, 138, 196)"
19747,2020-06-01,New Caledonia,0,0,19,"rgb(47, 138, 196)"
19748,2020-06-02,New Caledonia,0,1,20,"rgb(47, 138, 196)"
19749,2020-06-03,New Caledonia,0,0,20,"rgb(47, 138, 196)"
19750,2020-06-04,New Caledonia,0,0,20,"rgb(47, 138, 196)"
19751,2020-06-05,New Caledonia,0,0,20,"rgb(47, 138, 196)"
19752,2020-06-06,New Caledonia,0,0,20,"rgb(47, 138, 196)"
19753,2020-06-07,New Caledonia,0,0,20,"rgb(47, 138, 196)"
19754,2020-06-08,New Caledonia,0,0,20,"rgb(47, 138, 196)"
19755,2020-06-09,New Caledonia,0,0,20,"rgb(47, 138, 196)"
19756,2020-06-10,New Caledonia,0,1,21,"rgb(47, 138, 196)"
19757,2020-06-11,New Caledonia,0,0,21,"rgb(47, 138, 196)"
19758,2020-06-12,New Caledonia,0,0,21,"rgb(47, 138, 196)"
19759,2020-06-13,New Caledonia,0,0,21,"rgb(47, 138, 196)"
19760,2020-06-14,New Caledonia,0,0,21,"rgb(47, 138, 196)"
19761,2020-06-15,New Caledonia,0,0,21,"rgb(47, 138, 196)"
19762,2020-06-16,New Caledonia,0,0,21,"rgb(47, 138, 196)"
19763,2020-06-17,New Caledonia,0,0,21,"rgb(47, 138, 196)"
19764,2020-06-18,New Caledonia,0,0,21,"rgb(47, 138, 196)"
19765,2020-06-19,New Caledonia,0,0,21,"rgb(47, 138, 196)"
19766,2020-06-20,New Caledonia,0,0,21,"rgb(47, 138, 196)"
19767,2020-06-21,New Caledonia,0,0,21,"rgb(47, 138, 196)"
19768,2020-06-22,New Caledonia,0,0,21,"rgb(47, 138, 196)"
19769,2020-06-23,New Caledonia,0,0,21,"rgb(47, 138, 196)"
19770,2020-06-24,New Caledonia,0,0,21,"rgb(47, 138, 196)"
19771,2020-06-25,New Caledonia,0,0,21,"rgb(47, 138, 196)"
19772,2020-06-26,New Caledonia,0,0,21,"rgb(47, 138, 196)"
19773,2020-06-27,New Caledonia,0,0,21,"rgb(47, 138, 196)"
19774,2020-06-28,New Caledonia,0,0,21,"rgb(47, 138, 196)"
19775,2020-06-29,New Caledonia,0,0,21,"rgb(47, 138, 196)"
19776,2020-06-30,New Caledonia,0,0,21,"rgb(47, 138, 196)"
19777,2020-07-01,New Caledonia,0,0,21,"rgb(47, 138, 196)"
19778,2020-07-02,New Caledonia,0,0,21,"rgb(47, 138, 196)"
19779,2020-07-03,New Caledonia,0,0,21,"rgb(47, 138, 196)"
19780,2020-07-04,New Caledonia,0,0,21,"rgb(47, 138, 196)"
19781,2020-07-05,New Caledonia,0,0,21,"rgb(47, 138, 196)"
19782,2020-07-06,New Caledonia,0,0,21,"rgb(47, 138, 196)"
19783,2020-07-07,New Caledonia,0,0,21,"rgb(47, 138, 196)"
19784,2020-07-08,New Caledonia,0,0,21,"rgb(47, 138, 196)"
19785,2020-07-09,New Caledonia,0,0,21,"rgb(47, 138, 196)"
19786,2020-07-10,New Caledonia,0,0,21,"rgb(47, 138, 196)"
19787,2020-07-11,New Caledonia,0,0,21,"rgb(47, 138, 196)"
19788,2020-07-12,New Caledonia,0,0,21,"rgb(47, 138, 196)"
19789,2020-07-13,New Caledonia,0,0,21,"rgb(47, 138, 196)"
19790,2020-03-21,Niger,0,1,1,"rgb(118, 78, 159)"
19791,2020-03-22,Niger,0,0,1,"rgb(118, 78, 159)"
19792,2020-03-23,Niger,0,0,1,"rgb(118, 78, 159)"
19793,2020-03-24,Niger,0,1,2,"rgb(118, 78, 159)"
19794,2020-03-25,Niger,1,5,7,"rgb(118, 78, 159)"
19795,2020-03-26,Niger,0,0,7,"rgb(118, 78, 159)"
19796,2020-03-27,Niger,0,3,10,"rgb(118, 78, 159)"
19797,2020-03-28,Niger,0,0,10,"rgb(118, 78, 159)"
19798,2020-03-29,Niger,0,0,10,"rgb(118, 78, 159)"
19799,2020-03-30,Niger,0,0,10,"rgb(118, 78, 159)"
19800,2020-03-31,Niger,2,10,20,"rgb(118, 78, 159)"
19801,2020-04-01,Niger,0,0,20,"rgb(118, 78, 159)"
19802,2020-04-02,Niger,2,54,74,"rgb(118, 78, 159)"
19803,2020-04-03,Niger,0,0,74,"rgb(118, 78, 159)"
19804,2020-04-04,Niger,0,24,98,"rgb(118, 78, 159)"
19805,2020-04-05,Niger,0,22,120,"rgb(118, 78, 159)"
19806,2020-04-06,Niger,5,64,184,"rgb(118, 78, 159)"
19807,2020-04-07,Niger,0,69,253,"rgb(118, 78, 159)"
19808,2020-04-08,Niger,1,25,278,"rgb(118, 78, 159)"
19809,2020-04-09,Niger,0,64,342,"rgb(118, 78, 159)"
19810,2020-04-10,Niger,0,68,410,"rgb(118, 78, 159)"
19811,2020-04-11,Niger,0,28,438,"rgb(118, 78, 159)"
19812,2020-04-12,Niger,0,53,491,"rgb(118, 78, 159)"
19813,2020-04-13,Niger,1,38,529,"rgb(118, 78, 159)"
19814,2020-04-14,Niger,1,19,548,"rgb(118, 78, 159)"
19815,2020-04-15,Niger,1,22,570,"rgb(118, 78, 159)"
19816,2020-04-16,Niger,0,14,584,"rgb(118, 78, 159)"
19817,2020-04-17,Niger,1,25,609,"rgb(118, 78, 159)"
19818,2020-04-18,Niger,3,18,627,"rgb(118, 78, 159)"
19819,2020-04-19,Niger,1,12,639,"rgb(118, 78, 159)"
19820,2020-04-20,Niger,1,9,648,"rgb(118, 78, 159)"
19821,2020-04-21,Niger,0,7,655,"rgb(118, 78, 159)"
19822,2020-04-22,Niger,0,0,655,"rgb(118, 78, 159)"
19823,2020-04-23,Niger,2,7,662,"rgb(118, 78, 159)"
19824,2020-04-24,Niger,2,9,671,"rgb(118, 78, 159)"
19825,2020-04-25,Niger,0,10,681,"rgb(118, 78, 159)"
19826,2020-04-26,Niger,3,3,684,"rgb(118, 78, 159)"
19827,2020-04-27,Niger,2,12,696,"rgb(118, 78, 159)"
19828,2020-04-28,Niger,0,5,701,"rgb(118, 78, 159)"
19829,2020-04-29,Niger,2,8,709,"rgb(118, 78, 159)"
19830,2020-04-30,Niger,1,4,713,"rgb(118, 78, 159)"
19831,2020-05-01,Niger,0,6,719,"rgb(118, 78, 159)"
19832,2020-05-02,Niger,1,9,728,"rgb(118, 78, 159)"
19833,2020-05-03,Niger,2,8,736,"rgb(118, 78, 159)"
19834,2020-05-04,Niger,1,14,750,"rgb(118, 78, 159)"
19835,2020-05-05,Niger,1,5,755,"rgb(118, 78, 159)"
19836,2020-05-06,Niger,1,8,763,"rgb(118, 78, 159)"
19837,2020-05-07,Niger,0,7,770,"rgb(118, 78, 159)"
19838,2020-05-08,Niger,4,11,781,"rgb(118, 78, 159)"
19839,2020-05-09,Niger,2,14,795,"rgb(118, 78, 159)"
19840,2020-05-10,Niger,1,20,815,"rgb(118, 78, 159)"
19841,2020-05-11,Niger,1,6,821,"rgb(118, 78, 159)"
19842,2020-05-12,Niger,0,11,832,"rgb(118, 78, 159)"
19843,2020-05-13,Niger,1,22,854,"rgb(118, 78, 159)"
19844,2020-05-14,Niger,2,6,860,"rgb(118, 78, 159)"
19845,2020-05-15,Niger,1,16,876,"rgb(118, 78, 159)"
19846,2020-05-16,Niger,1,9,885,"rgb(118, 78, 159)"
19847,2020-05-17,Niger,0,4,889,"rgb(118, 78, 159)"
19848,2020-05-18,Niger,3,15,904,"rgb(118, 78, 159)"
19849,2020-05-19,Niger,1,5,909,"rgb(118, 78, 159)"
19850,2020-05-20,Niger,0,5,914,"rgb(118, 78, 159)"
19851,2020-05-21,Niger,3,6,920,"rgb(118, 78, 159)"
19852,2020-05-22,Niger,2,4,924,"rgb(118, 78, 159)"
19853,2020-05-23,Niger,0,13,937,"rgb(118, 78, 159)"
19854,2020-05-24,Niger,1,6,943,"rgb(118, 78, 159)"
19855,2020-05-25,Niger,0,2,945,"rgb(118, 78, 159)"
19856,2020-05-26,Niger,1,6,951,"rgb(118, 78, 159)"
19857,2020-05-27,Niger,1,1,952,"rgb(118, 78, 159)"
19858,2020-05-28,Niger,1,3,955,"rgb(118, 78, 159)"
19859,2020-05-29,Niger,0,0,955,"rgb(118, 78, 159)"
19860,2020-05-30,Niger,0,0,955,"rgb(118, 78, 159)"
19861,2020-05-31,Niger,0,1,956,"rgb(118, 78, 159)"
19862,2020-06-01,Niger,0,2,958,"rgb(118, 78, 159)"
19863,2020-06-02,Niger,1,0,958,"rgb(118, 78, 159)"
19864,2020-06-03,Niger,0,2,960,"rgb(118, 78, 159)"
19865,2020-06-04,Niger,0,1,961,"rgb(118, 78, 159)"
19866,2020-06-05,Niger,0,2,963,"rgb(118, 78, 159)"
19867,2020-06-06,Niger,0,3,966,"rgb(118, 78, 159)"
19868,2020-06-07,Niger,0,4,970,"rgb(118, 78, 159)"
19869,2020-06-08,Niger,0,3,973,"rgb(118, 78, 159)"
19870,2020-06-09,Niger,0,0,973,"rgb(118, 78, 159)"
19871,2020-06-10,Niger,0,1,974,"rgb(118, 78, 159)"
19872,2020-06-11,Niger,0,0,974,"rgb(118, 78, 159)"
19873,2020-06-12,Niger,0,0,974,"rgb(118, 78, 159)"
19874,2020-06-13,Niger,0,4,978,"rgb(118, 78, 159)"
19875,2020-06-14,Niger,1,2,980,"rgb(118, 78, 159)"
19876,2020-06-15,Niger,0,0,980,"rgb(118, 78, 159)"
19877,2020-06-16,Niger,0,0,980,"rgb(118, 78, 159)"
19878,2020-06-17,Niger,0,36,1016,"rgb(118, 78, 159)"
19879,2020-06-18,Niger,1,4,1020,"rgb(118, 78, 159)"
19880,2020-06-19,Niger,0,0,1020,"rgb(118, 78, 159)"
19881,2020-06-20,Niger,0,0,1020,"rgb(118, 78, 159)"
19882,2020-06-21,Niger,0,15,1035,"rgb(118, 78, 159)"
19883,2020-06-22,Niger,0,1,1036,"rgb(118, 78, 159)"
19884,2020-06-23,Niger,0,10,1046,"rgb(118, 78, 159)"
19885,2020-06-24,Niger,0,5,1051,"rgb(118, 78, 159)"
19886,2020-06-25,Niger,0,5,1056,"rgb(118, 78, 159)"
19887,2020-06-26,Niger,0,3,1059,"rgb(118, 78, 159)"
19888,2020-06-27,Niger,0,3,1062,"rgb(118, 78, 159)"
19889,2020-06-28,Niger,0,6,1068,"rgb(118, 78, 159)"
19890,2020-06-29,Niger,0,6,1074,"rgb(118, 78, 159)"
19891,2020-06-30,Niger,0,1,1075,"rgb(118, 78, 159)"
19892,2020-07-01,Niger,0,0,1075,"rgb(118, 78, 159)"
19893,2020-07-02,Niger,0,0,1075,"rgb(118, 78, 159)"
19894,2020-07-03,Niger,1,6,1081,"rgb(118, 78, 159)"
19895,2020-07-04,Niger,0,1,1082,"rgb(118, 78, 159)"
19896,2020-07-05,Niger,0,0,1082,"rgb(118, 78, 159)"
19897,2020-07-06,Niger,0,11,1093,"rgb(118, 78, 159)"
19898,2020-07-07,Niger,0,0,1093,"rgb(118, 78, 159)"
19899,2020-07-08,Niger,0,1,1094,"rgb(118, 78, 159)"
19900,2020-07-09,Niger,0,3,1097,"rgb(118, 78, 159)"
19901,2020-07-10,Niger,0,0,1097,"rgb(118, 78, 159)"
19902,2020-07-11,Niger,0,2,1099,"rgb(118, 78, 159)"
19903,2020-07-12,Niger,0,0,1099,"rgb(118, 78, 159)"
19904,2020-07-13,Niger,0,0,1099,"rgb(118, 78, 159)"
19905,2019-12-31,Nigeria,0,0,0,"rgb(237, 100, 90)"
19906,2020-01-01,Nigeria,0,0,0,"rgb(237, 100, 90)"
19907,2020-01-02,Nigeria,0,0,0,"rgb(237, 100, 90)"
19908,2020-01-03,Nigeria,0,0,0,"rgb(237, 100, 90)"
19909,2020-01-04,Nigeria,0,0,0,"rgb(237, 100, 90)"
19910,2020-01-05,Nigeria,0,0,0,"rgb(237, 100, 90)"
19911,2020-01-06,Nigeria,0,0,0,"rgb(237, 100, 90)"
19912,2020-01-07,Nigeria,0,0,0,"rgb(237, 100, 90)"
19913,2020-01-08,Nigeria,0,0,0,"rgb(237, 100, 90)"
19914,2020-01-09,Nigeria,0,0,0,"rgb(237, 100, 90)"
19915,2020-01-10,Nigeria,0,0,0,"rgb(237, 100, 90)"
19916,2020-01-11,Nigeria,0,0,0,"rgb(237, 100, 90)"
19917,2020-01-12,Nigeria,0,0,0,"rgb(237, 100, 90)"
19918,2020-01-13,Nigeria,0,0,0,"rgb(237, 100, 90)"
19919,2020-01-14,Nigeria,0,0,0,"rgb(237, 100, 90)"
19920,2020-01-15,Nigeria,0,0,0,"rgb(237, 100, 90)"
19921,2020-01-16,Nigeria,0,0,0,"rgb(237, 100, 90)"
19922,2020-01-17,Nigeria,0,0,0,"rgb(237, 100, 90)"
19923,2020-01-18,Nigeria,0,0,0,"rgb(237, 100, 90)"
19924,2020-01-19,Nigeria,0,0,0,"rgb(237, 100, 90)"
19925,2020-01-20,Nigeria,0,0,0,"rgb(237, 100, 90)"
19926,2020-01-21,Nigeria,0,0,0,"rgb(237, 100, 90)"
19927,2020-01-22,Nigeria,0,0,0,"rgb(237, 100, 90)"
19928,2020-01-23,Nigeria,0,0,0,"rgb(237, 100, 90)"
19929,2020-01-24,Nigeria,0,0,0,"rgb(237, 100, 90)"
19930,2020-01-25,Nigeria,0,0,0,"rgb(237, 100, 90)"
19931,2020-01-26,Nigeria,0,0,0,"rgb(237, 100, 90)"
19932,2020-01-27,Nigeria,0,0,0,"rgb(237, 100, 90)"
19933,2020-01-28,Nigeria,0,0,0,"rgb(237, 100, 90)"
19934,2020-01-29,Nigeria,0,0,0,"rgb(237, 100, 90)"
19935,2020-01-30,Nigeria,0,0,0,"rgb(237, 100, 90)"
19936,2020-01-31,Nigeria,0,0,0,"rgb(237, 100, 90)"
19937,2020-02-01,Nigeria,0,0,0,"rgb(237, 100, 90)"
19938,2020-02-02,Nigeria,0,0,0,"rgb(237, 100, 90)"
19939,2020-02-03,Nigeria,0,0,0,"rgb(237, 100, 90)"
19940,2020-02-04,Nigeria,0,0,0,"rgb(237, 100, 90)"
19941,2020-02-05,Nigeria,0,0,0,"rgb(237, 100, 90)"
19942,2020-02-06,Nigeria,0,0,0,"rgb(237, 100, 90)"
19943,2020-02-07,Nigeria,0,0,0,"rgb(237, 100, 90)"
19944,2020-02-08,Nigeria,0,0,0,"rgb(237, 100, 90)"
19945,2020-02-09,Nigeria,0,0,0,"rgb(237, 100, 90)"
19946,2020-02-10,Nigeria,0,0,0,"rgb(237, 100, 90)"
19947,2020-02-11,Nigeria,0,0,0,"rgb(237, 100, 90)"
19948,2020-02-12,Nigeria,0,0,0,"rgb(237, 100, 90)"
19949,2020-02-13,Nigeria,0,0,0,"rgb(237, 100, 90)"
19950,2020-02-14,Nigeria,0,0,0,"rgb(237, 100, 90)"
19951,2020-02-15,Nigeria,0,0,0,"rgb(237, 100, 90)"
19952,2020-02-16,Nigeria,0,0,0,"rgb(237, 100, 90)"
19953,2020-02-17,Nigeria,0,0,0,"rgb(237, 100, 90)"
19954,2020-02-18,Nigeria,0,0,0,"rgb(237, 100, 90)"
19955,2020-02-19,Nigeria,0,0,0,"rgb(237, 100, 90)"
19956,2020-02-20,Nigeria,0,0,0,"rgb(237, 100, 90)"
19957,2020-02-21,Nigeria,0,0,0,"rgb(237, 100, 90)"
19958,2020-02-22,Nigeria,0,0,0,"rgb(237, 100, 90)"
19959,2020-02-23,Nigeria,0,0,0,"rgb(237, 100, 90)"
19960,2020-02-24,Nigeria,0,0,0,"rgb(237, 100, 90)"
19961,2020-02-25,Nigeria,0,0,0,"rgb(237, 100, 90)"
19962,2020-02-26,Nigeria,0,0,0,"rgb(237, 100, 90)"
19963,2020-02-27,Nigeria,0,0,0,"rgb(237, 100, 90)"
19964,2020-02-28,Nigeria,0,1,1,"rgb(237, 100, 90)"
19965,2020-02-29,Nigeria,0,0,1,"rgb(237, 100, 90)"
19966,2020-03-01,Nigeria,0,0,1,"rgb(237, 100, 90)"
19967,2020-03-02,Nigeria,0,0,1,"rgb(237, 100, 90)"
19968,2020-03-10,Nigeria,0,1,2,"rgb(237, 100, 90)"
19969,2020-03-15,Nigeria,0,0,2,"rgb(237, 100, 90)"
19970,2020-03-16,Nigeria,0,0,2,"rgb(237, 100, 90)"
19971,2020-03-17,Nigeria,0,0,2,"rgb(237, 100, 90)"
19972,2020-03-18,Nigeria,0,1,3,"rgb(237, 100, 90)"
19973,2020-03-19,Nigeria,0,5,8,"rgb(237, 100, 90)"
19974,2020-03-20,Nigeria,0,0,8,"rgb(237, 100, 90)"
19975,2020-03-21,Nigeria,0,4,12,"rgb(237, 100, 90)"
19976,2020-03-22,Nigeria,0,10,22,"rgb(237, 100, 90)"
19977,2020-03-23,Nigeria,0,8,30,"rgb(237, 100, 90)"
19978,2020-03-24,Nigeria,1,10,40,"rgb(237, 100, 90)"
19979,2020-03-25,Nigeria,0,4,44,"rgb(237, 100, 90)"
19980,2020-03-26,Nigeria,0,7,51,"rgb(237, 100, 90)"
19981,2020-03-27,Nigeria,0,14,65,"rgb(237, 100, 90)"
19982,2020-03-28,Nigeria,0,16,81,"rgb(237, 100, 90)"
19983,2020-03-29,Nigeria,0,16,97,"rgb(237, 100, 90)"
19984,2020-03-30,Nigeria,0,0,97,"rgb(237, 100, 90)"
19985,2020-03-31,Nigeria,1,34,131,"rgb(237, 100, 90)"
19986,2020-04-01,Nigeria,0,0,131,"rgb(237, 100, 90)"
19987,2020-04-02,Nigeria,0,20,151,"rgb(237, 100, 90)"
19988,2020-04-03,Nigeria,0,23,174,"rgb(237, 100, 90)"
19989,2020-04-04,Nigeria,0,16,190,"rgb(237, 100, 90)"
19990,2020-04-05,Nigeria,2,20,210,"rgb(237, 100, 90)"
19991,2020-04-06,Nigeria,1,22,232,"rgb(237, 100, 90)"
19992,2020-04-07,Nigeria,0,6,238,"rgb(237, 100, 90)"
19993,2020-04-08,Nigeria,1,16,254,"rgb(237, 100, 90)"
19994,2020-04-09,Nigeria,0,22,276,"rgb(237, 100, 90)"
19995,2020-04-10,Nigeria,1,12,288,"rgb(237, 100, 90)"
19996,2020-04-11,Nigeria,0,17,305,"rgb(237, 100, 90)"
19997,2020-04-12,Nigeria,3,13,318,"rgb(237, 100, 90)"
19998,2020-04-13,Nigeria,0,5,323,"rgb(237, 100, 90)"
19999,2020-04-14,Nigeria,0,20,343,"rgb(237, 100, 90)"
20000,2020-04-15,Nigeria,1,30,373,"rgb(237, 100, 90)"
20001,2020-04-16,Nigeria,1,34,407,"rgb(237, 100, 90)"
20002,2020-04-17,Nigeria,1,35,442,"rgb(237, 100, 90)"
20003,2020-04-18,Nigeria,4,51,493,"rgb(237, 100, 90)"
20004,2020-04-19,Nigeria,2,49,542,"rgb(237, 100, 90)"
20005,2020-04-20,Nigeria,2,85,627,"rgb(237, 100, 90)"
20006,2020-04-21,Nigeria,1,38,665,"rgb(237, 100, 90)"
20007,2020-04-22,Nigeria,3,117,782,"rgb(237, 100, 90)"
20008,2020-04-23,Nigeria,3,91,873,"rgb(237, 100, 90)"
20009,2020-04-24,Nigeria,3,108,981,"rgb(237, 100, 90)"
20010,2020-04-25,Nigeria,1,114,1095,"rgb(237, 100, 90)"
20011,2020-04-26,Nigeria,3,87,1182,"rgb(237, 100, 90)"
20012,2020-04-27,Nigeria,5,91,1273,"rgb(237, 100, 90)"
20013,2020-04-28,Nigeria,0,64,1337,"rgb(237, 100, 90)"
20014,2020-04-29,Nigeria,4,195,1532,"rgb(237, 100, 90)"
20015,2020-04-30,Nigeria,7,196,1728,"rgb(237, 100, 90)"
20016,2020-05-01,Nigeria,7,204,1932,"rgb(237, 100, 90)"
20017,2020-05-02,Nigeria,10,238,2170,"rgb(237, 100, 90)"
20018,2020-05-03,Nigeria,17,218,2388,"rgb(237, 100, 90)"
20019,2020-05-04,Nigeria,2,170,2558,"rgb(237, 100, 90)"
20020,2020-05-05,Nigeria,6,244,2802,"rgb(237, 100, 90)"
20021,2020-05-06,Nigeria,5,148,2950,"rgb(237, 100, 90)"
20022,2020-05-07,Nigeria,5,195,3145,"rgb(237, 100, 90)"
20023,2020-05-08,Nigeria,4,381,3526,"rgb(237, 100, 90)"
20024,2020-05-09,Nigeria,10,386,3912,"rgb(237, 100, 90)"
20025,2020-05-10,Nigeria,11,239,4151,"rgb(237, 100, 90)"
20026,2020-05-11,Nigeria,15,248,4399,"rgb(237, 100, 90)"
20027,2020-05-12,Nigeria,7,242,4641,"rgb(237, 100, 90)"
20028,2020-05-13,Nigeria,8,146,4787,"rgb(237, 100, 90)"
20029,2020-05-14,Nigeria,6,184,4971,"rgb(237, 100, 90)"
20030,2020-05-15,Nigeria,3,191,5162,"rgb(237, 100, 90)"
20031,2020-05-16,Nigeria,4,283,5445,"rgb(237, 100, 90)"
20032,2020-05-17,Nigeria,5,176,5621,"rgb(237, 100, 90)"
20033,2020-05-18,Nigeria,6,338,5959,"rgb(237, 100, 90)"
20034,2020-05-19,Nigeria,9,216,6175,"rgb(237, 100, 90)"
20035,2020-05-20,Nigeria,1,226,6401,"rgb(237, 100, 90)"
20036,2020-05-21,Nigeria,8,276,6677,"rgb(237, 100, 90)"
20037,2020-05-22,Nigeria,11,339,7016,"rgb(237, 100, 90)"
20038,2020-05-23,Nigeria,10,245,7261,"rgb(237, 100, 90)"
20039,2020-05-24,Nigeria,0,265,7526,"rgb(237, 100, 90)"
20040,2020-05-25,Nigeria,5,313,7839,"rgb(237, 100, 90)"
20041,2020-05-26,Nigeria,7,229,8068,"rgb(237, 100, 90)"
20042,2020-05-27,Nigeria,16,276,8344,"rgb(237, 100, 90)"
20043,2020-05-28,Nigeria,5,389,8733,"rgb(237, 100, 90)"
20044,2020-05-29,Nigeria,5,182,8915,"rgb(237, 100, 90)"
20045,2020-05-30,Nigeria,2,387,9302,"rgb(237, 100, 90)"
20046,2020-05-31,Nigeria,12,553,9855,"rgb(237, 100, 90)"
20047,2020-06-01,Nigeria,14,307,10162,"rgb(237, 100, 90)"
20048,2020-06-02,Nigeria,12,416,10578,"rgb(237, 100, 90)"
20049,2020-06-03,Nigeria,15,241,10819,"rgb(237, 100, 90)"
20050,2020-06-04,Nigeria,1,347,11166,"rgb(237, 100, 90)"
20051,2020-06-05,Nigeria,8,350,11516,"rgb(237, 100, 90)"
20052,2020-06-06,Nigeria,10,328,11844,"rgb(237, 100, 90)"
20053,2020-06-07,Nigeria,9,389,12233,"rgb(237, 100, 90)"
20054,2020-06-08,Nigeria,12,253,12486,"rgb(237, 100, 90)"
20055,2020-06-09,Nigeria,7,315,12801,"rgb(237, 100, 90)"
20056,2020-06-10,Nigeria,4,663,13464,"rgb(237, 100, 90)"
20057,2020-06-11,Nigeria,17,409,13873,"rgb(237, 100, 90)"
20058,2020-06-12,Nigeria,5,681,14554,"rgb(237, 100, 90)"
20059,2020-06-13,Nigeria,12,627,15181,"rgb(237, 100, 90)"
20060,2020-06-14,Nigeria,8,501,15682,"rgb(237, 100, 90)"
20061,2020-06-15,Nigeria,13,403,16085,"rgb(237, 100, 90)"
20062,2020-06-16,Nigeria,4,573,16658,"rgb(237, 100, 90)"
20063,2020-06-17,Nigeria,31,490,17148,"rgb(237, 100, 90)"
20064,2020-06-18,Nigeria,14,587,17735,"rgb(237, 100, 90)"
20065,2020-06-19,Nigeria,6,745,18480,"rgb(237, 100, 90)"
20066,2020-06-20,Nigeria,12,667,19147,"rgb(237, 100, 90)"
20067,2020-06-21,Nigeria,19,661,19808,"rgb(237, 100, 90)"
20068,2020-06-22,Nigeria,12,436,20244,"rgb(237, 100, 90)"
20069,2020-06-23,Nigeria,7,675,20919,"rgb(237, 100, 90)"
20070,2020-06-24,Nigeria,8,452,21371,"rgb(237, 100, 90)"
20071,2020-06-25,Nigeria,9,649,22020,"rgb(237, 100, 90)"
20072,2020-06-26,Nigeria,7,594,22614,"rgb(237, 100, 90)"
20073,2020-06-27,Nigeria,5,684,23298,"rgb(237, 100, 90)"
20074,2020-06-28,Nigeria,4,779,24077,"rgb(237, 100, 90)"
20075,2020-06-29,Nigeria,7,490,24567,"rgb(237, 100, 90)"
20076,2020-06-30,Nigeria,8,566,25133,"rgb(237, 100, 90)"
20077,2020-07-01,Nigeria,17,561,25694,"rgb(237, 100, 90)"
20078,2020-07-02,Nigeria,13,790,26484,"rgb(237, 100, 90)"
20079,2020-07-03,Nigeria,13,626,27110,"rgb(237, 100, 90)"
20080,2020-07-04,Nigeria,12,454,27564,"rgb(237, 100, 90)"
20081,2020-07-05,Nigeria,6,603,28167,"rgb(237, 100, 90)"
20082,2020-07-06,Nigeria,11,544,28711,"rgb(237, 100, 90)"
20083,2020-07-07,Nigeria,9,575,29286,"rgb(237, 100, 90)"
20084,2020-07-08,Nigeria,15,503,29789,"rgb(237, 100, 90)"
20085,2020-07-09,Nigeria,15,460,30249,"rgb(237, 100, 90)"
20086,2020-07-10,Nigeria,5,499,30748,"rgb(237, 100, 90)"
20087,2020-07-11,Nigeria,20,575,31323,"rgb(237, 100, 90)"
20088,2020-07-12,Nigeria,15,664,31987,"rgb(237, 100, 90)"
20089,2020-07-13,Nigeria,16,571,32558,"rgb(237, 100, 90)"
20090,2020-03-19,Nicaragua,0,1,1,"rgb(165, 170, 153)"
20091,2020-03-20,Nicaragua,0,0,1,"rgb(165, 170, 153)"
20092,2020-03-21,Nicaragua,0,1,2,"rgb(165, 170, 153)"
20093,2020-03-22,Nicaragua,0,0,2,"rgb(165, 170, 153)"
20094,2020-03-23,Nicaragua,0,0,2,"rgb(165, 170, 153)"
20095,2020-03-24,Nicaragua,0,0,2,"rgb(165, 170, 153)"
20096,2020-03-25,Nicaragua,0,0,2,"rgb(165, 170, 153)"
20097,2020-03-26,Nicaragua,0,0,2,"rgb(165, 170, 153)"
20098,2020-03-27,Nicaragua,0,0,2,"rgb(165, 170, 153)"
20099,2020-03-28,Nicaragua,1,0,2,"rgb(165, 170, 153)"
20100,2020-03-29,Nicaragua,0,2,4,"rgb(165, 170, 153)"
20101,2020-03-30,Nicaragua,0,0,4,"rgb(165, 170, 153)"
20102,2020-03-31,Nicaragua,0,0,4,"rgb(165, 170, 153)"
20103,2020-04-01,Nicaragua,0,0,4,"rgb(165, 170, 153)"
20104,2020-04-02,Nicaragua,0,1,5,"rgb(165, 170, 153)"
20105,2020-04-03,Nicaragua,0,0,5,"rgb(165, 170, 153)"
20106,2020-04-04,Nicaragua,0,0,5,"rgb(165, 170, 153)"
20107,2020-04-05,Nicaragua,0,0,5,"rgb(165, 170, 153)"
20108,2020-04-06,Nicaragua,0,0,5,"rgb(165, 170, 153)"
20109,2020-04-07,Nicaragua,0,1,6,"rgb(165, 170, 153)"
20110,2020-04-08,Nicaragua,0,0,6,"rgb(165, 170, 153)"
20111,2020-04-09,Nicaragua,0,0,6,"rgb(165, 170, 153)"
20112,2020-04-10,Nicaragua,0,0,6,"rgb(165, 170, 153)"
20113,2020-04-11,Nicaragua,0,1,7,"rgb(165, 170, 153)"
20114,2020-04-12,Nicaragua,0,0,7,"rgb(165, 170, 153)"
20115,2020-04-13,Nicaragua,0,2,9,"rgb(165, 170, 153)"
20116,2020-04-14,Nicaragua,0,0,9,"rgb(165, 170, 153)"
20117,2020-04-15,Nicaragua,0,0,9,"rgb(165, 170, 153)"
20118,2020-04-16,Nicaragua,0,0,9,"rgb(165, 170, 153)"
20119,2020-04-17,Nicaragua,0,0,9,"rgb(165, 170, 153)"
20120,2020-04-18,Nicaragua,0,0,9,"rgb(165, 170, 153)"
20121,2020-04-19,Nicaragua,0,0,9,"rgb(165, 170, 153)"
20122,2020-04-20,Nicaragua,0,0,9,"rgb(165, 170, 153)"
20123,2020-04-21,Nicaragua,1,0,9,"rgb(165, 170, 153)"
20124,2020-04-22,Nicaragua,0,1,10,"rgb(165, 170, 153)"
20125,2020-04-23,Nicaragua,0,0,10,"rgb(165, 170, 153)"
20126,2020-04-24,Nicaragua,0,0,10,"rgb(165, 170, 153)"
20127,2020-04-25,Nicaragua,1,1,11,"rgb(165, 170, 153)"
20128,2020-04-26,Nicaragua,0,1,12,"rgb(165, 170, 153)"
20129,2020-04-27,Nicaragua,0,1,13,"rgb(165, 170, 153)"
20130,2020-04-28,Nicaragua,0,0,13,"rgb(165, 170, 153)"
20131,2020-04-29,Nicaragua,0,0,13,"rgb(165, 170, 153)"
20132,2020-04-30,Nicaragua,1,1,14,"rgb(165, 170, 153)"
20133,2020-05-01,Nicaragua,0,0,14,"rgb(165, 170, 153)"
20134,2020-05-02,Nicaragua,0,0,14,"rgb(165, 170, 153)"
20135,2020-05-03,Nicaragua,0,0,14,"rgb(165, 170, 153)"
20136,2020-05-04,Nicaragua,1,0,14,"rgb(165, 170, 153)"
20137,2020-05-05,Nicaragua,0,1,15,"rgb(165, 170, 153)"
20138,2020-05-06,Nicaragua,0,1,16,"rgb(165, 170, 153)"
20139,2020-05-07,Nicaragua,0,0,16,"rgb(165, 170, 153)"
20140,2020-05-08,Nicaragua,0,0,16,"rgb(165, 170, 153)"
20141,2020-05-09,Nicaragua,0,0,16,"rgb(165, 170, 153)"
20142,2020-05-10,Nicaragua,0,0,16,"rgb(165, 170, 153)"
20143,2020-05-11,Nicaragua,0,0,16,"rgb(165, 170, 153)"
20144,2020-05-12,Nicaragua,0,0,16,"rgb(165, 170, 153)"
20145,2020-05-13,Nicaragua,3,9,25,"rgb(165, 170, 153)"
20146,2020-05-14,Nicaragua,0,0,25,"rgb(165, 170, 153)"
20147,2020-05-15,Nicaragua,0,0,25,"rgb(165, 170, 153)"
20148,2020-05-16,Nicaragua,0,0,25,"rgb(165, 170, 153)"
20149,2020-05-17,Nicaragua,0,0,25,"rgb(165, 170, 153)"
20150,2020-05-18,Nicaragua,0,0,25,"rgb(165, 170, 153)"
20151,2020-05-19,Nicaragua,0,0,25,"rgb(165, 170, 153)"
20152,2020-05-20,Nicaragua,0,0,25,"rgb(165, 170, 153)"
20153,2020-05-21,Nicaragua,0,0,25,"rgb(165, 170, 153)"
20154,2020-05-22,Nicaragua,0,0,25,"rgb(165, 170, 153)"
20155,2020-05-23,Nicaragua,9,254,279,"rgb(165, 170, 153)"
20156,2020-05-24,Nicaragua,0,0,279,"rgb(165, 170, 153)"
20157,2020-05-25,Nicaragua,0,0,279,"rgb(165, 170, 153)"
20158,2020-05-26,Nicaragua,0,0,279,"rgb(165, 170, 153)"
20159,2020-05-27,Nicaragua,18,480,759,"rgb(165, 170, 153)"
20160,2020-05-28,Nicaragua,0,0,759,"rgb(165, 170, 153)"
20161,2020-05-29,Nicaragua,0,0,759,"rgb(165, 170, 153)"
20162,2020-05-30,Nicaragua,0,0,759,"rgb(165, 170, 153)"
20163,2020-05-31,Nicaragua,0,0,759,"rgb(165, 170, 153)"
20164,2020-06-01,Nicaragua,0,0,759,"rgb(165, 170, 153)"
20165,2020-06-02,Nicaragua,0,0,759,"rgb(165, 170, 153)"
20166,2020-06-03,Nicaragua,11,359,1118,"rgb(165, 170, 153)"
20167,2020-06-04,Nicaragua,0,0,1118,"rgb(165, 170, 153)"
20168,2020-06-05,Nicaragua,0,0,1118,"rgb(165, 170, 153)"
20169,2020-06-06,Nicaragua,0,0,1118,"rgb(165, 170, 153)"
20170,2020-06-07,Nicaragua,0,191,1309,"rgb(165, 170, 153)"
20171,2020-06-08,Nicaragua,0,0,1309,"rgb(165, 170, 153)"
20172,2020-06-09,Nicaragua,0,0,1309,"rgb(165, 170, 153)"
20173,2020-06-10,Nicaragua,0,0,1309,"rgb(165, 170, 153)"
20174,2020-06-11,Nicaragua,9,155,1464,"rgb(165, 170, 153)"
20175,2020-06-12,Nicaragua,0,0,1464,"rgb(165, 170, 153)"
20176,2020-06-13,Nicaragua,0,191,1655,"rgb(165, 170, 153)"
20177,2020-06-14,Nicaragua,0,0,1655,"rgb(165, 170, 153)"
20178,2020-06-15,Nicaragua,0,0,1655,"rgb(165, 170, 153)"
20179,2020-06-16,Nicaragua,0,0,1655,"rgb(165, 170, 153)"
20180,2020-06-17,Nicaragua,9,168,1823,"rgb(165, 170, 153)"
20181,2020-06-18,Nicaragua,0,191,2014,"rgb(165, 170, 153)"
20182,2020-06-19,Nicaragua,0,0,2014,"rgb(165, 170, 153)"
20183,2020-06-20,Nicaragua,0,0,2014,"rgb(165, 170, 153)"
20184,2020-06-21,Nicaragua,0,0,2014,"rgb(165, 170, 153)"
20185,2020-06-22,Nicaragua,0,0,2014,"rgb(165, 170, 153)"
20186,2020-06-23,Nicaragua,0,0,2014,"rgb(165, 170, 153)"
20187,2020-06-24,Nicaragua,10,156,2170,"rgb(165, 170, 153)"
20188,2020-06-25,Nicaragua,0,0,2170,"rgb(165, 170, 153)"
20189,2020-06-26,Nicaragua,0,0,2170,"rgb(165, 170, 153)"
20190,2020-06-27,Nicaragua,0,0,2170,"rgb(165, 170, 153)"
20191,2020-06-28,Nicaragua,0,0,2170,"rgb(165, 170, 153)"
20192,2020-06-29,Nicaragua,0,0,2170,"rgb(165, 170, 153)"
20193,2020-06-30,Nicaragua,0,0,2170,"rgb(165, 170, 153)"
20194,2020-07-01,Nicaragua,9,349,2519,"rgb(165, 170, 153)"
20195,2020-07-02,Nicaragua,0,0,2519,"rgb(165, 170, 153)"
20196,2020-07-03,Nicaragua,0,0,2519,"rgb(165, 170, 153)"
20197,2020-07-04,Nicaragua,0,0,2519,"rgb(165, 170, 153)"
20198,2020-07-05,Nicaragua,0,0,2519,"rgb(165, 170, 153)"
20199,2020-07-06,Nicaragua,0,0,2519,"rgb(165, 170, 153)"
20200,2020-07-07,Nicaragua,0,0,2519,"rgb(165, 170, 153)"
20201,2020-07-08,Nicaragua,8,327,2846,"rgb(165, 170, 153)"
20202,2020-07-09,Nicaragua,0,0,2846,"rgb(165, 170, 153)"
20203,2020-07-10,Nicaragua,0,0,2846,"rgb(165, 170, 153)"
20204,2020-07-11,Nicaragua,0,0,2846,"rgb(165, 170, 153)"
20205,2020-07-12,Nicaragua,0,0,2846,"rgb(165, 170, 153)"
20206,2020-07-13,Nicaragua,0,0,2846,"rgb(165, 170, 153)"
20207,2019-12-31,Netherlands,0,0,0,"rgb(27,158,119)"
20208,2020-01-01,Netherlands,0,0,0,"rgb(27,158,119)"
20209,2020-01-02,Netherlands,0,0,0,"rgb(27,158,119)"
20210,2020-01-03,Netherlands,0,0,0,"rgb(27,158,119)"
20211,2020-01-04,Netherlands,0,0,0,"rgb(27,158,119)"
20212,2020-01-05,Netherlands,0,0,0,"rgb(27,158,119)"
20213,2020-01-06,Netherlands,0,0,0,"rgb(27,158,119)"
20214,2020-01-07,Netherlands,0,0,0,"rgb(27,158,119)"
20215,2020-01-08,Netherlands,0,0,0,"rgb(27,158,119)"
20216,2020-01-09,Netherlands,0,0,0,"rgb(27,158,119)"
20217,2020-01-10,Netherlands,0,0,0,"rgb(27,158,119)"
20218,2020-01-11,Netherlands,0,0,0,"rgb(27,158,119)"
20219,2020-01-12,Netherlands,0,0,0,"rgb(27,158,119)"
20220,2020-01-13,Netherlands,0,0,0,"rgb(27,158,119)"
20221,2020-01-14,Netherlands,0,0,0,"rgb(27,158,119)"
20222,2020-01-15,Netherlands,0,0,0,"rgb(27,158,119)"
20223,2020-01-16,Netherlands,0,0,0,"rgb(27,158,119)"
20224,2020-01-17,Netherlands,0,0,0,"rgb(27,158,119)"
20225,2020-01-18,Netherlands,0,0,0,"rgb(27,158,119)"
20226,2020-01-19,Netherlands,0,0,0,"rgb(27,158,119)"
20227,2020-01-20,Netherlands,0,0,0,"rgb(27,158,119)"
20228,2020-01-21,Netherlands,0,0,0,"rgb(27,158,119)"
20229,2020-01-22,Netherlands,0,0,0,"rgb(27,158,119)"
20230,2020-01-23,Netherlands,0,0,0,"rgb(27,158,119)"
20231,2020-01-24,Netherlands,0,0,0,"rgb(27,158,119)"
20232,2020-01-25,Netherlands,0,0,0,"rgb(27,158,119)"
20233,2020-01-26,Netherlands,0,0,0,"rgb(27,158,119)"
20234,2020-01-27,Netherlands,0,0,0,"rgb(27,158,119)"
20235,2020-01-28,Netherlands,0,0,0,"rgb(27,158,119)"
20236,2020-01-29,Netherlands,0,0,0,"rgb(27,158,119)"
20237,2020-01-30,Netherlands,0,0,0,"rgb(27,158,119)"
20238,2020-01-31,Netherlands,0,0,0,"rgb(27,158,119)"
20239,2020-02-01,Netherlands,0,0,0,"rgb(27,158,119)"
20240,2020-02-02,Netherlands,0,0,0,"rgb(27,158,119)"
20241,2020-02-03,Netherlands,0,0,0,"rgb(27,158,119)"
20242,2020-02-04,Netherlands,0,0,0,"rgb(27,158,119)"
20243,2020-02-05,Netherlands,0,0,0,"rgb(27,158,119)"
20244,2020-02-06,Netherlands,0,0,0,"rgb(27,158,119)"
20245,2020-02-07,Netherlands,0,0,0,"rgb(27,158,119)"
20246,2020-02-08,Netherlands,0,0,0,"rgb(27,158,119)"
20247,2020-02-09,Netherlands,0,0,0,"rgb(27,158,119)"
20248,2020-02-10,Netherlands,0,0,0,"rgb(27,158,119)"
20249,2020-02-11,Netherlands,0,0,0,"rgb(27,158,119)"
20250,2020-02-12,Netherlands,0,0,0,"rgb(27,158,119)"
20251,2020-02-13,Netherlands,0,0,0,"rgb(27,158,119)"
20252,2020-02-14,Netherlands,0,0,0,"rgb(27,158,119)"
20253,2020-02-15,Netherlands,0,0,0,"rgb(27,158,119)"
20254,2020-02-16,Netherlands,0,0,0,"rgb(27,158,119)"
20255,2020-02-17,Netherlands,0,0,0,"rgb(27,158,119)"
20256,2020-02-18,Netherlands,0,0,0,"rgb(27,158,119)"
20257,2020-02-19,Netherlands,0,0,0,"rgb(27,158,119)"
20258,2020-02-20,Netherlands,0,0,0,"rgb(27,158,119)"
20259,2020-02-21,Netherlands,0,0,0,"rgb(27,158,119)"
20260,2020-02-22,Netherlands,0,0,0,"rgb(27,158,119)"
20261,2020-02-23,Netherlands,0,0,0,"rgb(27,158,119)"
20262,2020-02-24,Netherlands,0,0,0,"rgb(27,158,119)"
20263,2020-02-25,Netherlands,0,0,0,"rgb(27,158,119)"
20264,2020-02-26,Netherlands,0,0,0,"rgb(27,158,119)"
20265,2020-02-27,Netherlands,0,0,0,"rgb(27,158,119)"
20266,2020-02-28,Netherlands,0,1,1,"rgb(27,158,119)"
20267,2020-02-29,Netherlands,0,1,2,"rgb(27,158,119)"
20268,2020-03-01,Netherlands,0,5,7,"rgb(27,158,119)"
20269,2020-03-02,Netherlands,0,6,13,"rgb(27,158,119)"
20270,2020-03-03,Netherlands,0,5,18,"rgb(27,158,119)"
20271,2020-03-04,Netherlands,0,10,28,"rgb(27,158,119)"
20272,2020-03-05,Netherlands,0,10,38,"rgb(27,158,119)"
20273,2020-03-06,Netherlands,0,44,82,"rgb(27,158,119)"
20274,2020-03-07,Netherlands,1,46,128,"rgb(27,158,119)"
20275,2020-03-08,Netherlands,0,60,188,"rgb(27,158,119)"
20276,2020-03-09,Netherlands,2,77,265,"rgb(27,158,119)"
20277,2020-03-10,Netherlands,0,56,321,"rgb(27,158,119)"
20278,2020-03-11,Netherlands,1,61,382,"rgb(27,158,119)"
20279,2020-03-12,Netherlands,1,121,503,"rgb(27,158,119)"
20280,2020-03-13,Netherlands,0,111,614,"rgb(27,158,119)"
20281,2020-03-14,Netherlands,0,190,804,"rgb(27,158,119)"
20282,2020-03-15,Netherlands,7,155,959,"rgb(27,158,119)"
20283,2020-03-16,Netherlands,8,176,1135,"rgb(27,158,119)"
20284,2020-03-17,Netherlands,4,278,1413,"rgb(27,158,119)"
20285,2020-03-18,Netherlands,19,292,1705,"rgb(27,158,119)"
20286,2020-03-19,Netherlands,15,346,2051,"rgb(27,158,119)"
20287,2020-03-20,Netherlands,18,409,2460,"rgb(27,158,119)"
20288,2020-03-21,Netherlands,30,534,2994,"rgb(27,158,119)"
20289,2020-03-22,Netherlands,30,637,3631,"rgb(27,158,119)"
20290,2020-03-23,Netherlands,43,573,4204,"rgb(27,158,119)"
20291,2020-03-24,Netherlands,34,545,4749,"rgb(27,158,119)"
20292,2020-03-25,Netherlands,63,811,5560,"rgb(27,158,119)"
20293,2020-03-26,Netherlands,80,852,6412,"rgb(27,158,119)"
20294,2020-03-27,Netherlands,78,1019,7431,"rgb(27,158,119)"
20295,2020-03-28,Netherlands,112,1172,8603,"rgb(27,158,119)"
20296,2020-03-29,Netherlands,93,1159,9762,"rgb(27,158,119)"
20297,2020-03-30,Netherlands,132,1104,10866,"rgb(27,158,119)"
20298,2020-03-31,Netherlands,93,884,11750,"rgb(27,158,119)"
20299,2020-04-01,Netherlands,175,845,12595,"rgb(27,158,119)"
20300,2020-04-02,Netherlands,134,1019,13614,"rgb(27,158,119)"
20301,2020-04-03,Netherlands,166,1083,14697,"rgb(27,158,119)"
20302,2020-04-04,Netherlands,148,1026,15723,"rgb(27,158,119)"
20303,2020-04-05,Netherlands,164,904,16627,"rgb(27,158,119)"
20304,2020-04-06,Netherlands,115,1224,17851,"rgb(27,158,119)"
20305,2020-04-07,Netherlands,101,952,18803,"rgb(27,158,119)"
20306,2020-04-08,Netherlands,234,777,19580,"rgb(27,158,119)"
20307,2020-04-09,Netherlands,147,969,20549,"rgb(27,158,119)"
20308,2020-04-10,Netherlands,148,1213,21762,"rgb(27,158,119)"
20309,2020-04-11,Netherlands,115,1335,23097,"rgb(27,158,119)"
20310,2020-04-12,Netherlands,132,1316,24413,"rgb(27,158,119)"
20311,2020-04-13,Netherlands,94,1174,25587,"rgb(27,158,119)"
20312,2020-04-14,Netherlands,86,964,26551,"rgb(27,158,119)"
20313,2020-04-15,Netherlands,122,868,27419,"rgb(27,158,119)"
20314,2020-04-16,Netherlands,189,734,28153,"rgb(27,158,119)"
20315,2020-04-17,Netherlands,181,1061,29214,"rgb(27,158,119)"
20316,2020-04-18,Netherlands,144,1235,30449,"rgb(27,158,119)"
20317,2020-04-19,Netherlands,142,1140,31589,"rgb(27,158,119)"
20318,2020-04-20,Netherlands,83,1066,32655,"rgb(27,158,119)"
20319,2020-04-21,Netherlands,67,750,33405,"rgb(27,158,119)"
20320,2020-04-22,Netherlands,165,729,34134,"rgb(27,158,119)"
20321,2020-04-23,Netherlands,138,708,34842,"rgb(27,158,119)"
20322,2020-04-24,Netherlands,123,887,35729,"rgb(27,158,119)"
20323,2020-04-25,Netherlands,112,806,36535,"rgb(27,158,119)"
20324,2020-04-26,Netherlands,120,655,37190,"rgb(27,158,119)"
20325,2020-04-27,Netherlands,66,655,37845,"rgb(27,158,119)"
20326,2020-04-28,Netherlands,43,400,38245,"rgb(27,158,119)"
20327,2020-04-29,Netherlands,48,171,38416,"rgb(27,158,119)"
20328,2020-04-30,Netherlands,145,386,38802,"rgb(27,158,119)"
20329,2020-05-01,Netherlands,84,514,39316,"rgb(27,158,119)"
20330,2020-05-02,Netherlands,98,475,39791,"rgb(27,158,119)"
20331,2020-05-03,Netherlands,94,445,40236,"rgb(27,158,119)"
20332,2020-05-04,Netherlands,69,335,40571,"rgb(27,158,119)"
20333,2020-05-05,Netherlands,26,199,40770,"rgb(27,158,119)"
20334,2020-05-06,Netherlands,86,317,41087,"rgb(27,158,119)"
20335,2020-05-07,Netherlands,36,232,41319,"rgb(27,158,119)"
20336,2020-05-08,Netherlands,84,455,41774,"rgb(27,158,119)"
20337,2020-05-09,Netherlands,71,319,42093,"rgb(27,158,119)"
20338,2020-05-10,Netherlands,63,289,42382,"rgb(27,158,119)"
20339,2020-05-11,Netherlands,18,245,42627,"rgb(27,158,119)"
20340,2020-05-12,Netherlands,16,161,42788,"rgb(27,158,119)"
20341,2020-05-13,Netherlands,54,196,42984,"rgb(27,158,119)"
20342,2020-05-14,Netherlands,52,227,43211,"rgb(27,158,119)"
20343,2020-05-15,Netherlands,28,270,43481,"rgb(27,158,119)"
20344,2020-05-16,Netherlands,53,200,43681,"rgb(27,158,119)"
20345,2020-05-17,Netherlands,27,189,43870,"rgb(27,158,119)"
20346,2020-05-18,Netherlands,10,125,43995,"rgb(27,158,119)"
20347,2020-05-19,Netherlands,14,146,44141,"rgb(27,158,119)"
20348,2020-05-20,Netherlands,21,108,44249,"rgb(27,158,119)"
20349,2020-05-21,Netherlands,33,198,44447,"rgb(27,158,119)"
20350,2020-05-22,Netherlands,27,253,44700,"rgb(27,158,119)"
20351,2020-05-23,Netherlands,13,188,44888,"rgb(27,158,119)"
20352,2020-05-24,Netherlands,23,176,45064,"rgb(27,158,119)"
20353,2020-05-25,Netherlands,11,172,45236,"rgb(27,158,119)"
20354,2020-05-26,Netherlands,8,209,45445,"rgb(27,158,119)"
20355,2020-05-27,Netherlands,26,133,45578,"rgb(27,158,119)"
20356,2020-05-28,Netherlands,15,190,45768,"rgb(27,158,119)"
20357,2020-05-29,Netherlands,32,182,45950,"rgb(27,158,119)"
20358,2020-05-30,Netherlands,28,176,46126,"rgb(27,158,119)"
20359,2020-05-31,Netherlands,20,131,46257,"rgb(27,158,119)"
20360,2020-06-01,Netherlands,5,185,46442,"rgb(27,158,119)"
20361,2020-06-02,Netherlands,6,103,46545,"rgb(27,158,119)"
20362,2020-06-03,Netherlands,5,102,46647,"rgb(27,158,119)"
20363,2020-06-04,Netherlands,10,86,46733,"rgb(27,158,119)"
20364,2020-06-05,Netherlands,13,209,46942,"rgb(27,158,119)"
20365,2020-06-06,Netherlands,15,210,47152,"rgb(27,158,119)"
20366,2020-06-07,Netherlands,6,183,47335,"rgb(27,158,119)"
20367,2020-06-08,Netherlands,2,239,47574,"rgb(27,158,119)"
20368,2020-06-09,Netherlands,3,165,47739,"rgb(27,158,119)"
20369,2020-06-10,Netherlands,15,164,47903,"rgb(27,158,119)"
20370,2020-06-11,Netherlands,11,184,48087,"rgb(27,158,119)"
20371,2020-06-12,Netherlands,2,164,48251,"rgb(27,158,119)"
20372,2020-06-13,Netherlands,9,210,48461,"rgb(27,158,119)"
20373,2020-06-14,Netherlands,4,179,48640,"rgb(27,158,119)"
20374,2020-06-15,Netherlands,2,143,48783,"rgb(27,158,119)"
20375,2020-06-16,Netherlands,0,0,48783,"rgb(27,158,119)"
20376,2020-06-17,Netherlands,11,304,49087,"rgb(27,158,119)"
20377,2020-06-18,Netherlands,4,117,49204,"rgb(27,158,119)"
20378,2020-06-19,Netherlands,4,115,49319,"rgb(27,158,119)"
20379,2020-06-20,Netherlands,3,107,49426,"rgb(27,158,119)"
20380,2020-06-21,Netherlands,8,76,49502,"rgb(27,158,119)"
20381,2020-06-22,Netherlands,1,91,49593,"rgb(27,158,119)"
20382,2020-06-23,Netherlands,0,65,49658,"rgb(27,158,119)"
20383,2020-06-24,Netherlands,5,64,49722,"rgb(27,158,119)"
20384,2020-06-25,Netherlands,2,82,49804,"rgb(27,158,119)"
20385,2020-06-26,Netherlands,3,110,49914,"rgb(27,158,119)"
20386,2020-06-27,Netherlands,3,91,50005,"rgb(27,158,119)"
20387,2020-06-28,Netherlands,2,69,50074,"rgb(27,158,119)"
20388,2020-06-29,Netherlands,0,73,50147,"rgb(27,158,119)"
20389,2020-06-30,Netherlands,2,76,50223,"rgb(27,158,119)"
20390,2020-07-01,Netherlands,2,50,50273,"rgb(27,158,119)"
20391,2020-07-02,Netherlands,0,62,50335,"rgb(27,158,119)"
20392,2020-07-03,Netherlands,0,22,50357,"rgb(27,158,119)"
20393,2020-07-04,Netherlands,2,75,50432,"rgb(27,158,119)"
20394,2020-07-05,Netherlands,6,61,50493,"rgb(27,158,119)"
20395,2020-07-06,Netherlands,1,73,50566,"rgb(27,158,119)"
20396,2020-07-07,Netherlands,1,36,50602,"rgb(27,158,119)"
20397,2020-07-08,Netherlands,4,37,50639,"rgb(27,158,119)"
20398,2020-07-09,Netherlands,3,52,50691,"rgb(27,158,119)"
20399,2020-07-10,Netherlands,1,52,50743,"rgb(27,158,119)"
20400,2020-07-11,Netherlands,0,42,50785,"rgb(27,158,119)"
20401,2020-07-12,Netherlands,1,81,50866,"rgb(27,158,119)"
20402,2020-07-13,Netherlands,0,101,50967,"rgb(27,158,119)"
20403,2019-12-31,Norway,0,0,0,"rgb(217,95,2)"
20404,2020-01-01,Norway,0,0,0,"rgb(217,95,2)"
20405,2020-01-02,Norway,0,0,0,"rgb(217,95,2)"
20406,2020-01-03,Norway,0,0,0,"rgb(217,95,2)"
20407,2020-01-04,Norway,0,0,0,"rgb(217,95,2)"
20408,2020-01-05,Norway,0,0,0,"rgb(217,95,2)"
20409,2020-01-06,Norway,0,0,0,"rgb(217,95,2)"
20410,2020-01-07,Norway,0,0,0,"rgb(217,95,2)"
20411,2020-01-08,Norway,0,0,0,"rgb(217,95,2)"
20412,2020-01-09,Norway,0,0,0,"rgb(217,95,2)"
20413,2020-01-10,Norway,0,0,0,"rgb(217,95,2)"
20414,2020-01-11,Norway,0,0,0,"rgb(217,95,2)"
20415,2020-01-12,Norway,0,0,0,"rgb(217,95,2)"
20416,2020-01-13,Norway,0,0,0,"rgb(217,95,2)"
20417,2020-01-14,Norway,0,0,0,"rgb(217,95,2)"
20418,2020-01-15,Norway,0,0,0,"rgb(217,95,2)"
20419,2020-01-16,Norway,0,0,0,"rgb(217,95,2)"
20420,2020-01-17,Norway,0,0,0,"rgb(217,95,2)"
20421,2020-01-18,Norway,0,0,0,"rgb(217,95,2)"
20422,2020-01-19,Norway,0,0,0,"rgb(217,95,2)"
20423,2020-01-20,Norway,0,0,0,"rgb(217,95,2)"
20424,2020-01-21,Norway,0,0,0,"rgb(217,95,2)"
20425,2020-01-22,Norway,0,0,0,"rgb(217,95,2)"
20426,2020-01-23,Norway,0,0,0,"rgb(217,95,2)"
20427,2020-01-24,Norway,0,0,0,"rgb(217,95,2)"
20428,2020-01-25,Norway,0,0,0,"rgb(217,95,2)"
20429,2020-01-26,Norway,0,0,0,"rgb(217,95,2)"
20430,2020-01-27,Norway,0,0,0,"rgb(217,95,2)"
20431,2020-01-28,Norway,0,0,0,"rgb(217,95,2)"
20432,2020-01-29,Norway,0,0,0,"rgb(217,95,2)"
20433,2020-01-30,Norway,0,0,0,"rgb(217,95,2)"
20434,2020-01-31,Norway,0,0,0,"rgb(217,95,2)"
20435,2020-02-01,Norway,0,0,0,"rgb(217,95,2)"
20436,2020-02-02,Norway,0,0,0,"rgb(217,95,2)"
20437,2020-02-03,Norway,0,0,0,"rgb(217,95,2)"
20438,2020-02-04,Norway,0,0,0,"rgb(217,95,2)"
20439,2020-02-05,Norway,0,0,0,"rgb(217,95,2)"
20440,2020-02-06,Norway,0,0,0,"rgb(217,95,2)"
20441,2020-02-07,Norway,0,0,0,"rgb(217,95,2)"
20442,2020-02-08,Norway,0,0,0,"rgb(217,95,2)"
20443,2020-02-09,Norway,0,0,0,"rgb(217,95,2)"
20444,2020-02-10,Norway,0,0,0,"rgb(217,95,2)"
20445,2020-02-11,Norway,0,0,0,"rgb(217,95,2)"
20446,2020-02-12,Norway,0,0,0,"rgb(217,95,2)"
20447,2020-02-13,Norway,0,0,0,"rgb(217,95,2)"
20448,2020-02-14,Norway,0,0,0,"rgb(217,95,2)"
20449,2020-02-15,Norway,0,0,0,"rgb(217,95,2)"
20450,2020-02-16,Norway,0,0,0,"rgb(217,95,2)"
20451,2020-02-17,Norway,0,0,0,"rgb(217,95,2)"
20452,2020-02-18,Norway,0,0,0,"rgb(217,95,2)"
20453,2020-02-19,Norway,0,0,0,"rgb(217,95,2)"
20454,2020-02-20,Norway,0,0,0,"rgb(217,95,2)"
20455,2020-02-21,Norway,0,0,0,"rgb(217,95,2)"
20456,2020-02-22,Norway,0,0,0,"rgb(217,95,2)"
20457,2020-02-23,Norway,0,0,0,"rgb(217,95,2)"
20458,2020-02-24,Norway,0,0,0,"rgb(217,95,2)"
20459,2020-02-25,Norway,0,0,0,"rgb(217,95,2)"
20460,2020-02-26,Norway,0,0,0,"rgb(217,95,2)"
20461,2020-02-27,Norway,0,1,1,"rgb(217,95,2)"
20462,2020-02-28,Norway,0,3,4,"rgb(217,95,2)"
20463,2020-02-29,Norway,0,2,6,"rgb(217,95,2)"
20464,2020-03-01,Norway,0,9,15,"rgb(217,95,2)"
20465,2020-03-02,Norway,0,4,19,"rgb(217,95,2)"
20466,2020-03-03,Norway,0,6,25,"rgb(217,95,2)"
20467,2020-03-04,Norway,0,8,33,"rgb(217,95,2)"
20468,2020-03-05,Norway,0,23,56,"rgb(217,95,2)"
20469,2020-03-06,Norway,0,30,86,"rgb(217,95,2)"
20470,2020-03-07,Norway,0,27,113,"rgb(217,95,2)"
20471,2020-03-08,Norway,0,34,147,"rgb(217,95,2)"
20472,2020-03-09,Norway,0,22,169,"rgb(217,95,2)"
20473,2020-03-10,Norway,0,23,192,"rgb(217,95,2)"
20474,2020-03-11,Norway,0,85,277,"rgb(217,95,2)"
20475,2020-03-12,Norway,0,212,489,"rgb(217,95,2)"
20476,2020-03-13,Norway,1,132,621,"rgb(217,95,2)"
20477,2020-03-14,Norway,0,0,621,"rgb(217,95,2)"
20478,2020-03-15,Norway,0,286,907,"rgb(217,95,2)"
20479,2020-03-16,Norway,0,170,1077,"rgb(217,95,2)"
20480,2020-03-17,Norway,2,92,1169,"rgb(217,95,2)"
20481,2020-03-18,Norway,0,139,1308,"rgb(217,95,2)"
20482,2020-03-19,Norway,0,115,1423,"rgb(217,95,2)"
20483,2020-03-20,Norway,3,129,1552,"rgb(217,95,2)"
20484,2020-03-21,Norway,1,190,1742,"rgb(217,95,2)"
20485,2020-03-22,Norway,0,184,1926,"rgb(217,95,2)"
20486,2020-03-23,Norway,0,206,2132,"rgb(217,95,2)"
20487,2020-03-24,Norway,1,239,2371,"rgb(217,95,2)"
20488,2020-03-25,Norway,2,195,2566,"rgb(217,95,2)"
20489,2020-03-26,Norway,2,350,2916,"rgb(217,95,2)"
20490,2020-03-27,Norway,2,240,3156,"rgb(217,95,2)"
20491,2020-03-28,Norway,2,425,3581,"rgb(217,95,2)"
20492,2020-03-29,Norway,4,264,3845,"rgb(217,95,2)"
20493,2020-03-30,Norway,2,257,4102,"rgb(217,95,2)"
20494,2020-03-31,Norway,4,124,4226,"rgb(217,95,2)"
20495,2020-04-01,Norway,2,221,4447,"rgb(217,95,2)"
20496,2020-04-02,Norway,4,218,4665,"rgb(217,95,2)"
20497,2020-04-03,Norway,10,270,4935,"rgb(217,95,2)"
20498,2020-04-04,Norway,2,273,5208,"rgb(217,95,2)"
20499,2020-04-05,Norway,6,302,5510,"rgb(217,95,2)"
20500,2020-04-06,Norway,8,130,5640,"rgb(217,95,2)"
20501,2020-04-07,Norway,1,115,5755,"rgb(217,95,2)"
20502,2020-04-08,Norway,10,108,5863,"rgb(217,95,2)"
20503,2020-04-09,Norway,11,147,6010,"rgb(217,95,2)"
20504,2020-04-10,Norway,8,150,6160,"rgb(217,95,2)"
20505,2020-04-11,Norway,4,84,6244,"rgb(217,95,2)"
20506,2020-04-12,Norway,6,76,6320,"rgb(217,95,2)"
20507,2020-04-13,Norway,5,95,6415,"rgb(217,95,2)"
20508,2020-04-14,Norway,11,73,6488,"rgb(217,95,2)"
20509,2020-04-15,Norway,13,78,6566,"rgb(217,95,2)"
20510,2020-04-16,Norway,3,111,6677,"rgb(217,95,2)"
20511,2020-04-17,Norway,6,114,6791,"rgb(217,95,2)"
20512,2020-04-18,Norway,0,0,6791,"rgb(217,95,2)"
20513,2020-04-19,Norway,12,193,6984,"rgb(217,95,2)"
20514,2020-04-20,Norway,6,84,7068,"rgb(217,95,2)"
20515,2020-04-21,Norway,0,45,7113,"rgb(217,95,2)"
20516,2020-04-22,Norway,9,53,7166,"rgb(217,95,2)"
20517,2020-04-23,Norway,6,84,7250,"rgb(217,95,2)"
20518,2020-04-24,Norway,11,95,7345,"rgb(217,95,2)"
20519,2020-04-25,Norway,11,63,7408,"rgb(217,95,2)"
20520,2020-04-26,Norway,2,59,7467,"rgb(217,95,2)"
20521,2020-04-27,Norway,0,38,7505,"rgb(217,95,2)"
20522,2020-04-28,Norway,0,28,7533,"rgb(217,95,2)"
20523,2020-04-29,Norway,2,72,7605,"rgb(217,95,2)"
20524,2020-04-30,Norway,7,62,7667,"rgb(217,95,2)"
20525,2020-05-01,Norway,2,43,7710,"rgb(217,95,2)"
20526,2020-05-02,Norway,0,49,7759,"rgb(217,95,2)"
20527,2020-05-03,Norway,0,0,7759,"rgb(217,95,2)"
20528,2020-05-04,Norway,4,50,7809,"rgb(217,95,2)"
20529,2020-05-05,Norway,0,38,7847,"rgb(217,95,2)"
20530,2020-05-06,Norway,1,56,7903,"rgb(217,95,2)"
20531,2020-05-07,Norway,0,50,7953,"rgb(217,95,2)"
20532,2020-05-08,Norway,0,42,7995,"rgb(217,95,2)"
20533,2020-05-09,Norway,4,39,8034,"rgb(217,95,2)"
20534,2020-05-10,Norway,0,35,8069,"rgb(217,95,2)"
20535,2020-05-11,Norway,4,30,8099,"rgb(217,95,2)"
20536,2020-05-12,Norway,7,7,8106,"rgb(217,95,2)"
20537,2020-05-13,Norway,4,29,8135,"rgb(217,95,2)"
20538,2020-05-14,Norway,1,23,8158,"rgb(217,95,2)"
20539,2020-05-15,Norway,3,17,8175,"rgb(217,95,2)"
20540,2020-05-16,Norway,0,22,8197,"rgb(217,95,2)"
20541,2020-05-17,Norway,0,0,8197,"rgb(217,95,2)"
20542,2020-05-18,Norway,0,0,8197,"rgb(217,95,2)"
20543,2020-05-19,Norway,1,52,8249,"rgb(217,95,2)"
20544,2020-05-20,Norway,0,8,8257,"rgb(217,95,2)"
20545,2020-05-21,Norway,1,11,8268,"rgb(217,95,2)"
20546,2020-05-22,Norway,0,0,8268,"rgb(217,95,2)"
20547,2020-05-23,Norway,1,41,8309,"rgb(217,95,2)"
20548,2020-05-24,Norway,0,0,8309,"rgb(217,95,2)"
20549,2020-05-25,Norway,0,0,8309,"rgb(217,95,2)"
20550,2020-05-26,Norway,0,43,8352,"rgb(217,95,2)"
20551,2020-05-27,Norway,0,12,8364,"rgb(217,95,2)"
20552,2020-05-28,Norway,0,19,8383,"rgb(217,95,2)"
20553,2020-05-29,Norway,1,18,8401,"rgb(217,95,2)"
20554,2020-05-30,Norway,0,10,8411,"rgb(217,95,2)"
20555,2020-05-31,Norway,0,0,8411,"rgb(217,95,2)"
20556,2020-06-01,Norway,0,0,8411,"rgb(217,95,2)"
20557,2020-06-02,Norway,0,0,8411,"rgb(217,95,2)"
20558,2020-06-03,Norway,1,35,8446,"rgb(217,95,2)"
20559,2020-06-04,Norway,0,0,8446,"rgb(217,95,2)"
20560,2020-06-05,Norway,1,31,8477,"rgb(217,95,2)"
20561,2020-06-06,Norway,0,27,8504,"rgb(217,95,2)"
20562,2020-06-07,Norway,0,0,8504,"rgb(217,95,2)"
20563,2020-06-08,Norway,0,0,8504,"rgb(217,95,2)"
20564,2020-06-09,Norway,1,43,8547,"rgb(217,95,2)"
20565,2020-06-10,Norway,0,16,8563,"rgb(217,95,2)"
20566,2020-06-11,Norway,0,13,8576,"rgb(217,95,2)"
20567,2020-06-12,Norway,3,18,8594,"rgb(217,95,2)"
20568,2020-06-13,Norway,0,12,8606,"rgb(217,95,2)"
20569,2020-06-14,Norway,0,0,8606,"rgb(217,95,2)"
20570,2020-06-15,Norway,0,0,8606,"rgb(217,95,2)"
20571,2020-06-16,Norway,0,25,8631,"rgb(217,95,2)"
20572,2020-06-17,Norway,0,0,8631,"rgb(217,95,2)"
20573,2020-06-18,Norway,1,29,8660,"rgb(217,95,2)"
20574,2020-06-19,Norway,1,32,8692,"rgb(217,95,2)"
20575,2020-06-20,Norway,0,0,8692,"rgb(217,95,2)"
20576,2020-06-21,Norway,0,16,8708,"rgb(217,95,2)"
20577,2020-06-22,Norway,0,0,8708,"rgb(217,95,2)"
20578,2020-06-23,Norway,4,37,8745,"rgb(217,95,2)"
20579,2020-06-24,Norway,0,6,8751,"rgb(217,95,2)"
20580,2020-06-25,Norway,1,26,8777,"rgb(217,95,2)"
20581,2020-06-26,Norway,0,16,8793,"rgb(217,95,2)"
20582,2020-06-27,Norway,0,22,8815,"rgb(217,95,2)"
20583,2020-06-28,Norway,0,0,8815,"rgb(217,95,2)"
20584,2020-06-29,Norway,0,0,8815,"rgb(217,95,2)"
20585,2020-06-30,Norway,0,40,8855,"rgb(217,95,2)"
20586,2020-07-01,Norway,1,10,8865,"rgb(217,95,2)"
20587,2020-07-02,Norway,1,22,8887,"rgb(217,95,2)"
20588,2020-07-03,Norway,0,8,8895,"rgb(217,95,2)"
20589,2020-07-04,Norway,0,0,8895,"rgb(217,95,2)"
20590,2020-07-05,Norway,0,0,8895,"rgb(217,95,2)"
20591,2020-07-06,Norway,0,0,8895,"rgb(217,95,2)"
20592,2020-07-07,Norway,0,35,8930,"rgb(217,95,2)"
20593,2020-07-08,Norway,0,6,8936,"rgb(217,95,2)"
20594,2020-07-09,Norway,0,11,8947,"rgb(217,95,2)"
20595,2020-07-10,Norway,1,7,8954,"rgb(217,95,2)"
20596,2020-07-11,Norway,0,11,8965,"rgb(217,95,2)"
20597,2020-07-12,Norway,0,0,8965,"rgb(217,95,2)"
20598,2020-07-13,Norway,0,0,8965,"rgb(217,95,2)"
20599,2019-12-31,Nepal,0,0,0,"rgb(117,112,179)"
20600,2020-01-01,Nepal,0,0,0,"rgb(117,112,179)"
20601,2020-01-02,Nepal,0,0,0,"rgb(117,112,179)"
20602,2020-01-03,Nepal,0,0,0,"rgb(117,112,179)"
20603,2020-01-04,Nepal,0,0,0,"rgb(117,112,179)"
20604,2020-01-05,Nepal,0,0,0,"rgb(117,112,179)"
20605,2020-01-06,Nepal,0,0,0,"rgb(117,112,179)"
20606,2020-01-07,Nepal,0,0,0,"rgb(117,112,179)"
20607,2020-01-08,Nepal,0,0,0,"rgb(117,112,179)"
20608,2020-01-09,Nepal,0,0,0,"rgb(117,112,179)"
20609,2020-01-10,Nepal,0,0,0,"rgb(117,112,179)"
20610,2020-01-11,Nepal,0,0,0,"rgb(117,112,179)"
20611,2020-01-12,Nepal,0,0,0,"rgb(117,112,179)"
20612,2020-01-13,Nepal,0,0,0,"rgb(117,112,179)"
20613,2020-01-14,Nepal,0,0,0,"rgb(117,112,179)"
20614,2020-01-15,Nepal,0,0,0,"rgb(117,112,179)"
20615,2020-01-16,Nepal,0,0,0,"rgb(117,112,179)"
20616,2020-01-17,Nepal,0,0,0,"rgb(117,112,179)"
20617,2020-01-18,Nepal,0,0,0,"rgb(117,112,179)"
20618,2020-01-19,Nepal,0,0,0,"rgb(117,112,179)"
20619,2020-01-20,Nepal,0,0,0,"rgb(117,112,179)"
20620,2020-01-21,Nepal,0,0,0,"rgb(117,112,179)"
20621,2020-01-22,Nepal,0,0,0,"rgb(117,112,179)"
20622,2020-01-23,Nepal,0,0,0,"rgb(117,112,179)"
20623,2020-01-24,Nepal,0,0,0,"rgb(117,112,179)"
20624,2020-01-25,Nepal,0,1,1,"rgb(117,112,179)"
20625,2020-01-26,Nepal,0,0,1,"rgb(117,112,179)"
20626,2020-01-27,Nepal,0,0,1,"rgb(117,112,179)"
20627,2020-01-28,Nepal,0,0,1,"rgb(117,112,179)"
20628,2020-01-29,Nepal,0,0,1,"rgb(117,112,179)"
20629,2020-01-30,Nepal,0,0,1,"rgb(117,112,179)"
20630,2020-01-31,Nepal,0,0,1,"rgb(117,112,179)"
20631,2020-02-01,Nepal,0,0,1,"rgb(117,112,179)"
20632,2020-02-02,Nepal,0,0,1,"rgb(117,112,179)"
20633,2020-02-03,Nepal,0,0,1,"rgb(117,112,179)"
20634,2020-02-04,Nepal,0,0,1,"rgb(117,112,179)"
20635,2020-02-05,Nepal,0,0,1,"rgb(117,112,179)"
20636,2020-02-06,Nepal,0,0,1,"rgb(117,112,179)"
20637,2020-02-07,Nepal,0,0,1,"rgb(117,112,179)"
20638,2020-02-08,Nepal,0,0,1,"rgb(117,112,179)"
20639,2020-02-09,Nepal,0,0,1,"rgb(117,112,179)"
20640,2020-02-10,Nepal,0,0,1,"rgb(117,112,179)"
20641,2020-02-11,Nepal,0,0,1,"rgb(117,112,179)"
20642,2020-02-12,Nepal,0,0,1,"rgb(117,112,179)"
20643,2020-02-13,Nepal,0,0,1,"rgb(117,112,179)"
20644,2020-02-14,Nepal,0,0,1,"rgb(117,112,179)"
20645,2020-02-15,Nepal,0,0,1,"rgb(117,112,179)"
20646,2020-02-16,Nepal,0,0,1,"rgb(117,112,179)"
20647,2020-02-17,Nepal,0,0,1,"rgb(117,112,179)"
20648,2020-02-18,Nepal,0,0,1,"rgb(117,112,179)"
20649,2020-02-19,Nepal,0,0,1,"rgb(117,112,179)"
20650,2020-02-20,Nepal,0,0,1,"rgb(117,112,179)"
20651,2020-02-21,Nepal,0,0,1,"rgb(117,112,179)"
20652,2020-02-22,Nepal,0,0,1,"rgb(117,112,179)"
20653,2020-02-23,Nepal,0,0,1,"rgb(117,112,179)"
20654,2020-02-24,Nepal,0,0,1,"rgb(117,112,179)"
20655,2020-02-25,Nepal,0,0,1,"rgb(117,112,179)"
20656,2020-02-26,Nepal,0,0,1,"rgb(117,112,179)"
20657,2020-02-27,Nepal,0,0,1,"rgb(117,112,179)"
20658,2020-02-28,Nepal,0,0,1,"rgb(117,112,179)"
20659,2020-02-29,Nepal,0,0,1,"rgb(117,112,179)"
20660,2020-03-01,Nepal,0,0,1,"rgb(117,112,179)"
20661,2020-03-02,Nepal,0,0,1,"rgb(117,112,179)"
20662,2020-03-15,Nepal,0,0,1,"rgb(117,112,179)"
20663,2020-03-17,Nepal,0,0,1,"rgb(117,112,179)"
20664,2020-03-18,Nepal,0,0,1,"rgb(117,112,179)"
20665,2020-03-19,Nepal,0,0,1,"rgb(117,112,179)"
20666,2020-03-20,Nepal,0,0,1,"rgb(117,112,179)"
20667,2020-03-21,Nepal,0,0,1,"rgb(117,112,179)"
20668,2020-03-22,Nepal,0,0,1,"rgb(117,112,179)"
20669,2020-03-23,Nepal,0,0,1,"rgb(117,112,179)"
20670,2020-03-24,Nepal,0,1,2,"rgb(117,112,179)"
20671,2020-03-25,Nepal,0,1,3,"rgb(117,112,179)"
20672,2020-03-26,Nepal,0,0,3,"rgb(117,112,179)"
20673,2020-03-27,Nepal,0,0,3,"rgb(117,112,179)"
20674,2020-03-28,Nepal,0,0,3,"rgb(117,112,179)"
20675,2020-03-29,Nepal,0,2,5,"rgb(117,112,179)"
20676,2020-03-30,Nepal,0,0,5,"rgb(117,112,179)"
20677,2020-03-31,Nepal,0,0,5,"rgb(117,112,179)"
20678,2020-04-01,Nepal,0,0,5,"rgb(117,112,179)"
20679,2020-04-02,Nepal,0,0,5,"rgb(117,112,179)"
20680,2020-04-03,Nepal,0,0,5,"rgb(117,112,179)"
20681,2020-04-04,Nepal,0,1,6,"rgb(117,112,179)"
20682,2020-04-05,Nepal,0,0,6,"rgb(117,112,179)"
20683,2020-04-06,Nepal,0,3,9,"rgb(117,112,179)"
20684,2020-04-07,Nepal,0,0,9,"rgb(117,112,179)"
20685,2020-04-08,Nepal,0,0,9,"rgb(117,112,179)"
20686,2020-04-09,Nepal,0,0,9,"rgb(117,112,179)"
20687,2020-04-10,Nepal,0,0,9,"rgb(117,112,179)"
20688,2020-04-11,Nepal,0,0,9,"rgb(117,112,179)"
20689,2020-04-12,Nepal,0,0,9,"rgb(117,112,179)"
20690,2020-04-13,Nepal,0,3,12,"rgb(117,112,179)"
20691,2020-04-14,Nepal,0,2,14,"rgb(117,112,179)"
20692,2020-04-15,Nepal,0,2,16,"rgb(117,112,179)"
20693,2020-04-16,Nepal,0,0,16,"rgb(117,112,179)"
20694,2020-04-17,Nepal,0,0,16,"rgb(117,112,179)"
20695,2020-04-18,Nepal,0,14,30,"rgb(117,112,179)"
20696,2020-04-19,Nepal,0,1,31,"rgb(117,112,179)"
20697,2020-04-20,Nepal,0,0,31,"rgb(117,112,179)"
20698,2020-04-21,Nepal,0,0,31,"rgb(117,112,179)"
20699,2020-04-22,Nepal,0,11,42,"rgb(117,112,179)"
20700,2020-04-23,Nepal,0,3,45,"rgb(117,112,179)"
20701,2020-04-24,Nepal,0,3,48,"rgb(117,112,179)"
20702,2020-04-25,Nepal,0,1,49,"rgb(117,112,179)"
20703,2020-04-26,Nepal,0,0,49,"rgb(117,112,179)"
20704,2020-04-27,Nepal,0,3,52,"rgb(117,112,179)"
20705,2020-04-28,Nepal,0,0,52,"rgb(117,112,179)"
20706,2020-04-29,Nepal,0,2,54,"rgb(117,112,179)"
20707,2020-04-30,Nepal,0,3,57,"rgb(117,112,179)"
20708,2020-05-01,Nepal,0,0,57,"rgb(117,112,179)"
20709,2020-05-02,Nepal,0,2,59,"rgb(117,112,179)"
20710,2020-05-03,Nepal,0,0,59,"rgb(117,112,179)"
20711,2020-05-04,Nepal,0,16,75,"rgb(117,112,179)"
20712,2020-05-05,Nepal,0,7,82,"rgb(117,112,179)"
20713,2020-05-06,Nepal,0,0,82,"rgb(117,112,179)"
20714,2020-05-07,Nepal,0,17,99,"rgb(117,112,179)"
20715,2020-05-08,Nepal,0,2,101,"rgb(117,112,179)"
20716,2020-05-09,Nepal,0,0,101,"rgb(117,112,179)"
20717,2020-05-10,Nepal,0,8,109,"rgb(117,112,179)"
20718,2020-05-11,Nepal,0,11,120,"rgb(117,112,179)"
20719,2020-05-12,Nepal,0,14,134,"rgb(117,112,179)"
20720,2020-05-13,Nepal,0,83,217,"rgb(117,112,179)"
20721,2020-05-14,Nepal,0,2,219,"rgb(117,112,179)"
20722,2020-05-15,Nepal,0,39,258,"rgb(117,112,179)"
20723,2020-05-16,Nepal,0,18,276,"rgb(117,112,179)"
20724,2020-05-17,Nepal,1,15,291,"rgb(117,112,179)"
20725,2020-05-18,Nepal,1,13,304,"rgb(117,112,179)"
20726,2020-05-19,Nepal,0,71,375,"rgb(117,112,179)"
20727,2020-05-20,Nepal,0,27,402,"rgb(117,112,179)"
20728,2020-05-21,Nepal,0,42,444,"rgb(117,112,179)"
20729,2020-05-22,Nepal,1,43,487,"rgb(117,112,179)"
20730,2020-05-23,Nepal,0,61,548,"rgb(117,112,179)"
20731,2020-05-24,Nepal,0,36,584,"rgb(117,112,179)"
20732,2020-05-25,Nepal,0,19,603,"rgb(117,112,179)"
20733,2020-05-26,Nepal,1,79,682,"rgb(117,112,179)"
20734,2020-05-27,Nepal,0,90,772,"rgb(117,112,179)"
20735,2020-05-28,Nepal,0,114,886,"rgb(117,112,179)"
20736,2020-05-29,Nepal,1,156,1042,"rgb(117,112,179)"
20737,2020-05-30,Nepal,1,170,1212,"rgb(117,112,179)"
20738,2020-05-31,Nepal,0,189,1401,"rgb(117,112,179)"
20739,2020-06-01,Nepal,2,171,1572,"rgb(117,112,179)"
20740,2020-06-02,Nepal,0,226,1798,"rgb(117,112,179)"
20741,2020-06-03,Nepal,0,301,2099,"rgb(117,112,179)"
20742,2020-06-04,Nepal,1,201,2300,"rgb(117,112,179)"
20743,2020-06-05,Nepal,1,334,2634,"rgb(117,112,179)"
20744,2020-06-06,Nepal,1,278,2912,"rgb(117,112,179)"
20745,2020-06-07,Nepal,0,0,2912,"rgb(117,112,179)"
20746,2020-06-08,Nepal,2,536,3448,"rgb(117,112,179)"
20747,2020-06-09,Nepal,1,314,3762,"rgb(117,112,179)"
20748,2020-06-10,Nepal,1,323,4085,"rgb(117,112,179)"
20749,2020-06-11,Nepal,0,279,4364,"rgb(117,112,179)"
20750,2020-06-12,Nepal,0,250,4614,"rgb(117,112,179)"
20751,2020-06-13,Nepal,1,448,5062,"rgb(117,112,179)"
20752,2020-06-14,Nepal,2,273,5335,"rgb(117,112,179)"
20753,2020-06-15,Nepal,1,425,5760,"rgb(117,112,179)"
20754,2020-06-16,Nepal,0,451,6211,"rgb(117,112,179)"
20755,2020-06-17,Nepal,0,380,6591,"rgb(117,112,179)"
20756,2020-06-18,Nepal,1,586,7177,"rgb(117,112,179)"
20757,2020-06-19,Nepal,2,671,7848,"rgb(117,112,179)"
20758,2020-06-20,Nepal,0,426,8274,"rgb(117,112,179)"
20759,2020-06-21,Nepal,0,331,8605,"rgb(117,112,179)"
20760,2020-06-22,Nepal,1,421,9026,"rgb(117,112,179)"
20761,2020-06-23,Nepal,0,0,9026,"rgb(117,112,179)"
20762,2020-06-24,Nepal,0,0,9026,"rgb(117,112,179)"
20763,2020-06-25,Nepal,0,1702,10728,"rgb(117,112,179)"
20764,2020-06-26,Nepal,3,434,11162,"rgb(117,112,179)"
20765,2020-06-27,Nepal,1,593,11755,"rgb(117,112,179)"
20766,2020-06-28,Nepal,0,0,11755,"rgb(117,112,179)"
20767,2020-06-29,Nepal,1,1017,12772,"rgb(117,112,179)"
20768,2020-06-30,Nepal,1,476,13248,"rgb(117,112,179)"
20769,2020-07-01,Nepal,0,316,13564,"rgb(117,112,179)"
20770,2020-07-02,Nepal,1,482,14046,"rgb(117,112,179)"
20771,2020-07-03,Nepal,1,473,14519,"rgb(117,112,179)"
20772,2020-07-04,Nepal,1,740,15259,"rgb(117,112,179)"
20773,2020-07-05,Nepal,2,232,15491,"rgb(117,112,179)"
20774,2020-07-06,Nepal,0,293,15784,"rgb(117,112,179)"
20775,2020-07-07,Nepal,1,180,15964,"rgb(117,112,179)"
20776,2020-07-08,Nepal,0,0,15964,"rgb(117,112,179)"
20777,2020-07-09,Nepal,0,459,16423,"rgb(117,112,179)"
20778,2020-07-10,Nepal,0,108,16531,"rgb(117,112,179)"
20779,2020-07-11,Nepal,0,118,16649,"rgb(117,112,179)"
20780,2020-07-12,Nepal,3,70,16719,"rgb(117,112,179)"
20781,2020-07-13,Nepal,0,82,16801,"rgb(117,112,179)"
20782,2019-12-31,New Zealand,0,0,0,"rgb(231,41,138)"
20783,2020-01-01,New Zealand,0,0,0,"rgb(231,41,138)"
20784,2020-01-02,New Zealand,0,0,0,"rgb(231,41,138)"
20785,2020-01-03,New Zealand,0,0,0,"rgb(231,41,138)"
20786,2020-01-04,New Zealand,0,0,0,"rgb(231,41,138)"
20787,2020-01-05,New Zealand,0,0,0,"rgb(231,41,138)"
20788,2020-01-06,New Zealand,0,0,0,"rgb(231,41,138)"
20789,2020-01-07,New Zealand,0,0,0,"rgb(231,41,138)"
20790,2020-01-08,New Zealand,0,0,0,"rgb(231,41,138)"
20791,2020-01-09,New Zealand,0,0,0,"rgb(231,41,138)"
20792,2020-01-10,New Zealand,0,0,0,"rgb(231,41,138)"
20793,2020-01-11,New Zealand,0,0,0,"rgb(231,41,138)"
20794,2020-01-12,New Zealand,0,0,0,"rgb(231,41,138)"
20795,2020-01-13,New Zealand,0,0,0,"rgb(231,41,138)"
20796,2020-01-14,New Zealand,0,0,0,"rgb(231,41,138)"
20797,2020-01-15,New Zealand,0,0,0,"rgb(231,41,138)"
20798,2020-01-16,New Zealand,0,0,0,"rgb(231,41,138)"
20799,2020-01-17,New Zealand,0,0,0,"rgb(231,41,138)"
20800,2020-01-18,New Zealand,0,0,0,"rgb(231,41,138)"
20801,2020-01-19,New Zealand,0,0,0,"rgb(231,41,138)"
20802,2020-01-20,New Zealand,0,0,0,"rgb(231,41,138)"
20803,2020-01-21,New Zealand,0,0,0,"rgb(231,41,138)"
20804,2020-01-22,New Zealand,0,0,0,"rgb(231,41,138)"
20805,2020-01-23,New Zealand,0,0,0,"rgb(231,41,138)"
20806,2020-01-24,New Zealand,0,0,0,"rgb(231,41,138)"
20807,2020-01-25,New Zealand,0,0,0,"rgb(231,41,138)"
20808,2020-01-26,New Zealand,0,0,0,"rgb(231,41,138)"
20809,2020-01-27,New Zealand,0,0,0,"rgb(231,41,138)"
20810,2020-01-28,New Zealand,0,0,0,"rgb(231,41,138)"
20811,2020-01-29,New Zealand,0,0,0,"rgb(231,41,138)"
20812,2020-01-30,New Zealand,0,0,0,"rgb(231,41,138)"
20813,2020-01-31,New Zealand,0,0,0,"rgb(231,41,138)"
20814,2020-02-01,New Zealand,0,0,0,"rgb(231,41,138)"
20815,2020-02-02,New Zealand,0,0,0,"rgb(231,41,138)"
20816,2020-02-03,New Zealand,0,0,0,"rgb(231,41,138)"
20817,2020-02-04,New Zealand,0,0,0,"rgb(231,41,138)"
20818,2020-02-05,New Zealand,0,0,0,"rgb(231,41,138)"
20819,2020-02-06,New Zealand,0,0,0,"rgb(231,41,138)"
20820,2020-02-07,New Zealand,0,0,0,"rgb(231,41,138)"
20821,2020-02-08,New Zealand,0,0,0,"rgb(231,41,138)"
20822,2020-02-09,New Zealand,0,0,0,"rgb(231,41,138)"
20823,2020-02-10,New Zealand,0,0,0,"rgb(231,41,138)"
20824,2020-02-11,New Zealand,0,0,0,"rgb(231,41,138)"
20825,2020-02-12,New Zealand,0,0,0,"rgb(231,41,138)"
20826,2020-02-13,New Zealand,0,0,0,"rgb(231,41,138)"
20827,2020-02-14,New Zealand,0,0,0,"rgb(231,41,138)"
20828,2020-02-15,New Zealand,0,0,0,"rgb(231,41,138)"
20829,2020-02-16,New Zealand,0,0,0,"rgb(231,41,138)"
20830,2020-02-17,New Zealand,0,0,0,"rgb(231,41,138)"
20831,2020-02-18,New Zealand,0,0,0,"rgb(231,41,138)"
20832,2020-02-19,New Zealand,0,0,0,"rgb(231,41,138)"
20833,2020-02-20,New Zealand,0,0,0,"rgb(231,41,138)"
20834,2020-02-21,New Zealand,0,0,0,"rgb(231,41,138)"
20835,2020-02-22,New Zealand,0,0,0,"rgb(231,41,138)"
20836,2020-02-23,New Zealand,0,0,0,"rgb(231,41,138)"
20837,2020-02-24,New Zealand,0,0,0,"rgb(231,41,138)"
20838,2020-02-25,New Zealand,0,0,0,"rgb(231,41,138)"
20839,2020-02-26,New Zealand,0,0,0,"rgb(231,41,138)"
20840,2020-02-27,New Zealand,0,0,0,"rgb(231,41,138)"
20841,2020-02-28,New Zealand,0,1,1,"rgb(231,41,138)"
20842,2020-02-29,New Zealand,0,0,1,"rgb(231,41,138)"
20843,2020-03-01,New Zealand,0,0,1,"rgb(231,41,138)"
20844,2020-03-02,New Zealand,0,0,1,"rgb(231,41,138)"
20845,2020-03-04,New Zealand,0,1,2,"rgb(231,41,138)"
20846,2020-03-05,New Zealand,0,1,3,"rgb(231,41,138)"
20847,2020-03-06,New Zealand,0,1,4,"rgb(231,41,138)"
20848,2020-03-07,New Zealand,0,1,5,"rgb(231,41,138)"
20849,2020-03-14,New Zealand,0,1,6,"rgb(231,41,138)"
20850,2020-03-15,New Zealand,0,2,8,"rgb(231,41,138)"
20851,2020-03-18,New Zealand,0,12,20,"rgb(231,41,138)"
20852,2020-03-19,New Zealand,0,8,28,"rgb(231,41,138)"
20853,2020-03-20,New Zealand,0,11,39,"rgb(231,41,138)"
20854,2020-03-21,New Zealand,0,14,53,"rgb(231,41,138)"
20855,2020-03-22,New Zealand,0,13,66,"rgb(231,41,138)"
20856,2020-03-23,New Zealand,0,36,102,"rgb(231,41,138)"
20857,2020-03-24,New Zealand,0,40,142,"rgb(231,41,138)"
20858,2020-03-25,New Zealand,0,47,189,"rgb(231,41,138)"
20859,2020-03-26,New Zealand,0,73,262,"rgb(231,41,138)"
20860,2020-03-27,New Zealand,0,76,338,"rgb(231,41,138)"
20861,2020-03-28,New Zealand,0,78,416,"rgb(231,41,138)"
20862,2020-03-29,New Zealand,1,60,476,"rgb(231,41,138)"
20863,2020-03-30,New Zealand,0,76,552,"rgb(231,41,138)"
20864,2020-03-31,New Zealand,0,95,647,"rgb(231,41,138)"
20865,2020-04-01,New Zealand,0,0,647,"rgb(231,41,138)"
20866,2020-04-02,New Zealand,0,76,723,"rgb(231,41,138)"
20867,2020-04-03,New Zealand,0,49,772,"rgb(231,41,138)"
20868,2020-04-04,New Zealand,0,52,824,"rgb(231,41,138)"
20869,2020-04-05,New Zealand,0,48,872,"rgb(231,41,138)"
20870,2020-04-06,New Zealand,0,39,911,"rgb(231,41,138)"
20871,2020-04-07,New Zealand,0,32,943,"rgb(231,41,138)"
20872,2020-04-08,New Zealand,0,26,969,"rgb(231,41,138)"
20873,2020-04-09,New Zealand,0,23,992,"rgb(231,41,138)"
20874,2020-04-10,New Zealand,1,23,1015,"rgb(231,41,138)"
20875,2020-04-11,New Zealand,2,20,1035,"rgb(231,41,138)"
20876,2020-04-12,New Zealand,0,14,1049,"rgb(231,41,138)"
20877,2020-04-13,New Zealand,1,15,1064,"rgb(231,41,138)"
20878,2020-04-14,New Zealand,4,8,1072,"rgb(231,41,138)"
20879,2020-04-15,New Zealand,0,6,1078,"rgb(231,41,138)"
20880,2020-04-16,New Zealand,0,6,1084,"rgb(231,41,138)"
20881,2020-04-17,New Zealand,2,2,1086,"rgb(231,41,138)"
20882,2020-04-18,New Zealand,0,8,1094,"rgb(231,41,138)"
20883,2020-04-19,New Zealand,1,4,1098,"rgb(231,41,138)"
20884,2020-04-20,New Zealand,0,7,1105,"rgb(231,41,138)"
20885,2020-04-21,New Zealand,1,2,1107,"rgb(231,41,138)"
20886,2020-04-22,New Zealand,1,5,1112,"rgb(231,41,138)"
20887,2020-04-23,New Zealand,2,0,1112,"rgb(231,41,138)"
20888,2020-04-24,New Zealand,1,2,1114,"rgb(231,41,138)"
20889,2020-04-25,New Zealand,1,3,1117,"rgb(231,41,138)"
20890,2020-04-26,New Zealand,0,4,1121,"rgb(231,41,138)"
20891,2020-04-27,New Zealand,1,1,1122,"rgb(231,41,138)"
20892,2020-04-28,New Zealand,0,2,1124,"rgb(231,41,138)"
20893,2020-04-29,New Zealand,0,2,1126,"rgb(231,41,138)"
20894,2020-04-30,New Zealand,0,3,1129,"rgb(231,41,138)"
20895,2020-05-01,New Zealand,0,3,1132,"rgb(231,41,138)"
20896,2020-05-02,New Zealand,1,2,1134,"rgb(231,41,138)"
20897,2020-05-03,New Zealand,0,2,1136,"rgb(231,41,138)"
20898,2020-05-04,New Zealand,0,1,1137,"rgb(231,41,138)"
20899,2020-05-05,New Zealand,0,0,1137,"rgb(231,41,138)"
20900,2020-05-06,New Zealand,1,1,1138,"rgb(231,41,138)"
20901,2020-05-07,New Zealand,0,1,1139,"rgb(231,41,138)"
20902,2020-05-08,New Zealand,0,2,1141,"rgb(231,41,138)"
20903,2020-05-09,New Zealand,0,1,1142,"rgb(231,41,138)"
20904,2020-05-10,New Zealand,0,2,1144,"rgb(231,41,138)"
20905,2020-05-11,New Zealand,0,3,1147,"rgb(231,41,138)"
20906,2020-05-12,New Zealand,0,0,1147,"rgb(231,41,138)"
20907,2020-05-13,New Zealand,0,0,1147,"rgb(231,41,138)"
20908,2020-05-14,New Zealand,0,0,1147,"rgb(231,41,138)"
20909,2020-05-15,New Zealand,0,1,1148,"rgb(231,41,138)"
20910,2020-05-16,New Zealand,0,0,1148,"rgb(231,41,138)"
20911,2020-05-17,New Zealand,0,1,1149,"rgb(231,41,138)"
20912,2020-05-18,New Zealand,0,0,1149,"rgb(231,41,138)"
20913,2020-05-19,New Zealand,0,4,1153,"rgb(231,41,138)"
20914,2020-05-20,New Zealand,0,0,1153,"rgb(231,41,138)"
20915,2020-05-21,New Zealand,0,0,1153,"rgb(231,41,138)"
20916,2020-05-22,New Zealand,0,1,1154,"rgb(231,41,138)"
20917,2020-05-23,New Zealand,0,0,1154,"rgb(231,41,138)"
20918,2020-05-24,New Zealand,0,0,1154,"rgb(231,41,138)"
20919,2020-05-25,New Zealand,0,0,1154,"rgb(231,41,138)"
20920,2020-05-26,New Zealand,0,0,1154,"rgb(231,41,138)"
20921,2020-05-27,New Zealand,0,0,1154,"rgb(231,41,138)"
20922,2020-05-28,New Zealand,1,0,1154,"rgb(231,41,138)"
20923,2020-05-29,New Zealand,0,0,1154,"rgb(231,41,138)"
20924,2020-05-30,New Zealand,0,0,1154,"rgb(231,41,138)"
20925,2020-05-31,New Zealand,0,0,1154,"rgb(231,41,138)"
20926,2020-06-01,New Zealand,0,0,1154,"rgb(231,41,138)"
20927,2020-06-02,New Zealand,0,0,1154,"rgb(231,41,138)"
20928,2020-06-03,New Zealand,0,0,1154,"rgb(231,41,138)"
20929,2020-06-04,New Zealand,0,0,1154,"rgb(231,41,138)"
20930,2020-06-05,New Zealand,0,0,1154,"rgb(231,41,138)"
20931,2020-06-06,New Zealand,0,0,1154,"rgb(231,41,138)"
20932,2020-06-07,New Zealand,0,0,1154,"rgb(231,41,138)"
20933,2020-06-08,New Zealand,0,0,1154,"rgb(231,41,138)"
20934,2020-06-09,New Zealand,0,0,1154,"rgb(231,41,138)"
20935,2020-06-10,New Zealand,0,0,1154,"rgb(231,41,138)"
20936,2020-06-11,New Zealand,0,0,1154,"rgb(231,41,138)"
20937,2020-06-12,New Zealand,0,0,1154,"rgb(231,41,138)"
20938,2020-06-13,New Zealand,0,0,1154,"rgb(231,41,138)"
20939,2020-06-14,New Zealand,0,0,1154,"rgb(231,41,138)"
20940,2020-06-15,New Zealand,0,0,1154,"rgb(231,41,138)"
20941,2020-06-16,New Zealand,0,2,1156,"rgb(231,41,138)"
20942,2020-06-17,New Zealand,0,0,1156,"rgb(231,41,138)"
20943,2020-06-18,New Zealand,0,1,1157,"rgb(231,41,138)"
20944,2020-06-19,New Zealand,0,0,1157,"rgb(231,41,138)"
20945,2020-06-20,New Zealand,0,2,1159,"rgb(231,41,138)"
20946,2020-06-21,New Zealand,0,2,1161,"rgb(231,41,138)"
20947,2020-06-22,New Zealand,0,2,1163,"rgb(231,41,138)"
20948,2020-06-23,New Zealand,0,2,1165,"rgb(231,41,138)"
20949,2020-06-24,New Zealand,0,1,1166,"rgb(231,41,138)"
20950,2020-06-25,New Zealand,0,3,1169,"rgb(231,41,138)"
20951,2020-06-26,New Zealand,0,1,1170,"rgb(231,41,138)"
20952,2020-06-27,New Zealand,0,2,1172,"rgb(231,41,138)"
20953,2020-06-28,New Zealand,0,4,1176,"rgb(231,41,138)"
20954,2020-06-29,New Zealand,0,2,1178,"rgb(231,41,138)"
20955,2020-06-30,New Zealand,0,0,1178,"rgb(231,41,138)"
20956,2020-07-01,New Zealand,0,0,1178,"rgb(231,41,138)"
20957,2020-07-02,New Zealand,0,2,1180,"rgb(231,41,138)"
20958,2020-07-03,New Zealand,0,0,1180,"rgb(231,41,138)"
20959,2020-07-04,New Zealand,0,0,1180,"rgb(231,41,138)"
20960,2020-07-05,New Zealand,0,3,1183,"rgb(231,41,138)"
20961,2020-07-06,New Zealand,0,0,1183,"rgb(231,41,138)"
20962,2020-07-07,New Zealand,0,3,1186,"rgb(231,41,138)"
20963,2020-07-08,New Zealand,0,1,1187,"rgb(231,41,138)"
20964,2020-07-09,New Zealand,0,3,1190,"rgb(231,41,138)"
20965,2020-07-10,New Zealand,0,2,1192,"rgb(231,41,138)"
20966,2020-07-11,New Zealand,0,1,1193,"rgb(231,41,138)"
20967,2020-07-12,New Zealand,0,1,1194,"rgb(231,41,138)"
20968,2020-07-13,New Zealand,0,0,1194,"rgb(231,41,138)"
20969,2019-12-31,Oman,0,0,0,"rgb(102,166,30)"
20970,2020-01-01,Oman,0,0,0,"rgb(102,166,30)"
20971,2020-01-02,Oman,0,0,0,"rgb(102,166,30)"
20972,2020-01-03,Oman,0,0,0,"rgb(102,166,30)"
20973,2020-01-04,Oman,0,0,0,"rgb(102,166,30)"
20974,2020-01-05,Oman,0,0,0,"rgb(102,166,30)"
20975,2020-01-06,Oman,0,0,0,"rgb(102,166,30)"
20976,2020-01-07,Oman,0,0,0,"rgb(102,166,30)"
20977,2020-01-08,Oman,0,0,0,"rgb(102,166,30)"
20978,2020-01-09,Oman,0,0,0,"rgb(102,166,30)"
20979,2020-01-10,Oman,0,0,0,"rgb(102,166,30)"
20980,2020-01-11,Oman,0,0,0,"rgb(102,166,30)"
20981,2020-01-12,Oman,0,0,0,"rgb(102,166,30)"
20982,2020-01-13,Oman,0,0,0,"rgb(102,166,30)"
20983,2020-01-14,Oman,0,0,0,"rgb(102,166,30)"
20984,2020-01-15,Oman,0,0,0,"rgb(102,166,30)"
20985,2020-01-16,Oman,0,0,0,"rgb(102,166,30)"
20986,2020-01-17,Oman,0,0,0,"rgb(102,166,30)"
20987,2020-01-18,Oman,0,0,0,"rgb(102,166,30)"
20988,2020-01-19,Oman,0,0,0,"rgb(102,166,30)"
20989,2020-01-20,Oman,0,0,0,"rgb(102,166,30)"
20990,2020-01-21,Oman,0,0,0,"rgb(102,166,30)"
20991,2020-01-22,Oman,0,0,0,"rgb(102,166,30)"
20992,2020-01-23,Oman,0,0,0,"rgb(102,166,30)"
20993,2020-01-24,Oman,0,0,0,"rgb(102,166,30)"
20994,2020-01-25,Oman,0,0,0,"rgb(102,166,30)"
20995,2020-01-26,Oman,0,0,0,"rgb(102,166,30)"
20996,2020-01-27,Oman,0,0,0,"rgb(102,166,30)"
20997,2020-01-28,Oman,0,0,0,"rgb(102,166,30)"
20998,2020-01-29,Oman,0,0,0,"rgb(102,166,30)"
20999,2020-01-30,Oman,0,0,0,"rgb(102,166,30)"
21000,2020-01-31,Oman,0,0,0,"rgb(102,166,30)"
21001,2020-02-01,Oman,0,0,0,"rgb(102,166,30)"
21002,2020-02-02,Oman,0,0,0,"rgb(102,166,30)"
21003,2020-02-03,Oman,0,0,0,"rgb(102,166,30)"
21004,2020-02-04,Oman,0,0,0,"rgb(102,166,30)"
21005,2020-02-05,Oman,0,0,0,"rgb(102,166,30)"
21006,2020-02-06,Oman,0,0,0,"rgb(102,166,30)"
21007,2020-02-07,Oman,0,0,0,"rgb(102,166,30)"
21008,2020-02-08,Oman,0,0,0,"rgb(102,166,30)"
21009,2020-02-09,Oman,0,0,0,"rgb(102,166,30)"
21010,2020-02-10,Oman,0,0,0,"rgb(102,166,30)"
21011,2020-02-11,Oman,0,0,0,"rgb(102,166,30)"
21012,2020-02-12,Oman,0,0,0,"rgb(102,166,30)"
21013,2020-02-13,Oman,0,0,0,"rgb(102,166,30)"
21014,2020-02-14,Oman,0,0,0,"rgb(102,166,30)"
21015,2020-02-15,Oman,0,0,0,"rgb(102,166,30)"
21016,2020-02-16,Oman,0,0,0,"rgb(102,166,30)"
21017,2020-02-17,Oman,0,0,0,"rgb(102,166,30)"
21018,2020-02-18,Oman,0,0,0,"rgb(102,166,30)"
21019,2020-02-19,Oman,0,0,0,"rgb(102,166,30)"
21020,2020-02-20,Oman,0,0,0,"rgb(102,166,30)"
21021,2020-02-21,Oman,0,0,0,"rgb(102,166,30)"
21022,2020-02-22,Oman,0,0,0,"rgb(102,166,30)"
21023,2020-02-23,Oman,0,0,0,"rgb(102,166,30)"
21024,2020-02-24,Oman,0,0,0,"rgb(102,166,30)"
21025,2020-02-25,Oman,0,2,2,"rgb(102,166,30)"
21026,2020-02-26,Oman,0,2,4,"rgb(102,166,30)"
21027,2020-02-27,Oman,0,0,4,"rgb(102,166,30)"
21028,2020-02-28,Oman,0,2,6,"rgb(102,166,30)"
21029,2020-02-29,Oman,0,0,6,"rgb(102,166,30)"
21030,2020-03-01,Oman,0,0,6,"rgb(102,166,30)"
21031,2020-03-02,Oman,0,0,6,"rgb(102,166,30)"
21032,2020-03-03,Oman,0,1,7,"rgb(102,166,30)"
21033,2020-03-05,Oman,0,8,15,"rgb(102,166,30)"
21034,2020-03-06,Oman,0,1,16,"rgb(102,166,30)"
21035,2020-03-10,Oman,0,2,18,"rgb(102,166,30)"
21036,2020-03-11,Oman,0,0,18,"rgb(102,166,30)"
21037,2020-03-14,Oman,0,2,20,"rgb(102,166,30)"
21038,2020-03-15,Oman,0,0,20,"rgb(102,166,30)"
21039,2020-03-16,Oman,0,2,22,"rgb(102,166,30)"
21040,2020-03-17,Oman,0,2,24,"rgb(102,166,30)"
21041,2020-03-18,Oman,0,0,24,"rgb(102,166,30)"
21042,2020-03-19,Oman,0,15,39,"rgb(102,166,30)"
21043,2020-03-20,Oman,0,0,39,"rgb(102,166,30)"
21044,2020-03-21,Oman,0,9,48,"rgb(102,166,30)"
21045,2020-03-22,Oman,0,4,52,"rgb(102,166,30)"
21046,2020-03-23,Oman,0,3,55,"rgb(102,166,30)"
21047,2020-03-24,Oman,0,11,66,"rgb(102,166,30)"
21048,2020-03-25,Oman,0,18,84,"rgb(102,166,30)"
21049,2020-03-26,Oman,0,15,99,"rgb(102,166,30)"
21050,2020-03-27,Oman,0,10,109,"rgb(102,166,30)"
21051,2020-03-28,Oman,0,22,131,"rgb(102,166,30)"
21052,2020-03-29,Oman,0,21,152,"rgb(102,166,30)"
21053,2020-03-30,Oman,0,15,167,"rgb(102,166,30)"
21054,2020-03-31,Oman,0,12,179,"rgb(102,166,30)"
21055,2020-04-01,Oman,1,13,192,"rgb(102,166,30)"
21056,2020-04-02,Oman,0,18,210,"rgb(102,166,30)"
21057,2020-04-03,Oman,0,21,231,"rgb(102,166,30)"
21058,2020-04-04,Oman,0,0,231,"rgb(102,166,30)"
21059,2020-04-05,Oman,1,46,277,"rgb(102,166,30)"
21060,2020-04-06,Oman,0,21,298,"rgb(102,166,30)"
21061,2020-04-07,Oman,0,73,371,"rgb(102,166,30)"
21062,2020-04-08,Oman,0,48,419,"rgb(102,166,30)"
21063,2020-04-09,Oman,0,0,419,"rgb(102,166,30)"
21064,2020-04-10,Oman,1,38,457,"rgb(102,166,30)"
21065,2020-04-11,Oman,0,27,484,"rgb(102,166,30)"
21066,2020-04-12,Oman,0,62,546,"rgb(102,166,30)"
21067,2020-04-13,Oman,1,53,599,"rgb(102,166,30)"
21068,2020-04-14,Oman,0,214,813,"rgb(102,166,30)"
21069,2020-04-15,Oman,0,97,910,"rgb(102,166,30)"
21070,2020-04-16,Oman,0,0,910,"rgb(102,166,30)"
21071,2020-04-17,Oman,0,109,1019,"rgb(102,166,30)"
21072,2020-04-18,Oman,2,50,1069,"rgb(102,166,30)"
21073,2020-04-19,Oman,0,111,1180,"rgb(102,166,30)"
21074,2020-04-20,Oman,1,86,1266,"rgb(102,166,30)"
21075,2020-04-21,Oman,1,242,1508,"rgb(102,166,30)"
21076,2020-04-22,Oman,0,0,1508,"rgb(102,166,30)"
21077,2020-04-23,Oman,0,106,1614,"rgb(102,166,30)"
21078,2020-04-24,Oman,1,102,1716,"rgb(102,166,30)"
21079,2020-04-25,Oman,1,74,1790,"rgb(102,166,30)"
21080,2020-04-26,Oman,0,115,1905,"rgb(102,166,30)"
21081,2020-04-27,Oman,0,93,1998,"rgb(102,166,30)"
21082,2020-04-28,Oman,0,51,2049,"rgb(102,166,30)"
21083,2020-04-29,Oman,0,82,2131,"rgb(102,166,30)"
21084,2020-04-30,Oman,0,143,2274,"rgb(102,166,30)"
21085,2020-05-01,Oman,1,74,2348,"rgb(102,166,30)"
21086,2020-05-02,Oman,0,99,2447,"rgb(102,166,30)"
21087,2020-05-03,Oman,1,36,2483,"rgb(102,166,30)"
21088,2020-05-04,Oman,0,85,2568,"rgb(102,166,30)"
21089,2020-05-05,Oman,0,69,2637,"rgb(102,166,30)"
21090,2020-05-06,Oman,0,98,2735,"rgb(102,166,30)"
21091,2020-05-07,Oman,1,168,2903,"rgb(102,166,30)"
21092,2020-05-08,Oman,1,55,2958,"rgb(102,166,30)"
21093,2020-05-09,Oman,1,154,3112,"rgb(102,166,30)"
21094,2020-05-10,Oman,2,112,3224,"rgb(102,166,30)"
21095,2020-05-11,Oman,0,175,3399,"rgb(102,166,30)"
21096,2020-05-12,Oman,0,175,3574,"rgb(102,166,30)"
21097,2020-05-13,Oman,0,147,3721,"rgb(102,166,30)"
21098,2020-05-14,Oman,0,298,4019,"rgb(102,166,30)"
21099,2020-05-15,Oman,2,322,4341,"rgb(102,166,30)"
21100,2020-05-16,Oman,0,284,4625,"rgb(102,166,30)"
21101,2020-05-17,Oman,2,404,5029,"rgb(102,166,30)"
21102,2020-05-18,Oman,1,157,5186,"rgb(102,166,30)"
21103,2020-05-19,Oman,4,193,5379,"rgb(102,166,30)"
21104,2020-05-20,Oman,1,292,5671,"rgb(102,166,30)"
21105,2020-05-21,Oman,3,372,6043,"rgb(102,166,30)"
21106,2020-05-22,Oman,1,327,6370,"rgb(102,166,30)"
21107,2020-05-23,Oman,1,424,6794,"rgb(102,166,30)"
21108,2020-05-24,Oman,4,463,7257,"rgb(102,166,30)"
21109,2020-05-25,Oman,1,513,7770,"rgb(102,166,30)"
21110,2020-05-26,Oman,0,0,7770,"rgb(102,166,30)"
21111,2020-05-27,Oman,0,348,8118,"rgb(102,166,30)"
21112,2020-05-28,Oman,1,255,8373,"rgb(102,166,30)"
21113,2020-05-29,Oman,2,636,9009,"rgb(102,166,30)"
21114,2020-05-30,Oman,0,811,9820,"rgb(102,166,30)"
21115,2020-05-31,Oman,2,603,10423,"rgb(102,166,30)"
21116,2020-06-01,Oman,5,1014,11437,"rgb(102,166,30)"
21117,2020-06-02,Oman,3,786,12223,"rgb(102,166,30)"
21118,2020-06-03,Oman,9,576,12799,"rgb(102,166,30)"
21119,2020-06-04,Oman,8,738,13537,"rgb(102,166,30)"
21120,2020-06-05,Oman,0,779,14316,"rgb(102,166,30)"
21121,2020-06-06,Oman,5,770,15086,"rgb(102,166,30)"
21122,2020-06-07,Oman,0,930,16016,"rgb(102,166,30)"
21123,2020-06-08,Oman,3,866,16882,"rgb(102,166,30)"
21124,2020-06-09,Oman,6,604,17486,"rgb(102,166,30)"
21125,2020-06-10,Oman,2,712,18198,"rgb(102,166,30)"
21126,2020-06-11,Oman,1,689,18887,"rgb(102,166,30)"
21127,2020-06-12,Oman,5,1067,19954,"rgb(102,166,30)"
21128,2020-06-13,Oman,7,1117,21071,"rgb(102,166,30)"
21129,2020-06-14,Oman,3,1006,22077,"rgb(102,166,30)"
21130,2020-06-15,Oman,5,1404,23481,"rgb(102,166,30)"
21131,2020-06-16,Oman,4,1043,24524,"rgb(102,166,30)"
21132,2020-06-17,Oman,6,745,25269,"rgb(102,166,30)"
21133,2020-06-18,Oman,2,810,26079,"rgb(102,166,30)"
21134,2020-06-19,Oman,3,739,26818,"rgb(102,166,30)"
21135,2020-06-20,Oman,6,852,27670,"rgb(102,166,30)"
21136,2020-06-21,Oman,3,896,28566,"rgb(102,166,30)"
21137,2020-06-22,Oman,3,905,29471,"rgb(102,166,30)"
21138,2020-06-23,Oman,6,1605,31076,"rgb(102,166,30)"
21139,2020-06-24,Oman,3,1318,32394,"rgb(102,166,30)"
21140,2020-06-25,Oman,2,1142,33536,"rgb(102,166,30)"
21141,2020-06-26,Oman,2,1366,34902,"rgb(102,166,30)"
21142,2020-06-27,Oman,9,1132,36034,"rgb(102,166,30)"
21143,2020-06-28,Oman,6,919,36953,"rgb(102,166,30)"
21144,2020-06-29,Oman,4,1197,38150,"rgb(102,166,30)"
21145,2020-06-30,Oman,6,910,39060,"rgb(102,166,30)"
21146,2020-07-01,Oman,7,1010,40070,"rgb(102,166,30)"
21147,2020-07-02,Oman,9,1124,41194,"rgb(102,166,30)"
21148,2020-07-03,Oman,3,1361,42555,"rgb(102,166,30)"
21149,2020-07-04,Oman,5,1374,43929,"rgb(102,166,30)"
21150,2020-07-05,Oman,10,1177,45106,"rgb(102,166,30)"
21151,2020-07-06,Oman,10,1072,46178,"rgb(102,166,30)"
21152,2020-07-07,Oman,5,1557,47735,"rgb(102,166,30)"
21153,2020-07-08,Oman,6,1262,48997,"rgb(102,166,30)"
21154,2020-07-09,Oman,9,1210,50207,"rgb(102,166,30)"
21155,2020-07-10,Oman,3,1518,51725,"rgb(102,166,30)"
21156,2020-07-11,Oman,8,1889,53614,"rgb(102,166,30)"
21157,2020-07-12,Oman,4,1083,54697,"rgb(102,166,30)"
21158,2020-07-13,Oman,9,1318,56015,"rgb(102,166,30)"
21159,2020-03-10,Panama,0,1,1,"rgb(230,171,2)"
21160,2020-03-11,Panama,1,6,7,"rgb(230,171,2)"
21161,2020-03-12,Panama,0,7,14,"rgb(230,171,2)"
21162,2020-03-13,Panama,0,13,27,"rgb(230,171,2)"
21163,2020-03-14,Panama,0,9,36,"rgb(230,171,2)"
21164,2020-03-15,Panama,0,7,43,"rgb(230,171,2)"
21165,2020-03-16,Panama,0,0,43,"rgb(230,171,2)"
21166,2020-03-17,Panama,0,26,69,"rgb(230,171,2)"
21167,2020-03-18,Panama,0,17,86,"rgb(230,171,2)"
21168,2020-03-19,Panama,0,23,109,"rgb(230,171,2)"
21169,2020-03-20,Panama,0,28,137,"rgb(230,171,2)"
21170,2020-03-21,Panama,0,63,200,"rgb(230,171,2)"
21171,2020-03-22,Panama,2,45,245,"rgb(230,171,2)"
21172,2020-03-23,Panama,0,68,313,"rgb(230,171,2)"
21173,2020-03-24,Panama,3,32,345,"rgb(230,171,2)"
21174,2020-03-25,Panama,0,98,443,"rgb(230,171,2)"
21175,2020-03-26,Panama,0,145,588,"rgb(230,171,2)"
21176,2020-03-27,Panama,3,86,674,"rgb(230,171,2)"
21177,2020-03-28,Panama,5,112,786,"rgb(230,171,2)"
21178,2020-03-29,Panama,3,115,901,"rgb(230,171,2)"
21179,2020-03-30,Panama,7,88,989,"rgb(230,171,2)"
21180,2020-03-31,Panama,2,86,1075,"rgb(230,171,2)"
21181,2020-04-01,Panama,4,106,1181,"rgb(230,171,2)"
21182,2020-04-02,Panama,2,136,1317,"rgb(230,171,2)"
21183,2020-04-03,Panama,5,158,1475,"rgb(230,171,2)"
21184,2020-04-04,Panama,4,198,1673,"rgb(230,171,2)"
21185,2020-04-05,Panama,5,128,1801,"rgb(230,171,2)"
21186,2020-04-06,Panama,8,187,1988,"rgb(230,171,2)"
21187,2020-04-07,Panama,1,112,2100,"rgb(230,171,2)"
21188,2020-04-08,Panama,4,149,2249,"rgb(230,171,2)"
21189,2020-04-09,Panama,4,279,2528,"rgb(230,171,2)"
21190,2020-04-10,Panama,3,224,2752,"rgb(230,171,2)"
21191,2020-04-11,Panama,8,222,2974,"rgb(230,171,2)"
21192,2020-04-12,Panama,5,260,3234,"rgb(230,171,2)"
21193,2020-04-13,Panama,8,166,3400,"rgb(230,171,2)"
21194,2020-04-14,Panama,7,72,3472,"rgb(230,171,2)"
21195,2020-04-15,Panama,1,102,3574,"rgb(230,171,2)"
21196,2020-04-16,Panama,8,177,3751,"rgb(230,171,2)"
21197,2020-04-17,Panama,6,265,4016,"rgb(230,171,2)"
21198,2020-04-18,Panama,7,194,4210,"rgb(230,171,2)"
21199,2020-04-19,Panama,4,63,4273,"rgb(230,171,2)"
21200,2020-04-20,Panama,6,194,4467,"rgb(230,171,2)"
21201,2020-04-21,Panama,10,191,4658,"rgb(230,171,2)"
21202,2020-04-22,Panama,5,163,4821,"rgb(230,171,2)"
21203,2020-04-23,Panama,3,171,4992,"rgb(230,171,2)"
21204,2020-04-24,Panama,2,174,5166,"rgb(230,171,2)"
21205,2020-04-25,Panama,8,172,5338,"rgb(230,171,2)"
21206,2020-04-26,Panama,5,200,5538,"rgb(230,171,2)"
21207,2020-04-27,Panama,6,241,5779,"rgb(230,171,2)"
21208,2020-04-28,Panama,2,242,6021,"rgb(230,171,2)"
21209,2020-04-29,Panama,9,179,6200,"rgb(230,171,2)"
21210,2020-04-30,Panama,2,178,6378,"rgb(230,171,2)"
21211,2020-05-01,Panama,10,154,6532,"rgb(230,171,2)"
21212,2020-05-02,Panama,4,188,6720,"rgb(230,171,2)"
21213,2020-05-03,Panama,5,370,7090,"rgb(230,171,2)"
21214,2020-05-04,Panama,3,107,7197,"rgb(230,171,2)"
21215,2020-05-05,Panama,3,190,7387,"rgb(230,171,2)"
21216,2020-05-06,Panama,7,136,7523,"rgb(230,171,2)"
21217,2020-05-07,Panama,8,208,7731,"rgb(230,171,2)"
21218,2020-05-08,Panama,7,137,7868,"rgb(230,171,2)"
21219,2020-05-09,Panama,6,202,8070,"rgb(230,171,2)"
21220,2020-05-10,Panama,6,212,8282,"rgb(230,171,2)"
21221,2020-05-11,Panama,7,166,8448,"rgb(230,171,2)"
21222,2020-05-12,Panama,5,168,8616,"rgb(230,171,2)"
21223,2020-05-13,Panama,3,167,8783,"rgb(230,171,2)"
21224,2020-05-14,Panama,4,161,8944,"rgb(230,171,2)"
21225,2020-05-15,Panama,4,174,9118,"rgb(230,171,2)"
21226,2020-05-16,Panama,6,150,9268,"rgb(230,171,2)"
21227,2020-05-17,Panama,3,181,9449,"rgb(230,171,2)"
21228,2020-05-18,Panama,6,157,9606,"rgb(230,171,2)"
21229,2020-05-19,Panama,4,120,9726,"rgb(230,171,2)"
21230,2020-05-20,Panama,2,141,9867,"rgb(230,171,2)"
21231,2020-05-21,Panama,6,110,9977,"rgb(230,171,2)"
21232,2020-05-22,Panama,4,139,10116,"rgb(230,171,2)"
21233,2020-05-23,Panama,4,151,10267,"rgb(230,171,2)"
21234,2020-05-24,Panama,4,310,10577,"rgb(230,171,2)"
21235,2020-05-25,Panama,7,349,10926,"rgb(230,171,2)"
21236,2020-05-26,Panama,4,257,11183,"rgb(230,171,2)"
21237,2020-05-27,Panama,3,264,11447,"rgb(230,171,2)"
21238,2020-05-28,Panama,2,281,11728,"rgb(230,171,2)"
21239,2020-05-29,Panama,5,403,12131,"rgb(230,171,2)"
21240,2020-05-30,Panama,6,400,12531,"rgb(230,171,2)"
21241,2020-05-31,Panama,4,487,13018,"rgb(230,171,2)"
21242,2020-06-01,Panama,6,445,13463,"rgb(230,171,2)"
21243,2020-06-02,Panama,8,374,13837,"rgb(230,171,2)"
21244,2020-06-03,Panama,8,258,14095,"rgb(230,171,2)"
21245,2020-06-04,Panama,5,514,14609,"rgb(230,171,2)"
21246,2020-06-05,Panama,6,435,15044,"rgb(230,171,2)"
21247,2020-06-06,Panama,7,419,15463,"rgb(230,171,2)"
21248,2020-06-07,Panama,16,541,16004,"rgb(230,171,2)"
21249,2020-06-08,Panama,7,421,16425,"rgb(230,171,2)"
21250,2020-06-09,Panama,5,429,16854,"rgb(230,171,2)"
21251,2020-06-10,Panama,5,379,17233,"rgb(230,171,2)"
21252,2020-06-11,Panama,10,656,17889,"rgb(230,171,2)"
21253,2020-06-12,Panama,5,697,18586,"rgb(230,171,2)"
21254,2020-06-13,Panama,3,625,19211,"rgb(230,171,2)"
21255,2020-06-14,Panama,8,848,20059,"rgb(230,171,2)"
21256,2020-06-15,Panama,8,627,20686,"rgb(230,171,2)"
21257,2020-06-16,Panama,11,736,21422,"rgb(230,171,2)"
21258,2020-06-17,Panama,9,540,21962,"rgb(230,171,2)"
21259,2020-06-18,Panama,13,635,22597,"rgb(230,171,2)"
21260,2020-06-19,Panama,5,754,23351,"rgb(230,171,2)"
21261,2020-06-20,Panama,10,923,24274,"rgb(230,171,2)"
21262,2020-06-21,Panama,8,948,25222,"rgb(230,171,2)"
21263,2020-06-22,Panama,8,808,26030,"rgb(230,171,2)"
21264,2020-06-23,Panama,20,722,26752,"rgb(230,171,2)"
21265,2020-06-24,Panama,15,562,27314,"rgb(230,171,2)"
21266,2020-06-25,Panama,11,716,28030,"rgb(230,171,2)"
21267,2020-06-26,Panama,17,1007,29037,"rgb(230,171,2)"
21268,2020-06-27,Panama,11,868,29905,"rgb(230,171,2)"
21269,2020-06-28,Panama,17,753,30658,"rgb(230,171,2)"
21270,2020-06-29,Panama,12,1028,31686,"rgb(230,171,2)"
21271,2020-06-30,Panama,16,1099,32785,"rgb(230,171,2)"
21272,2020-07-01,Panama,11,765,33550,"rgb(230,171,2)"
21273,2020-07-02,Panama,14,913,34463,"rgb(230,171,2)"
21274,2020-07-03,Panama,22,774,35237,"rgb(230,171,2)"
21275,2020-07-04,Panama,31,758,35995,"rgb(230,171,2)"
21276,2020-07-05,Panama,22,988,36983,"rgb(230,171,2)"
21277,2020-07-06,Panama,27,1166,38149,"rgb(230,171,2)"
21278,2020-07-07,Panama,23,1185,39334,"rgb(230,171,2)"
21279,2020-07-08,Panama,29,957,40291,"rgb(230,171,2)"
21280,2020-07-09,Panama,20,960,41251,"rgb(230,171,2)"
21281,2020-07-10,Panama,20,965,42216,"rgb(230,171,2)"
21282,2020-07-11,Panama,24,1041,43257,"rgb(230,171,2)"
21283,2020-07-12,Panama,30,1075,44332,"rgb(230,171,2)"
21284,2020-07-13,Panama,16,1301,45633,"rgb(230,171,2)"
21285,2020-03-07,Peru,0,1,1,"rgb(166,118,29)"
21286,2020-03-09,Peru,0,6,7,"rgb(166,118,29)"
21287,2020-03-10,Peru,0,2,9,"rgb(166,118,29)"
21288,2020-03-11,Peru,0,2,11,"rgb(166,118,29)"
21289,2020-03-12,Peru,0,6,17,"rgb(166,118,29)"
21290,2020-03-13,Peru,0,5,22,"rgb(166,118,29)"
21291,2020-03-14,Peru,0,16,38,"rgb(166,118,29)"
21292,2020-03-15,Peru,0,5,43,"rgb(166,118,29)"
21293,2020-03-16,Peru,0,28,71,"rgb(166,118,29)"
21294,2020-03-17,Peru,0,15,86,"rgb(166,118,29)"
21295,2020-03-18,Peru,0,31,117,"rgb(166,118,29)"
21296,2020-03-19,Peru,0,28,145,"rgb(166,118,29)"
21297,2020-03-20,Peru,2,89,234,"rgb(166,118,29)"
21298,2020-03-21,Peru,1,29,263,"rgb(166,118,29)"
21299,2020-03-22,Peru,2,55,318,"rgb(166,118,29)"
21300,2020-03-23,Peru,0,45,363,"rgb(166,118,29)"
21301,2020-03-24,Peru,0,32,395,"rgb(166,118,29)"
21302,2020-03-25,Peru,2,21,416,"rgb(166,118,29)"
21303,2020-03-26,Peru,1,142,558,"rgb(166,118,29)"
21304,2020-03-27,Peru,1,22,580,"rgb(166,118,29)"
21305,2020-03-28,Peru,2,55,635,"rgb(166,118,29)"
21306,2020-03-29,Peru,5,36,671,"rgb(166,118,29)"
21307,2020-03-30,Peru,2,181,852,"rgb(166,118,29)"
21308,2020-03-31,Peru,6,98,950,"rgb(166,118,29)"
21309,2020-04-01,Peru,6,115,1065,"rgb(166,118,29)"
21310,2020-04-02,Peru,17,258,1323,"rgb(166,118,29)"
21311,2020-04-03,Peru,8,91,1414,"rgb(166,118,29)"
21312,2020-04-04,Peru,6,181,1595,"rgb(166,118,29)"
21313,2020-04-05,Peru,12,151,1746,"rgb(166,118,29)"
21314,2020-04-06,Peru,10,535,2281,"rgb(166,118,29)"
21315,2020-04-07,Peru,9,280,2561,"rgb(166,118,29)"
21316,2020-04-08,Peru,15,393,2954,"rgb(166,118,29)"
21317,2020-04-09,Peru,14,1388,4342,"rgb(166,118,29)"
21318,2020-04-10,Peru,17,914,5256,"rgb(166,118,29)"
21319,2020-04-11,Peru,31,641,5897,"rgb(166,118,29)"
21320,2020-04-12,Peru,12,951,6848,"rgb(166,118,29)"
21321,2020-04-13,Peru,12,671,7519,"rgb(166,118,29)"
21322,2020-04-14,Peru,0,0,7519,"rgb(166,118,29)"
21323,2020-04-15,Peru,37,2784,10303,"rgb(166,118,29)"
21324,2020-04-16,Peru,24,1172,11475,"rgb(166,118,29)"
21325,2020-04-17,Peru,20,1016,12491,"rgb(166,118,29)"
21326,2020-04-18,Peru,26,998,13489,"rgb(166,118,29)"
21327,2020-04-19,Peru,48,931,14420,"rgb(166,118,29)"
21328,2020-04-20,Peru,52,1208,15628,"rgb(166,118,29)"
21329,2020-04-21,Peru,45,697,16325,"rgb(166,118,29)"
21330,2020-04-22,Peru,39,1512,17837,"rgb(166,118,29)"
21331,2020-04-23,Peru,46,1413,19250,"rgb(166,118,29)"
21332,2020-04-24,Peru,42,1664,20914,"rgb(166,118,29)"
21333,2020-04-25,Peru,62,734,21648,"rgb(166,118,29)"
21334,2020-04-26,Peru,66,3683,25331,"rgb(166,118,29)"
21335,2020-04-27,Peru,28,2186,27517,"rgb(166,118,29)"
21336,2020-04-28,Peru,54,1182,28699,"rgb(166,118,29)"
21337,2020-04-29,Peru,72,2491,31190,"rgb(166,118,29)"
21338,2020-04-30,Peru,89,2741,33931,"rgb(166,118,29)"
21339,2020-05-01,Peru,108,3045,36976,"rgb(166,118,29)"
21340,2020-05-02,Peru,73,3483,40459,"rgb(166,118,29)"
21341,2020-05-03,Peru,76,2075,42534,"rgb(166,118,29)"
21342,2020-05-04,Peru,86,3394,45928,"rgb(166,118,29)"
21343,2020-05-05,Peru,58,1444,47372,"rgb(166,118,29)"
21344,2020-05-06,Peru,100,3817,51189,"rgb(166,118,29)"
21345,2020-05-07,Peru,89,3628,54817,"rgb(166,118,29)"
21346,2020-05-08,Peru,94,3709,58526,"rgb(166,118,29)"
21347,2020-05-09,Peru,87,3321,61847,"rgb(166,118,29)"
21348,2020-05-10,Peru,100,3168,65015,"rgb(166,118,29)"
21349,2020-05-11,Peru,75,2292,67307,"rgb(166,118,29)"
21350,2020-05-12,Peru,72,1515,68822,"rgb(166,118,29)"
21351,2020-05-13,Peru,96,3237,72059,"rgb(166,118,29)"
21352,2020-05-14,Peru,112,4247,76306,"rgb(166,118,29)"
21353,2020-05-15,Peru,98,4298,80604,"rgb(166,118,29)"
21354,2020-05-16,Peru,126,3891,84495,"rgb(166,118,29)"
21355,2020-05-17,Peru,130,4046,88541,"rgb(166,118,29)"
21356,2020-05-18,Peru,125,3732,92273,"rgb(166,118,29)"
21357,2020-05-19,Peru,141,2660,94933,"rgb(166,118,29)"
21358,2020-05-20,Peru,125,4550,99483,"rgb(166,118,29)"
21359,2020-05-21,Peru,110,4537,104020,"rgb(166,118,29)"
21360,2020-05-22,Peru,124,4749,108769,"rgb(166,118,29)"
21361,2020-05-23,Peru,96,2929,111698,"rgb(166,118,29)"
21362,2020-05-24,Peru,129,4056,115754,"rgb(166,118,29)"
21363,2020-05-25,Peru,83,4205,119959,"rgb(166,118,29)"
21364,2020-05-26,Peru,173,4020,123979,"rgb(166,118,29)"
21365,2020-05-27,Peru,159,5772,129751,"rgb(166,118,29)"
21366,2020-05-28,Peru,195,6154,135905,"rgb(166,118,29)"
21367,2020-05-29,Peru,116,5874,141779,"rgb(166,118,29)"
21368,2020-05-30,Peru,131,6506,148285,"rgb(166,118,29)"
21369,2020-05-31,Peru,141,7386,155671,"rgb(166,118,29)"
21370,2020-06-01,Peru,135,8805,164476,"rgb(166,118,29)"
21371,2020-06-02,Peru,128,5563,170039,"rgb(166,118,29)"
21372,2020-06-03,Peru,0,0,170039,"rgb(166,118,29)"
21373,2020-06-04,Peru,260,8875,178914,"rgb(166,118,29)"
21374,2020-06-05,Peru,137,4284,183198,"rgb(166,118,29)"
21375,2020-06-06,Peru,131,4202,187400,"rgb(166,118,29)"
21376,2020-06-07,Peru,139,4358,191758,"rgb(166,118,29)"
21377,2020-06-08,Peru,164,4757,196515,"rgb(166,118,29)"
21378,2020-06-09,Peru,106,3181,199696,"rgb(166,118,29)"
21379,2020-06-10,Peru,167,4040,203736,"rgb(166,118,29)"
21380,2020-06-11,Peru,165,5087,208823,"rgb(166,118,29)"
21381,2020-06-12,Peru,206,5965,214788,"rgb(166,118,29)"
21382,2020-06-13,Peru,199,5961,220749,"rgb(166,118,29)"
21383,2020-06-14,Peru,190,4383,225132,"rgb(166,118,29)"
21384,2020-06-15,Peru,190,4604,229736,"rgb(166,118,29)"
21385,2020-06-16,Peru,172,3256,232992,"rgb(166,118,29)"
21386,2020-06-17,Peru,196,4164,237156,"rgb(166,118,29)"
21387,2020-06-18,Peru,201,3752,240908,"rgb(166,118,29)"
21388,2020-06-19,Peru,204,3480,244388,"rgb(166,118,29)"
21389,2020-06-20,Peru,199,3537,247925,"rgb(166,118,29)"
21390,2020-06-21,Peru,201,3413,251338,"rgb(166,118,29)"
21391,2020-06-22,Peru,184,3598,254936,"rgb(166,118,29)"
21392,2020-06-23,Peru,0,0,254936,"rgb(166,118,29)"
21393,2020-06-24,Peru,359,5874,260810,"rgb(166,118,29)"
21394,2020-06-25,Peru,182,3879,264689,"rgb(166,118,29)"
21395,2020-06-26,Peru,175,3913,268602,"rgb(166,118,29)"
21396,2020-06-27,Peru,178,3762,272364,"rgb(166,118,29)"
21397,2020-06-28,Peru,196,3625,275989,"rgb(166,118,29)"
21398,2020-06-29,Peru,182,3430,279419,"rgb(166,118,29)"
21399,2020-06-30,Peru,187,2946,282365,"rgb(166,118,29)"
21400,2020-07-01,Peru,173,2848,285213,"rgb(166,118,29)"
21401,2020-07-02,Peru,183,3264,288477,"rgb(166,118,29)"
21402,2020-07-03,Peru,185,3527,292004,"rgb(166,118,29)"
21403,2020-07-04,Peru,181,3595,295599,"rgb(166,118,29)"
21404,2020-07-05,Peru,186,3481,299080,"rgb(166,118,29)"
21405,2020-07-06,Peru,177,3638,302718,"rgb(166,118,29)"
21406,2020-07-07,Peru,183,2985,305703,"rgb(166,118,29)"
21407,2020-07-08,Peru,180,3575,309278,"rgb(166,118,29)"
21408,2020-07-09,Peru,181,3633,312911,"rgb(166,118,29)"
21409,2020-07-10,Peru,181,3537,316448,"rgb(166,118,29)"
21410,2020-07-11,Peru,186,3198,319646,"rgb(166,118,29)"
21411,2020-07-12,Peru,182,3064,322710,"rgb(166,118,29)"
21412,2020-07-13,Peru,188,3616,326326,"rgb(166,118,29)"
21413,2020-03-19,French Polynesia,0,3,3,"rgb(102,102,102)"
21414,2020-03-20,French Polynesia,0,0,3,"rgb(102,102,102)"
21415,2020-03-21,French Polynesia,0,12,15,"rgb(102,102,102)"
21416,2020-03-22,French Polynesia,0,2,17,"rgb(102,102,102)"
21417,2020-03-23,French Polynesia,0,1,18,"rgb(102,102,102)"
21418,2020-03-24,French Polynesia,0,5,23,"rgb(102,102,102)"
21419,2020-03-25,French Polynesia,0,2,25,"rgb(102,102,102)"
21420,2020-03-26,French Polynesia,0,0,25,"rgb(102,102,102)"
21421,2020-03-27,French Polynesia,0,5,30,"rgb(102,102,102)"
21422,2020-03-28,French Polynesia,0,0,30,"rgb(102,102,102)"
21423,2020-03-29,French Polynesia,0,4,34,"rgb(102,102,102)"
21424,2020-03-30,French Polynesia,0,1,35,"rgb(102,102,102)"
21425,2020-03-31,French Polynesia,0,1,36,"rgb(102,102,102)"
21426,2020-04-01,French Polynesia,0,1,37,"rgb(102,102,102)"
21427,2020-04-02,French Polynesia,0,0,37,"rgb(102,102,102)"
21428,2020-04-03,French Polynesia,0,0,37,"rgb(102,102,102)"
21429,2020-04-04,French Polynesia,0,2,39,"rgb(102,102,102)"
21430,2020-04-05,French Polynesia,0,1,40,"rgb(102,102,102)"
21431,2020-04-06,French Polynesia,0,1,41,"rgb(102,102,102)"
21432,2020-04-07,French Polynesia,0,0,41,"rgb(102,102,102)"
21433,2020-04-08,French Polynesia,0,6,47,"rgb(102,102,102)"
21434,2020-04-09,French Polynesia,0,4,51,"rgb(102,102,102)"
21435,2020-04-10,French Polynesia,0,0,51,"rgb(102,102,102)"
21436,2020-04-11,French Polynesia,0,0,51,"rgb(102,102,102)"
21437,2020-04-12,French Polynesia,0,0,51,"rgb(102,102,102)"
21438,2020-04-13,French Polynesia,0,2,53,"rgb(102,102,102)"
21439,2020-04-14,French Polynesia,0,2,55,"rgb(102,102,102)"
21440,2020-04-15,French Polynesia,0,0,55,"rgb(102,102,102)"
21441,2020-04-16,French Polynesia,0,0,55,"rgb(102,102,102)"
21442,2020-04-17,French Polynesia,0,0,55,"rgb(102,102,102)"
21443,2020-04-18,French Polynesia,0,0,55,"rgb(102,102,102)"
21444,2020-04-19,French Polynesia,0,0,55,"rgb(102,102,102)"
21445,2020-04-20,French Polynesia,0,0,55,"rgb(102,102,102)"
21446,2020-04-21,French Polynesia,0,1,56,"rgb(102,102,102)"
21447,2020-04-22,French Polynesia,0,1,57,"rgb(102,102,102)"
21448,2020-04-23,French Polynesia,0,0,57,"rgb(102,102,102)"
21449,2020-04-24,French Polynesia,0,0,57,"rgb(102,102,102)"
21450,2020-04-25,French Polynesia,0,0,57,"rgb(102,102,102)"
21451,2020-04-26,French Polynesia,0,0,57,"rgb(102,102,102)"
21452,2020-04-27,French Polynesia,0,0,57,"rgb(102,102,102)"
21453,2020-04-28,French Polynesia,0,1,58,"rgb(102,102,102)"
21454,2020-04-29,French Polynesia,0,0,58,"rgb(102,102,102)"
21455,2020-04-30,French Polynesia,0,0,58,"rgb(102,102,102)"
21456,2020-05-01,French Polynesia,0,0,58,"rgb(102,102,102)"
21457,2020-05-02,French Polynesia,0,0,58,"rgb(102,102,102)"
21458,2020-05-03,French Polynesia,0,0,58,"rgb(102,102,102)"
21459,2020-05-04,French Polynesia,0,0,58,"rgb(102,102,102)"
21460,2020-05-05,French Polynesia,0,0,58,"rgb(102,102,102)"
21461,2020-05-06,French Polynesia,0,2,60,"rgb(102,102,102)"
21462,2020-05-07,French Polynesia,0,0,60,"rgb(102,102,102)"
21463,2020-05-08,French Polynesia,0,0,60,"rgb(102,102,102)"
21464,2020-05-09,French Polynesia,0,0,60,"rgb(102,102,102)"
21465,2020-05-10,French Polynesia,0,0,60,"rgb(102,102,102)"
21466,2020-05-11,French Polynesia,0,0,60,"rgb(102,102,102)"
21467,2020-05-12,French Polynesia,0,0,60,"rgb(102,102,102)"
21468,2020-05-13,French Polynesia,0,0,60,"rgb(102,102,102)"
21469,2020-05-14,French Polynesia,0,0,60,"rgb(102,102,102)"
21470,2020-05-15,French Polynesia,0,0,60,"rgb(102,102,102)"
21471,2020-05-16,French Polynesia,0,0,60,"rgb(102,102,102)"
21472,2020-05-17,French Polynesia,0,0,60,"rgb(102,102,102)"
21473,2020-05-18,French Polynesia,0,0,60,"rgb(102,102,102)"
21474,2020-05-19,French Polynesia,0,0,60,"rgb(102,102,102)"
21475,2020-05-20,French Polynesia,0,0,60,"rgb(102,102,102)"
21476,2020-05-21,French Polynesia,0,0,60,"rgb(102,102,102)"
21477,2020-05-22,French Polynesia,0,0,60,"rgb(102,102,102)"
21478,2020-05-23,French Polynesia,0,0,60,"rgb(102,102,102)"
21479,2020-05-24,French Polynesia,0,0,60,"rgb(102,102,102)"
21480,2020-05-25,French Polynesia,0,0,60,"rgb(102,102,102)"
21481,2020-05-26,French Polynesia,0,0,60,"rgb(102,102,102)"
21482,2020-05-27,French Polynesia,0,0,60,"rgb(102,102,102)"
21483,2020-05-28,French Polynesia,0,0,60,"rgb(102,102,102)"
21484,2020-05-29,French Polynesia,0,0,60,"rgb(102,102,102)"
21485,2020-05-30,French Polynesia,0,0,60,"rgb(102,102,102)"
21486,2020-05-31,French Polynesia,0,0,60,"rgb(102,102,102)"
21487,2020-06-01,French Polynesia,0,0,60,"rgb(102,102,102)"
21488,2020-06-02,French Polynesia,0,0,60,"rgb(102,102,102)"
21489,2020-06-03,French Polynesia,0,0,60,"rgb(102,102,102)"
21490,2020-06-04,French Polynesia,0,0,60,"rgb(102,102,102)"
21491,2020-06-05,French Polynesia,0,0,60,"rgb(102,102,102)"
21492,2020-06-06,French Polynesia,0,0,60,"rgb(102,102,102)"
21493,2020-06-07,French Polynesia,0,0,60,"rgb(102,102,102)"
21494,2020-06-08,French Polynesia,0,0,60,"rgb(102,102,102)"
21495,2020-06-09,French Polynesia,0,0,60,"rgb(102,102,102)"
21496,2020-06-10,French Polynesia,0,0,60,"rgb(102,102,102)"
21497,2020-06-11,French Polynesia,0,0,60,"rgb(102,102,102)"
21498,2020-06-12,French Polynesia,0,0,60,"rgb(102,102,102)"
21499,2020-06-13,French Polynesia,0,0,60,"rgb(102,102,102)"
21500,2020-06-14,French Polynesia,0,0,60,"rgb(102,102,102)"
21501,2020-06-15,French Polynesia,0,0,60,"rgb(102,102,102)"
21502,2020-06-16,French Polynesia,0,0,60,"rgb(102,102,102)"
21503,2020-06-17,French Polynesia,0,0,60,"rgb(102,102,102)"
21504,2020-06-18,French Polynesia,0,0,60,"rgb(102,102,102)"
21505,2020-06-19,French Polynesia,0,0,60,"rgb(102,102,102)"
21506,2020-06-20,French Polynesia,0,0,60,"rgb(102,102,102)"
21507,2020-06-21,French Polynesia,0,0,60,"rgb(102,102,102)"
21508,2020-06-22,French Polynesia,0,0,60,"rgb(102,102,102)"
21509,2020-06-23,French Polynesia,0,0,60,"rgb(102,102,102)"
21510,2020-06-24,French Polynesia,0,0,60,"rgb(102,102,102)"
21511,2020-06-25,French Polynesia,0,0,60,"rgb(102,102,102)"
21512,2020-06-26,French Polynesia,0,0,60,"rgb(102,102,102)"
21513,2020-06-27,French Polynesia,0,2,62,"rgb(102,102,102)"
21514,2020-06-28,French Polynesia,0,0,62,"rgb(102,102,102)"
21515,2020-06-29,French Polynesia,0,0,62,"rgb(102,102,102)"
21516,2020-06-30,French Polynesia,0,0,62,"rgb(102,102,102)"
21517,2020-07-01,French Polynesia,0,0,62,"rgb(102,102,102)"
21518,2020-07-02,French Polynesia,0,0,62,"rgb(102,102,102)"
21519,2020-07-03,French Polynesia,0,0,62,"rgb(102,102,102)"
21520,2020-07-04,French Polynesia,0,0,62,"rgb(102,102,102)"
21521,2020-07-05,French Polynesia,0,0,62,"rgb(102,102,102)"
21522,2020-07-06,French Polynesia,0,0,62,"rgb(102,102,102)"
21523,2020-07-07,French Polynesia,0,0,62,"rgb(102,102,102)"
21524,2020-07-08,French Polynesia,0,0,62,"rgb(102,102,102)"
21525,2020-07-09,French Polynesia,0,0,62,"rgb(102,102,102)"
21526,2020-07-10,French Polynesia,0,0,62,"rgb(102,102,102)"
21527,2020-07-11,French Polynesia,0,0,62,"rgb(102,102,102)"
21528,2020-07-12,French Polynesia,0,0,62,"rgb(102,102,102)"
21529,2020-07-13,French Polynesia,0,0,62,"rgb(102,102,102)"
21530,2020-03-21,Papua New Guinea,0,1,1,"rgb(102, 197, 204)"
21531,2020-03-22,Papua New Guinea,0,0,1,"rgb(102, 197, 204)"
21532,2020-03-23,Papua New Guinea,0,0,1,"rgb(102, 197, 204)"
21533,2020-03-24,Papua New Guinea,0,0,1,"rgb(102, 197, 204)"
21534,2020-03-25,Papua New Guinea,0,0,1,"rgb(102, 197, 204)"
21535,2020-03-26,Papua New Guinea,0,0,1,"rgb(102, 197, 204)"
21536,2020-03-27,Papua New Guinea,0,0,1,"rgb(102, 197, 204)"
21537,2020-03-28,Papua New Guinea,0,0,1,"rgb(102, 197, 204)"
21538,2020-03-29,Papua New Guinea,0,0,1,"rgb(102, 197, 204)"
21539,2020-03-30,Papua New Guinea,0,0,1,"rgb(102, 197, 204)"
21540,2020-03-31,Papua New Guinea,0,0,1,"rgb(102, 197, 204)"
21541,2020-04-01,Papua New Guinea,0,0,1,"rgb(102, 197, 204)"
21542,2020-04-02,Papua New Guinea,0,0,1,"rgb(102, 197, 204)"
21543,2020-04-03,Papua New Guinea,0,0,1,"rgb(102, 197, 204)"
21544,2020-04-04,Papua New Guinea,0,0,1,"rgb(102, 197, 204)"
21545,2020-04-05,Papua New Guinea,0,0,1,"rgb(102, 197, 204)"
21546,2020-04-06,Papua New Guinea,0,0,1,"rgb(102, 197, 204)"
21547,2020-04-07,Papua New Guinea,0,0,1,"rgb(102, 197, 204)"
21548,2020-04-08,Papua New Guinea,0,1,2,"rgb(102, 197, 204)"
21549,2020-04-09,Papua New Guinea,0,0,2,"rgb(102, 197, 204)"
21550,2020-04-10,Papua New Guinea,0,0,2,"rgb(102, 197, 204)"
21551,2020-04-11,Papua New Guinea,0,0,2,"rgb(102, 197, 204)"
21552,2020-04-12,Papua New Guinea,0,0,2,"rgb(102, 197, 204)"
21553,2020-04-13,Papua New Guinea,0,0,2,"rgb(102, 197, 204)"
21554,2020-04-14,Papua New Guinea,0,0,2,"rgb(102, 197, 204)"
21555,2020-04-15,Papua New Guinea,0,0,2,"rgb(102, 197, 204)"
21556,2020-04-16,Papua New Guinea,0,0,2,"rgb(102, 197, 204)"
21557,2020-04-17,Papua New Guinea,0,5,7,"rgb(102, 197, 204)"
21558,2020-04-18,Papua New Guinea,0,0,7,"rgb(102, 197, 204)"
21559,2020-04-19,Papua New Guinea,0,0,7,"rgb(102, 197, 204)"
21560,2020-04-20,Papua New Guinea,0,0,7,"rgb(102, 197, 204)"
21561,2020-04-21,Papua New Guinea,0,0,7,"rgb(102, 197, 204)"
21562,2020-04-22,Papua New Guinea,0,0,7,"rgb(102, 197, 204)"
21563,2020-04-23,Papua New Guinea,0,1,8,"rgb(102, 197, 204)"
21564,2020-04-24,Papua New Guinea,0,0,8,"rgb(102, 197, 204)"
21565,2020-04-25,Papua New Guinea,0,0,8,"rgb(102, 197, 204)"
21566,2020-04-26,Papua New Guinea,0,0,8,"rgb(102, 197, 204)"
21567,2020-04-27,Papua New Guinea,0,0,8,"rgb(102, 197, 204)"
21568,2020-04-28,Papua New Guinea,0,0,8,"rgb(102, 197, 204)"
21569,2020-04-29,Papua New Guinea,0,0,8,"rgb(102, 197, 204)"
21570,2020-04-30,Papua New Guinea,0,0,8,"rgb(102, 197, 204)"
21571,2020-05-01,Papua New Guinea,0,0,8,"rgb(102, 197, 204)"
21572,2020-05-02,Papua New Guinea,0,0,8,"rgb(102, 197, 204)"
21573,2020-05-03,Papua New Guinea,0,0,8,"rgb(102, 197, 204)"
21574,2020-05-04,Papua New Guinea,0,0,8,"rgb(102, 197, 204)"
21575,2020-05-05,Papua New Guinea,0,0,8,"rgb(102, 197, 204)"
21576,2020-05-06,Papua New Guinea,0,0,8,"rgb(102, 197, 204)"
21577,2020-05-07,Papua New Guinea,0,0,8,"rgb(102, 197, 204)"
21578,2020-05-08,Papua New Guinea,0,0,8,"rgb(102, 197, 204)"
21579,2020-05-09,Papua New Guinea,0,0,8,"rgb(102, 197, 204)"
21580,2020-05-10,Papua New Guinea,0,0,8,"rgb(102, 197, 204)"
21581,2020-05-11,Papua New Guinea,0,0,8,"rgb(102, 197, 204)"
21582,2020-05-12,Papua New Guinea,0,0,8,"rgb(102, 197, 204)"
21583,2020-05-13,Papua New Guinea,0,0,8,"rgb(102, 197, 204)"
21584,2020-05-14,Papua New Guinea,0,0,8,"rgb(102, 197, 204)"
21585,2020-05-15,Papua New Guinea,0,0,8,"rgb(102, 197, 204)"
21586,2020-05-16,Papua New Guinea,0,0,8,"rgb(102, 197, 204)"
21587,2020-05-17,Papua New Guinea,0,0,8,"rgb(102, 197, 204)"
21588,2020-05-18,Papua New Guinea,0,0,8,"rgb(102, 197, 204)"
21589,2020-05-19,Papua New Guinea,0,0,8,"rgb(102, 197, 204)"
21590,2020-05-20,Papua New Guinea,0,0,8,"rgb(102, 197, 204)"
21591,2020-05-21,Papua New Guinea,0,0,8,"rgb(102, 197, 204)"
21592,2020-05-22,Papua New Guinea,0,0,8,"rgb(102, 197, 204)"
21593,2020-05-23,Papua New Guinea,0,0,8,"rgb(102, 197, 204)"
21594,2020-05-24,Papua New Guinea,0,0,8,"rgb(102, 197, 204)"
21595,2020-05-25,Papua New Guinea,0,0,8,"rgb(102, 197, 204)"
21596,2020-05-26,Papua New Guinea,0,0,8,"rgb(102, 197, 204)"
21597,2020-05-27,Papua New Guinea,0,0,8,"rgb(102, 197, 204)"
21598,2020-05-28,Papua New Guinea,0,0,8,"rgb(102, 197, 204)"
21599,2020-05-29,Papua New Guinea,0,0,8,"rgb(102, 197, 204)"
21600,2020-05-30,Papua New Guinea,0,0,8,"rgb(102, 197, 204)"
21601,2020-05-31,Papua New Guinea,0,0,8,"rgb(102, 197, 204)"
21602,2020-06-01,Papua New Guinea,0,0,8,"rgb(102, 197, 204)"
21603,2020-06-02,Papua New Guinea,0,0,8,"rgb(102, 197, 204)"
21604,2020-06-03,Papua New Guinea,0,0,8,"rgb(102, 197, 204)"
21605,2020-06-04,Papua New Guinea,0,0,8,"rgb(102, 197, 204)"
21606,2020-06-05,Papua New Guinea,0,0,8,"rgb(102, 197, 204)"
21607,2020-06-06,Papua New Guinea,0,0,8,"rgb(102, 197, 204)"
21608,2020-06-07,Papua New Guinea,0,0,8,"rgb(102, 197, 204)"
21609,2020-06-08,Papua New Guinea,0,0,8,"rgb(102, 197, 204)"
21610,2020-06-09,Papua New Guinea,0,0,8,"rgb(102, 197, 204)"
21611,2020-06-10,Papua New Guinea,0,0,8,"rgb(102, 197, 204)"
21612,2020-06-11,Papua New Guinea,0,0,8,"rgb(102, 197, 204)"
21613,2020-06-12,Papua New Guinea,0,0,8,"rgb(102, 197, 204)"
21614,2020-06-13,Papua New Guinea,0,0,8,"rgb(102, 197, 204)"
21615,2020-06-14,Papua New Guinea,0,0,8,"rgb(102, 197, 204)"
21616,2020-06-15,Papua New Guinea,0,0,8,"rgb(102, 197, 204)"
21617,2020-06-16,Papua New Guinea,0,0,8,"rgb(102, 197, 204)"
21618,2020-06-17,Papua New Guinea,0,0,8,"rgb(102, 197, 204)"
21619,2020-06-18,Papua New Guinea,0,0,8,"rgb(102, 197, 204)"
21620,2020-06-19,Papua New Guinea,0,0,8,"rgb(102, 197, 204)"
21621,2020-06-20,Papua New Guinea,0,0,8,"rgb(102, 197, 204)"
21622,2020-06-21,Papua New Guinea,0,0,8,"rgb(102, 197, 204)"
21623,2020-06-22,Papua New Guinea,0,1,9,"rgb(102, 197, 204)"
21624,2020-06-23,Papua New Guinea,0,0,9,"rgb(102, 197, 204)"
21625,2020-06-24,Papua New Guinea,0,0,9,"rgb(102, 197, 204)"
21626,2020-06-25,Papua New Guinea,0,1,10,"rgb(102, 197, 204)"
21627,2020-06-26,Papua New Guinea,0,1,11,"rgb(102, 197, 204)"
21628,2020-06-27,Papua New Guinea,0,0,11,"rgb(102, 197, 204)"
21629,2020-06-28,Papua New Guinea,0,0,11,"rgb(102, 197, 204)"
21630,2020-06-29,Papua New Guinea,0,0,11,"rgb(102, 197, 204)"
21631,2020-06-30,Papua New Guinea,0,0,11,"rgb(102, 197, 204)"
21632,2020-07-01,Papua New Guinea,0,0,11,"rgb(102, 197, 204)"
21633,2020-07-02,Papua New Guinea,0,0,11,"rgb(102, 197, 204)"
21634,2020-07-03,Papua New Guinea,0,0,11,"rgb(102, 197, 204)"
21635,2020-07-04,Papua New Guinea,0,0,11,"rgb(102, 197, 204)"
21636,2020-07-05,Papua New Guinea,0,0,11,"rgb(102, 197, 204)"
21637,2020-07-06,Papua New Guinea,0,0,11,"rgb(102, 197, 204)"
21638,2020-07-07,Papua New Guinea,0,0,11,"rgb(102, 197, 204)"
21639,2020-07-08,Papua New Guinea,0,0,11,"rgb(102, 197, 204)"
21640,2020-07-09,Papua New Guinea,0,0,11,"rgb(102, 197, 204)"
21641,2020-07-10,Papua New Guinea,0,0,11,"rgb(102, 197, 204)"
21642,2020-07-11,Papua New Guinea,0,0,11,"rgb(102, 197, 204)"
21643,2020-07-12,Papua New Guinea,0,0,11,"rgb(102, 197, 204)"
21644,2020-07-13,Papua New Guinea,0,0,11,"rgb(102, 197, 204)"
21645,2019-12-31,Philippines,0,0,0,"rgb(246, 207, 113)"
21646,2020-01-01,Philippines,0,0,0,"rgb(246, 207, 113)"
21647,2020-01-02,Philippines,0,0,0,"rgb(246, 207, 113)"
21648,2020-01-03,Philippines,0,0,0,"rgb(246, 207, 113)"
21649,2020-01-04,Philippines,0,0,0,"rgb(246, 207, 113)"
21650,2020-01-05,Philippines,0,0,0,"rgb(246, 207, 113)"
21651,2020-01-06,Philippines,0,0,0,"rgb(246, 207, 113)"
21652,2020-01-07,Philippines,0,0,0,"rgb(246, 207, 113)"
21653,2020-01-08,Philippines,0,0,0,"rgb(246, 207, 113)"
21654,2020-01-09,Philippines,0,0,0,"rgb(246, 207, 113)"
21655,2020-01-10,Philippines,0,0,0,"rgb(246, 207, 113)"
21656,2020-01-11,Philippines,0,0,0,"rgb(246, 207, 113)"
21657,2020-01-12,Philippines,0,0,0,"rgb(246, 207, 113)"
21658,2020-01-13,Philippines,0,0,0,"rgb(246, 207, 113)"
21659,2020-01-14,Philippines,0,0,0,"rgb(246, 207, 113)"
21660,2020-01-15,Philippines,0,0,0,"rgb(246, 207, 113)"
21661,2020-01-16,Philippines,0,0,0,"rgb(246, 207, 113)"
21662,2020-01-17,Philippines,0,0,0,"rgb(246, 207, 113)"
21663,2020-01-18,Philippines,0,0,0,"rgb(246, 207, 113)"
21664,2020-01-19,Philippines,0,0,0,"rgb(246, 207, 113)"
21665,2020-01-20,Philippines,0,0,0,"rgb(246, 207, 113)"
21666,2020-01-21,Philippines,0,0,0,"rgb(246, 207, 113)"
21667,2020-01-22,Philippines,0,0,0,"rgb(246, 207, 113)"
21668,2020-01-23,Philippines,0,0,0,"rgb(246, 207, 113)"
21669,2020-01-24,Philippines,0,0,0,"rgb(246, 207, 113)"
21670,2020-01-25,Philippines,0,0,0,"rgb(246, 207, 113)"
21671,2020-01-26,Philippines,0,0,0,"rgb(246, 207, 113)"
21672,2020-01-27,Philippines,0,0,0,"rgb(246, 207, 113)"
21673,2020-01-28,Philippines,0,0,0,"rgb(246, 207, 113)"
21674,2020-01-29,Philippines,0,0,0,"rgb(246, 207, 113)"
21675,2020-01-30,Philippines,0,1,1,"rgb(246, 207, 113)"
21676,2020-01-31,Philippines,0,0,1,"rgb(246, 207, 113)"
21677,2020-02-01,Philippines,0,0,1,"rgb(246, 207, 113)"
21678,2020-02-02,Philippines,1,1,2,"rgb(246, 207, 113)"
21679,2020-02-03,Philippines,0,0,2,"rgb(246, 207, 113)"
21680,2020-02-04,Philippines,0,0,2,"rgb(246, 207, 113)"
21681,2020-02-05,Philippines,0,0,2,"rgb(246, 207, 113)"
21682,2020-02-06,Philippines,0,1,3,"rgb(246, 207, 113)"
21683,2020-02-07,Philippines,0,0,3,"rgb(246, 207, 113)"
21684,2020-02-08,Philippines,0,0,3,"rgb(246, 207, 113)"
21685,2020-02-09,Philippines,0,0,3,"rgb(246, 207, 113)"
21686,2020-02-10,Philippines,0,0,3,"rgb(246, 207, 113)"
21687,2020-02-11,Philippines,0,0,3,"rgb(246, 207, 113)"
21688,2020-02-12,Philippines,0,0,3,"rgb(246, 207, 113)"
21689,2020-02-13,Philippines,0,0,3,"rgb(246, 207, 113)"
21690,2020-02-14,Philippines,0,0,3,"rgb(246, 207, 113)"
21691,2020-02-15,Philippines,0,0,3,"rgb(246, 207, 113)"
21692,2020-02-16,Philippines,0,0,3,"rgb(246, 207, 113)"
21693,2020-02-17,Philippines,0,0,3,"rgb(246, 207, 113)"
21694,2020-02-18,Philippines,0,0,3,"rgb(246, 207, 113)"
21695,2020-02-19,Philippines,0,0,3,"rgb(246, 207, 113)"
21696,2020-02-20,Philippines,0,0,3,"rgb(246, 207, 113)"
21697,2020-02-21,Philippines,0,0,3,"rgb(246, 207, 113)"
21698,2020-02-22,Philippines,0,0,3,"rgb(246, 207, 113)"
21699,2020-02-23,Philippines,0,0,3,"rgb(246, 207, 113)"
21700,2020-02-24,Philippines,0,0,3,"rgb(246, 207, 113)"
21701,2020-02-25,Philippines,0,0,3,"rgb(246, 207, 113)"
21702,2020-02-26,Philippines,0,0,3,"rgb(246, 207, 113)"
21703,2020-02-27,Philippines,0,0,3,"rgb(246, 207, 113)"
21704,2020-02-28,Philippines,0,0,3,"rgb(246, 207, 113)"
21705,2020-02-29,Philippines,0,0,3,"rgb(246, 207, 113)"
21706,2020-03-01,Philippines,0,0,3,"rgb(246, 207, 113)"
21707,2020-03-02,Philippines,0,0,3,"rgb(246, 207, 113)"
21708,2020-03-07,Philippines,0,2,5,"rgb(246, 207, 113)"
21709,2020-03-08,Philippines,0,1,6,"rgb(246, 207, 113)"
21710,2020-03-09,Philippines,0,4,10,"rgb(246, 207, 113)"
21711,2020-03-10,Philippines,0,23,33,"rgb(246, 207, 113)"
21712,2020-03-11,Philippines,0,0,33,"rgb(246, 207, 113)"
21713,2020-03-12,Philippines,1,16,49,"rgb(246, 207, 113)"
21714,2020-03-13,Philippines,0,3,52,"rgb(246, 207, 113)"
21715,2020-03-14,Philippines,4,12,64,"rgb(246, 207, 113)"
21716,2020-03-15,Philippines,0,47,111,"rgb(246, 207, 113)"
21717,2020-03-16,Philippines,6,29,140,"rgb(246, 207, 113)"
21718,2020-03-17,Philippines,0,2,142,"rgb(246, 207, 113)"
21719,2020-03-18,Philippines,2,45,187,"rgb(246, 207, 113)"
21720,2020-03-19,Philippines,3,15,202,"rgb(246, 207, 113)"
21721,2020-03-20,Philippines,1,28,230,"rgb(246, 207, 113)"
21722,2020-03-21,Philippines,0,0,230,"rgb(246, 207, 113)"
21723,2020-03-22,Philippines,7,150,380,"rgb(246, 207, 113)"
21724,2020-03-23,Philippines,0,0,380,"rgb(246, 207, 113)"
21725,2020-03-24,Philippines,8,82,462,"rgb(246, 207, 113)"
21726,2020-03-25,Philippines,2,90,552,"rgb(246, 207, 113)"
21727,2020-03-26,Philippines,3,84,636,"rgb(246, 207, 113)"
21728,2020-03-27,Philippines,7,71,707,"rgb(246, 207, 113)"
21729,2020-03-28,Philippines,9,96,803,"rgb(246, 207, 113)"
21730,2020-03-29,Philippines,14,272,1075,"rgb(246, 207, 113)"
21731,2020-03-30,Philippines,3,343,1418,"rgb(246, 207, 113)"
21732,2020-03-31,Philippines,17,666,2084,"rgb(246, 207, 113)"
21733,2020-04-01,Philippines,0,0,2084,"rgb(246, 207, 113)"
21734,2020-04-02,Philippines,8,227,2311,"rgb(246, 207, 113)"
21735,2020-04-03,Philippines,11,322,2633,"rgb(246, 207, 113)"
21736,2020-04-04,Philippines,29,385,3018,"rgb(246, 207, 113)"
21737,2020-04-05,Philippines,8,76,3094,"rgb(246, 207, 113)"
21738,2020-04-06,Philippines,8,152,3246,"rgb(246, 207, 113)"
21739,2020-04-07,Philippines,11,414,3660,"rgb(246, 207, 113)"
21740,2020-04-08,Philippines,14,104,3764,"rgb(246, 207, 113)"
21741,2020-04-09,Philippines,5,106,3870,"rgb(246, 207, 113)"
21742,2020-04-10,Philippines,21,206,4076,"rgb(246, 207, 113)"
21743,2020-04-11,Philippines,0,0,4076,"rgb(246, 207, 113)"
21744,2020-04-12,Philippines,44,352,4428,"rgb(246, 207, 113)"
21745,2020-04-13,Philippines,50,220,4648,"rgb(246, 207, 113)"
21746,2020-04-14,Philippines,18,284,4932,"rgb(246, 207, 113)"
21747,2020-04-15,Philippines,20,291,5223,"rgb(246, 207, 113)"
21748,2020-04-16,Philippines,14,230,5453,"rgb(246, 207, 113)"
21749,2020-04-17,Philippines,13,207,5660,"rgb(246, 207, 113)"
21750,2020-04-18,Philippines,25,218,5878,"rgb(246, 207, 113)"
21751,2020-04-19,Philippines,10,209,6087,"rgb(246, 207, 113)"
21752,2020-04-20,Philippines,12,172,6259,"rgb(246, 207, 113)"
21753,2020-04-21,Philippines,19,200,6459,"rgb(246, 207, 113)"
21754,2020-04-22,Philippines,9,140,6599,"rgb(246, 207, 113)"
21755,2020-04-23,Philippines,9,111,6710,"rgb(246, 207, 113)"
21756,2020-04-24,Philippines,16,271,6981,"rgb(246, 207, 113)"
21757,2020-04-25,Philippines,15,211,7192,"rgb(246, 207, 113)"
21758,2020-04-26,Philippines,17,102,7294,"rgb(246, 207, 113)"
21759,2020-04-27,Philippines,7,285,7579,"rgb(246, 207, 113)"
21760,2020-04-28,Philippines,10,198,7777,"rgb(246, 207, 113)"
21761,2020-04-29,Philippines,19,181,7958,"rgb(246, 207, 113)"
21762,2020-04-30,Philippines,28,254,8212,"rgb(246, 207, 113)"
21763,2020-05-01,Philippines,10,276,8488,"rgb(246, 207, 113)"
21764,2020-05-02,Philippines,11,284,8772,"rgb(246, 207, 113)"
21765,2020-05-03,Philippines,24,156,8928,"rgb(246, 207, 113)"
21766,2020-05-04,Philippines,4,295,9223,"rgb(246, 207, 113)"
21767,2020-05-05,Philippines,16,262,9485,"rgb(246, 207, 113)"
21768,2020-05-06,Philippines,14,199,9684,"rgb(246, 207, 113)"
21769,2020-05-07,Philippines,21,320,10004,"rgb(246, 207, 113)"
21770,2020-05-08,Philippines,27,339,10343,"rgb(246, 207, 113)"
21771,2020-05-09,Philippines,11,120,10463,"rgb(246, 207, 113)"
21772,2020-05-10,Philippines,8,147,10610,"rgb(246, 207, 113)"
21773,2020-05-11,Philippines,15,184,10794,"rgb(246, 207, 113)"
21774,2020-05-12,Philippines,7,292,11086,"rgb(246, 207, 113)"
21775,2020-05-13,Philippines,25,264,11350,"rgb(246, 207, 113)"
21776,2020-05-14,Philippines,21,268,11618,"rgb(246, 207, 113)"
21777,2020-05-15,Philippines,18,258,11876,"rgb(246, 207, 113)"
21778,2020-05-16,Philippines,16,215,12091,"rgb(246, 207, 113)"
21779,2020-05-17,Philippines,11,214,12305,"rgb(246, 207, 113)"
21780,2020-05-18,Philippines,7,208,12513,"rgb(246, 207, 113)"
21781,2020-05-19,Philippines,7,205,12718,"rgb(246, 207, 113)"
21782,2020-05-20,Philippines,6,224,12942,"rgb(246, 207, 113)"
21783,2020-05-21,Philippines,5,279,13221,"rgb(246, 207, 113)"
21784,2020-05-22,Philippines,4,213,13434,"rgb(246, 207, 113)"
21785,2020-05-23,Philippines,11,163,13597,"rgb(246, 207, 113)"
21786,2020-05-24,Philippines,6,180,13777,"rgb(246, 207, 113)"
21787,2020-05-25,Philippines,5,258,14035,"rgb(246, 207, 113)"
21788,2020-05-26,Philippines,5,284,14319,"rgb(246, 207, 113)"
21789,2020-05-27,Philippines,13,350,14669,"rgb(246, 207, 113)"
21790,2020-05-28,Philippines,18,380,15049,"rgb(246, 207, 113)"
21791,2020-05-29,Philippines,17,539,15588,"rgb(246, 207, 113)"
21792,2020-05-30,Philippines,21,1046,16634,"rgb(246, 207, 113)"
21793,2020-05-31,Philippines,8,590,17224,"rgb(246, 207, 113)"
21794,2020-06-01,Philippines,7,862,18086,"rgb(246, 207, 113)"
21795,2020-06-02,Philippines,3,552,18638,"rgb(246, 207, 113)"
21796,2020-06-03,Philippines,6,359,18997,"rgb(246, 207, 113)"
21797,2020-06-04,Philippines,8,751,19748,"rgb(246, 207, 113)"
21798,2020-06-05,Philippines,10,634,20382,"rgb(246, 207, 113)"
21799,2020-06-06,Philippines,3,244,20626,"rgb(246, 207, 113)"
21800,2020-06-07,Philippines,7,714,21340,"rgb(246, 207, 113)"
21801,2020-06-08,Philippines,9,555,21895,"rgb(246, 207, 113)"
21802,2020-06-09,Philippines,8,579,22474,"rgb(246, 207, 113)"
21803,2020-06-10,Philippines,6,518,22992,"rgb(246, 207, 113)"
21804,2020-06-11,Philippines,10,740,23732,"rgb(246, 207, 113)"
21805,2020-06-12,Philippines,9,443,24175,"rgb(246, 207, 113)"
21806,2020-06-13,Philippines,16,612,24787,"rgb(246, 207, 113)"
21807,2020-06-14,Philippines,22,605,25392,"rgb(246, 207, 113)"
21808,2020-06-15,Philippines,14,538,25930,"rgb(246, 207, 113)"
21809,2020-06-16,Philippines,10,490,26420,"rgb(246, 207, 113)"
21810,2020-06-17,Philippines,5,361,26781,"rgb(246, 207, 113)"
21811,2020-06-18,Philippines,5,457,27238,"rgb(246, 207, 113)"
21812,2020-06-19,Philippines,8,561,27799,"rgb(246, 207, 113)"
21813,2020-06-20,Philippines,14,660,28459,"rgb(246, 207, 113)"
21814,2020-06-21,Philippines,20,941,29400,"rgb(246, 207, 113)"
21815,2020-06-22,Philippines,19,652,30052,"rgb(246, 207, 113)"
21816,2020-06-23,Philippines,8,630,30682,"rgb(246, 207, 113)"
21817,2020-06-24,Philippines,9,1143,31825,"rgb(246, 207, 113)"
21818,2020-06-25,Philippines,18,470,32295,"rgb(246, 207, 113)"
21819,2020-06-26,Philippines,8,774,33069,"rgb(246, 207, 113)"
21820,2020-06-27,Philippines,12,1004,34073,"rgb(246, 207, 113)"
21821,2020-06-28,Philippines,12,730,34803,"rgb(246, 207, 113)"
21822,2020-06-29,Philippines,8,652,35455,"rgb(246, 207, 113)"
21823,2020-06-30,Philippines,11,983,36438,"rgb(246, 207, 113)"
21824,2020-07-01,Philippines,11,1076,37514,"rgb(246, 207, 113)"
21825,2020-07-02,Philippines,4,997,38511,"rgb(246, 207, 113)"
21826,2020-07-03,Philippines,4,294,38805,"rgb(246, 207, 113)"
21827,2020-07-04,Philippines,6,1531,40336,"rgb(246, 207, 113)"
21828,2020-07-05,Philippines,10,1494,41830,"rgb(246, 207, 113)"
21829,2020-07-06,Philippines,0,0,41830,"rgb(246, 207, 113)"
21830,2020-07-07,Philippines,13,4503,46333,"rgb(246, 207, 113)"
21831,2020-07-08,Philippines,6,1540,47873,"rgb(246, 207, 113)"
21832,2020-07-09,Philippines,5,2486,50359,"rgb(246, 207, 113)"
21833,2020-07-10,Philippines,4,1395,51754,"rgb(246, 207, 113)"
21834,2020-07-11,Philippines,42,1160,52914,"rgb(246, 207, 113)"
21835,2020-07-12,Philippines,12,1308,54222,"rgb(246, 207, 113)"
21836,2020-07-13,Philippines,162,2037,56259,"rgb(246, 207, 113)"
21837,2019-12-31,Pakistan,0,0,0,"rgb(248, 156, 116)"
21838,2020-01-01,Pakistan,0,0,0,"rgb(248, 156, 116)"
21839,2020-01-02,Pakistan,0,0,0,"rgb(248, 156, 116)"
21840,2020-01-03,Pakistan,0,0,0,"rgb(248, 156, 116)"
21841,2020-01-04,Pakistan,0,0,0,"rgb(248, 156, 116)"
21842,2020-01-05,Pakistan,0,0,0,"rgb(248, 156, 116)"
21843,2020-01-06,Pakistan,0,0,0,"rgb(248, 156, 116)"
21844,2020-01-07,Pakistan,0,0,0,"rgb(248, 156, 116)"
21845,2020-01-08,Pakistan,0,0,0,"rgb(248, 156, 116)"
21846,2020-01-09,Pakistan,0,0,0,"rgb(248, 156, 116)"
21847,2020-01-10,Pakistan,0,0,0,"rgb(248, 156, 116)"
21848,2020-01-11,Pakistan,0,0,0,"rgb(248, 156, 116)"
21849,2020-01-12,Pakistan,0,0,0,"rgb(248, 156, 116)"
21850,2020-01-13,Pakistan,0,0,0,"rgb(248, 156, 116)"
21851,2020-01-14,Pakistan,0,0,0,"rgb(248, 156, 116)"
21852,2020-01-15,Pakistan,0,0,0,"rgb(248, 156, 116)"
21853,2020-01-16,Pakistan,0,0,0,"rgb(248, 156, 116)"
21854,2020-01-17,Pakistan,0,0,0,"rgb(248, 156, 116)"
21855,2020-01-18,Pakistan,0,0,0,"rgb(248, 156, 116)"
21856,2020-01-19,Pakistan,0,0,0,"rgb(248, 156, 116)"
21857,2020-01-20,Pakistan,0,0,0,"rgb(248, 156, 116)"
21858,2020-01-21,Pakistan,0,0,0,"rgb(248, 156, 116)"
21859,2020-01-22,Pakistan,0,0,0,"rgb(248, 156, 116)"
21860,2020-01-23,Pakistan,0,0,0,"rgb(248, 156, 116)"
21861,2020-01-24,Pakistan,0,0,0,"rgb(248, 156, 116)"
21862,2020-01-25,Pakistan,0,0,0,"rgb(248, 156, 116)"
21863,2020-01-26,Pakistan,0,0,0,"rgb(248, 156, 116)"
21864,2020-01-27,Pakistan,0,0,0,"rgb(248, 156, 116)"
21865,2020-01-28,Pakistan,0,0,0,"rgb(248, 156, 116)"
21866,2020-01-29,Pakistan,0,0,0,"rgb(248, 156, 116)"
21867,2020-01-30,Pakistan,0,0,0,"rgb(248, 156, 116)"
21868,2020-01-31,Pakistan,0,0,0,"rgb(248, 156, 116)"
21869,2020-02-01,Pakistan,0,0,0,"rgb(248, 156, 116)"
21870,2020-02-02,Pakistan,0,0,0,"rgb(248, 156, 116)"
21871,2020-02-03,Pakistan,0,0,0,"rgb(248, 156, 116)"
21872,2020-02-04,Pakistan,0,0,0,"rgb(248, 156, 116)"
21873,2020-02-05,Pakistan,0,0,0,"rgb(248, 156, 116)"
21874,2020-02-06,Pakistan,0,0,0,"rgb(248, 156, 116)"
21875,2020-02-07,Pakistan,0,0,0,"rgb(248, 156, 116)"
21876,2020-02-08,Pakistan,0,0,0,"rgb(248, 156, 116)"
21877,2020-02-09,Pakistan,0,0,0,"rgb(248, 156, 116)"
21878,2020-02-10,Pakistan,0,0,0,"rgb(248, 156, 116)"
21879,2020-02-11,Pakistan,0,0,0,"rgb(248, 156, 116)"
21880,2020-02-12,Pakistan,0,0,0,"rgb(248, 156, 116)"
21881,2020-02-13,Pakistan,0,0,0,"rgb(248, 156, 116)"
21882,2020-02-14,Pakistan,0,0,0,"rgb(248, 156, 116)"
21883,2020-02-15,Pakistan,0,0,0,"rgb(248, 156, 116)"
21884,2020-02-16,Pakistan,0,0,0,"rgb(248, 156, 116)"
21885,2020-02-17,Pakistan,0,0,0,"rgb(248, 156, 116)"
21886,2020-02-18,Pakistan,0,0,0,"rgb(248, 156, 116)"
21887,2020-02-19,Pakistan,0,0,0,"rgb(248, 156, 116)"
21888,2020-02-20,Pakistan,0,0,0,"rgb(248, 156, 116)"
21889,2020-02-21,Pakistan,0,0,0,"rgb(248, 156, 116)"
21890,2020-02-22,Pakistan,0,0,0,"rgb(248, 156, 116)"
21891,2020-02-23,Pakistan,0,0,0,"rgb(248, 156, 116)"
21892,2020-02-24,Pakistan,0,0,0,"rgb(248, 156, 116)"
21893,2020-02-25,Pakistan,0,0,0,"rgb(248, 156, 116)"
21894,2020-02-26,Pakistan,0,0,0,"rgb(248, 156, 116)"
21895,2020-02-27,Pakistan,0,2,2,"rgb(248, 156, 116)"
21896,2020-02-28,Pakistan,0,0,2,"rgb(248, 156, 116)"
21897,2020-02-29,Pakistan,0,0,2,"rgb(248, 156, 116)"
21898,2020-03-01,Pakistan,0,2,4,"rgb(248, 156, 116)"
21899,2020-03-02,Pakistan,0,0,4,"rgb(248, 156, 116)"
21900,2020-03-04,Pakistan,0,1,5,"rgb(248, 156, 116)"
21901,2020-03-07,Pakistan,0,1,6,"rgb(248, 156, 116)"
21902,2020-03-10,Pakistan,0,10,16,"rgb(248, 156, 116)"
21903,2020-03-11,Pakistan,0,0,16,"rgb(248, 156, 116)"
21904,2020-03-12,Pakistan,0,4,20,"rgb(248, 156, 116)"
21905,2020-03-13,Pakistan,0,1,21,"rgb(248, 156, 116)"
21906,2020-03-14,Pakistan,0,0,21,"rgb(248, 156, 116)"
21907,2020-03-15,Pakistan,0,9,30,"rgb(248, 156, 116)"
21908,2020-03-16,Pakistan,0,1,31,"rgb(248, 156, 116)"
21909,2020-03-17,Pakistan,0,156,187,"rgb(248, 156, 116)"
21910,2020-03-18,Pakistan,0,0,187,"rgb(248, 156, 116)"
21911,2020-03-19,Pakistan,0,115,302,"rgb(248, 156, 116)"
21912,2020-03-20,Pakistan,2,176,478,"rgb(248, 156, 116)"
21913,2020-03-21,Pakistan,1,17,495,"rgb(248, 156, 116)"
21914,2020-03-22,Pakistan,0,151,646,"rgb(248, 156, 116)"
21915,2020-03-23,Pakistan,2,138,784,"rgb(248, 156, 116)"
21916,2020-03-24,Pakistan,1,103,887,"rgb(248, 156, 116)"
21917,2020-03-25,Pakistan,1,104,991,"rgb(248, 156, 116)"
21918,2020-03-26,Pakistan,1,66,1057,"rgb(248, 156, 116)"
21919,2020-03-27,Pakistan,1,140,1197,"rgb(248, 156, 116)"
21920,2020-03-28,Pakistan,0,0,1197,"rgb(248, 156, 116)"
21921,2020-03-29,Pakistan,2,211,1408,"rgb(248, 156, 116)"
21922,2020-03-30,Pakistan,2,118,1526,"rgb(248, 156, 116)"
21923,2020-03-31,Pakistan,5,99,1625,"rgb(248, 156, 116)"
21924,2020-04-01,Pakistan,8,414,2039,"rgb(248, 156, 116)"
21925,2020-04-02,Pakistan,5,252,2291,"rgb(248, 156, 116)"
21926,2020-04-03,Pakistan,0,0,2291,"rgb(248, 156, 116)"
21927,2020-04-04,Pakistan,0,0,2291,"rgb(248, 156, 116)"
21928,2020-04-05,Pakistan,4,159,2450,"rgb(248, 156, 116)"
21929,2020-04-06,Pakistan,15,827,3277,"rgb(248, 156, 116)"
21930,2020-04-07,Pakistan,4,587,3864,"rgb(248, 156, 116)"
21931,2020-04-08,Pakistan,4,208,4072,"rgb(248, 156, 116)"
21932,2020-04-09,Pakistan,5,250,4322,"rgb(248, 156, 116)"
21933,2020-04-10,Pakistan,3,279,4601,"rgb(248, 156, 116)"
21934,2020-04-11,Pakistan,5,187,4788,"rgb(248, 156, 116)"
21935,2020-04-12,Pakistan,15,250,5038,"rgb(248, 156, 116)"
21936,2020-04-13,Pakistan,7,336,5374,"rgb(248, 156, 116)"
21937,2020-04-14,Pakistan,3,342,5716,"rgb(248, 156, 116)"
21938,2020-04-15,Pakistan,11,272,5988,"rgb(248, 156, 116)"
21939,2020-04-16,Pakistan,17,517,6505,"rgb(248, 156, 116)"
21940,2020-04-17,Pakistan,11,520,7025,"rgb(248, 156, 116)"
21941,2020-04-18,Pakistan,8,456,7481,"rgb(248, 156, 116)"
21942,2020-04-19,Pakistan,16,512,7993,"rgb(248, 156, 116)"
21943,2020-04-20,Pakistan,17,425,8418,"rgb(248, 156, 116)"
21944,2020-04-21,Pakistan,16,798,9216,"rgb(248, 156, 116)"
21945,2020-04-22,Pakistan,17,533,9749,"rgb(248, 156, 116)"
21946,2020-04-23,Pakistan,0,0,9749,"rgb(248, 156, 116)"
21947,2020-04-24,Pakistan,28,1406,11155,"rgb(248, 156, 116)"
21948,2020-04-25,Pakistan,16,785,11940,"rgb(248, 156, 116)"
21949,2020-04-26,Pakistan,16,783,12723,"rgb(248, 156, 116)"
21950,2020-04-27,Pakistan,12,605,13328,"rgb(248, 156, 116)"
21951,2020-04-28,Pakistan,20,751,14079,"rgb(248, 156, 116)"
21952,2020-04-29,Pakistan,26,806,14885,"rgb(248, 156, 116)"
21953,2020-04-30,Pakistan,19,874,15759,"rgb(248, 156, 116)"
21954,2020-05-01,Pakistan,39,1058,16817,"rgb(248, 156, 116)"
21955,2020-05-02,Pakistan,32,1297,18114,"rgb(248, 156, 116)"
21956,2020-05-03,Pakistan,23,989,19103,"rgb(248, 156, 116)"
21957,2020-05-04,Pakistan,22,1083,20186,"rgb(248, 156, 116)"
21958,2020-05-05,Pakistan,24,1315,21501,"rgb(248, 156, 116)"
21959,2020-05-06,Pakistan,40,1049,22550,"rgb(248, 156, 116)"
21960,2020-05-07,Pakistan,38,1523,24073,"rgb(248, 156, 116)"
21961,2020-05-08,Pakistan,30,1764,25837,"rgb(248, 156, 116)"
21962,2020-05-09,Pakistan,24,1637,27474,"rgb(248, 156, 116)"
21963,2020-05-10,Pakistan,21,1991,29465,"rgb(248, 156, 116)"
21964,2020-05-11,Pakistan,28,1476,30941,"rgb(248, 156, 116)"
21965,2020-05-12,Pakistan,39,1140,32081,"rgb(248, 156, 116)"
21966,2020-05-13,Pakistan,31,2255,34336,"rgb(248, 156, 116)"
21967,2020-05-14,Pakistan,33,1452,35788,"rgb(248, 156, 116)"
21968,2020-05-15,Pakistan,33,1430,37218,"rgb(248, 156, 116)"
21969,2020-05-16,Pakistan,31,1581,38799,"rgb(248, 156, 116)"
21970,2020-05-17,Pakistan,39,1352,40151,"rgb(248, 156, 116)"
21971,2020-05-18,Pakistan,30,1974,42125,"rgb(248, 156, 116)"
21972,2020-05-19,Pakistan,36,1841,43966,"rgb(248, 156, 116)"
21973,2020-05-20,Pakistan,46,1932,45898,"rgb(248, 156, 116)"
21974,2020-05-21,Pakistan,32,2193,48091,"rgb(248, 156, 116)"
21975,2020-05-22,Pakistan,50,2603,50694,"rgb(248, 156, 116)"
21976,2020-05-23,Pakistan,34,1743,52437,"rgb(248, 156, 116)"
21977,2020-05-24,Pakistan,32,2164,54601,"rgb(248, 156, 116)"
21978,2020-05-25,Pakistan,34,1748,56349,"rgb(248, 156, 116)"
21979,2020-05-26,Pakistan,30,1356,57705,"rgb(248, 156, 116)"
21980,2020-05-27,Pakistan,28,1446,59151,"rgb(248, 156, 116)"
21981,2020-05-28,Pakistan,35,2076,61227,"rgb(248, 156, 116)"
21982,2020-05-29,Pakistan,57,2801,64028,"rgb(248, 156, 116)"
21983,2020-05-30,Pakistan,78,2429,66457,"rgb(248, 156, 116)"
21984,2020-05-31,Pakistan,88,3039,69496,"rgb(248, 156, 116)"
21985,2020-06-01,Pakistan,60,2964,72460,"rgb(248, 156, 116)"
21986,2020-06-02,Pakistan,78,3938,76398,"rgb(248, 156, 116)"
21987,2020-06-03,Pakistan,67,4065,80463,"rgb(248, 156, 116)"
21988,2020-06-04,Pakistan,82,4801,85264,"rgb(248, 156, 116)"
21989,2020-06-05,Pakistan,68,3985,89249,"rgb(248, 156, 116)"
21990,2020-06-06,Pakistan,97,4734,93983,"rgb(248, 156, 116)"
21991,2020-06-07,Pakistan,67,4960,98943,"rgb(248, 156, 116)"
21992,2020-06-08,Pakistan,65,4728,103671,"rgb(248, 156, 116)"
21993,2020-06-09,Pakistan,105,4646,108317,"rgb(248, 156, 116)"
21994,2020-06-10,Pakistan,83,5385,113702,"rgb(248, 156, 116)"
21995,2020-06-11,Pakistan,101,5834,119536,"rgb(248, 156, 116)"
21996,2020-06-12,Pakistan,107,6397,125933,"rgb(248, 156, 116)"
21997,2020-06-13,Pakistan,88,6472,132405,"rgb(248, 156, 116)"
21998,2020-06-14,Pakistan,81,6825,139230,"rgb(248, 156, 116)"
21999,2020-06-15,Pakistan,97,5248,144478,"rgb(248, 156, 116)"
22000,2020-06-16,Pakistan,110,4443,148921,"rgb(248, 156, 116)"
22001,2020-06-17,Pakistan,136,5839,154760,"rgb(248, 156, 116)"
22002,2020-06-18,Pakistan,118,5358,160118,"rgb(248, 156, 116)"
22003,2020-06-19,Pakistan,136,4944,165062,"rgb(248, 156, 116)"
22004,2020-06-20,Pakistan,153,6604,171666,"rgb(248, 156, 116)"
22005,2020-06-21,Pakistan,119,4951,176617,"rgb(248, 156, 116)"
22006,2020-06-22,Pakistan,89,4471,181088,"rgb(248, 156, 116)"
22007,2020-06-23,Pakistan,105,3946,185034,"rgb(248, 156, 116)"
22008,2020-06-24,Pakistan,60,3892,188926,"rgb(248, 156, 116)"
22009,2020-06-25,Pakistan,148,4044,192970,"rgb(248, 156, 116)"
22010,2020-06-26,Pakistan,59,2775,195745,"rgb(248, 156, 116)"
22011,2020-06-27,Pakistan,73,3138,198883,"rgb(248, 156, 116)"
22012,2020-06-28,Pakistan,83,4072,202955,"rgb(248, 156, 116)"
22013,2020-06-29,Pakistan,49,3557,206512,"rgb(248, 156, 116)"
22014,2020-06-30,Pakistan,137,2825,209337,"rgb(248, 156, 116)"
22015,2020-07-01,Pakistan,91,4133,213470,"rgb(248, 156, 116)"
22016,2020-07-02,Pakistan,78,4339,217809,"rgb(248, 156, 116)"
22017,2020-07-03,Pakistan,78,4087,221896,"rgb(248, 156, 116)"
22018,2020-07-04,Pakistan,68,3387,225283,"rgb(248, 156, 116)"
22019,2020-07-05,Pakistan,93,3191,228474,"rgb(248, 156, 116)"
22020,2020-07-06,Pakistan,50,3344,231818,"rgb(248, 156, 116)"
22021,2020-07-07,Pakistan,77,2691,234509,"rgb(248, 156, 116)"
22022,2020-07-08,Pakistan,83,2980,237489,"rgb(248, 156, 116)"
22023,2020-07-09,Pakistan,61,3359,240848,"rgb(248, 156, 116)"
22024,2020-07-10,Pakistan,75,2751,243599,"rgb(248, 156, 116)"
22025,2020-07-11,Pakistan,65,2752,246351,"rgb(248, 156, 116)"
22026,2020-07-12,Pakistan,74,2521,248872,"rgb(248, 156, 116)"
22027,2020-07-13,Pakistan,69,2753,251625,"rgb(248, 156, 116)"
22028,2020-03-04,Poland,0,1,1,"rgb(220, 176, 242)"
22029,2020-03-07,Poland,0,4,5,"rgb(220, 176, 242)"
22030,2020-03-08,Poland,0,1,6,"rgb(220, 176, 242)"
22031,2020-03-09,Poland,0,5,11,"rgb(220, 176, 242)"
22032,2020-03-10,Poland,0,6,17,"rgb(220, 176, 242)"
22033,2020-03-11,Poland,0,5,22,"rgb(220, 176, 242)"
22034,2020-03-12,Poland,0,9,31,"rgb(220, 176, 242)"
22035,2020-03-13,Poland,1,18,49,"rgb(220, 176, 242)"
22036,2020-03-14,Poland,1,19,68,"rgb(220, 176, 242)"
22037,2020-03-15,Poland,1,36,104,"rgb(220, 176, 242)"
22038,2020-03-16,Poland,0,21,125,"rgb(220, 176, 242)"
22039,2020-03-17,Poland,1,52,177,"rgb(220, 176, 242)"
22040,2020-03-18,Poland,1,61,238,"rgb(220, 176, 242)"
22041,2020-03-19,Poland,0,49,287,"rgb(220, 176, 242)"
22042,2020-03-20,Poland,0,68,355,"rgb(220, 176, 242)"
22043,2020-03-21,Poland,0,70,425,"rgb(220, 176, 242)"
22044,2020-03-22,Poland,0,111,536,"rgb(220, 176, 242)"
22045,2020-03-23,Poland,2,98,634,"rgb(220, 176, 242)"
22046,2020-03-24,Poland,1,115,749,"rgb(220, 176, 242)"
22047,2020-03-25,Poland,2,152,901,"rgb(220, 176, 242)"
22048,2020-03-26,Poland,4,150,1051,"rgb(220, 176, 242)"
22049,2020-03-27,Poland,2,170,1221,"rgb(220, 176, 242)"
22050,2020-03-28,Poland,0,168,1389,"rgb(220, 176, 242)"
22051,2020-03-29,Poland,2,249,1638,"rgb(220, 176, 242)"
22052,2020-03-30,Poland,4,224,1862,"rgb(220, 176, 242)"
22053,2020-03-31,Poland,9,193,2055,"rgb(220, 176, 242)"
22054,2020-04-01,Poland,2,256,2311,"rgb(220, 176, 242)"
22055,2020-04-02,Poland,10,243,2554,"rgb(220, 176, 242)"
22056,2020-04-03,Poland,14,392,2946,"rgb(220, 176, 242)"
22057,2020-04-04,Poland,14,437,3383,"rgb(220, 176, 242)"
22058,2020-04-05,Poland,8,244,3627,"rgb(220, 176, 242)"
22059,2020-04-06,Poland,15,475,4102,"rgb(220, 176, 242)"
22060,2020-04-07,Poland,13,311,4413,"rgb(220, 176, 242)"
22061,2020-04-08,Poland,22,435,4848,"rgb(220, 176, 242)"
22062,2020-04-09,Poland,30,357,5205,"rgb(220, 176, 242)"
22063,2020-04-10,Poland,15,370,5575,"rgb(220, 176, 242)"
22064,2020-04-11,Poland,7,380,5955,"rgb(220, 176, 242)"
22065,2020-04-12,Poland,27,401,6356,"rgb(220, 176, 242)"
22066,2020-04-13,Poland,24,318,6674,"rgb(220, 176, 242)"
22067,2020-04-14,Poland,13,260,6934,"rgb(220, 176, 242)"
22068,2020-04-15,Poland,18,268,7202,"rgb(220, 176, 242)"
22069,2020-04-16,Poland,23,380,7582,"rgb(220, 176, 242)"
22070,2020-04-17,Poland,28,336,7918,"rgb(220, 176, 242)"
22071,2020-04-18,Poland,18,461,8379,"rgb(220, 176, 242)"
22072,2020-04-19,Poland,15,363,8742,"rgb(220, 176, 242)"
22073,2020-04-20,Poland,13,545,9287,"rgb(220, 176, 242)"
22074,2020-04-21,Poland,20,306,9593,"rgb(220, 176, 242)"
22075,2020-04-22,Poland,21,263,9856,"rgb(220, 176, 242)"
22076,2020-04-23,Poland,25,313,10169,"rgb(220, 176, 242)"
22077,2020-04-24,Poland,28,342,10511,"rgb(220, 176, 242)"
22078,2020-04-25,Poland,40,381,10892,"rgb(220, 176, 242)"
22079,2020-04-26,Poland,30,381,11273,"rgb(220, 176, 242)"
22080,2020-04-27,Poland,11,344,11617,"rgb(220, 176, 242)"
22081,2020-04-28,Poland,27,285,11902,"rgb(220, 176, 242)"
22082,2020-04-29,Poland,34,316,12218,"rgb(220, 176, 242)"
22083,2020-04-30,Poland,28,422,12640,"rgb(220, 176, 242)"
22084,2020-05-01,Poland,20,237,12877,"rgb(220, 176, 242)"
22085,2020-05-02,Poland,7,228,13105,"rgb(220, 176, 242)"
22086,2020-05-03,Poland,13,270,13375,"rgb(220, 176, 242)"
22087,2020-05-04,Poland,14,318,13693,"rgb(220, 176, 242)"
22088,2020-05-05,Poland,20,313,14006,"rgb(220, 176, 242)"
22089,2020-05-06,Poland,18,425,14431,"rgb(220, 176, 242)"
22090,2020-05-07,Poland,17,309,14740,"rgb(220, 176, 242)"
22091,2020-05-08,Poland,22,307,15047,"rgb(220, 176, 242)"
22092,2020-05-09,Poland,21,319,15366,"rgb(220, 176, 242)"
22093,2020-05-10,Poland,9,285,15651,"rgb(220, 176, 242)"
22094,2020-05-11,Poland,15,345,15996,"rgb(220, 176, 242)"
22095,2020-05-12,Poland,11,330,16326,"rgb(220, 176, 242)"
22096,2020-05-13,Poland,28,595,16921,"rgb(220, 176, 242)"
22097,2020-05-14,Poland,22,283,17204,"rgb(220, 176, 242)"
22098,2020-05-15,Poland,22,411,17615,"rgb(220, 176, 242)"
22099,2020-05-16,Poland,24,401,18016,"rgb(220, 176, 242)"
22100,2020-05-17,Poland,8,241,18257,"rgb(220, 176, 242)"
22101,2020-05-18,Poland,10,272,18529,"rgb(220, 176, 242)"
22102,2020-05-19,Poland,11,356,18885,"rgb(220, 176, 242)"
22103,2020-05-20,Poland,12,383,19268,"rgb(220, 176, 242)"
22104,2020-05-21,Poland,14,471,19739,"rgb(220, 176, 242)"
22105,2020-05-22,Poland,10,404,20143,"rgb(220, 176, 242)"
22106,2020-05-23,Poland,10,476,20619,"rgb(220, 176, 242)"
22107,2020-05-24,Poland,11,312,20931,"rgb(220, 176, 242)"
22108,2020-05-25,Poland,3,395,21326,"rgb(220, 176, 242)"
22109,2020-05-26,Poland,11,305,21631,"rgb(220, 176, 242)"
22110,2020-05-27,Poland,17,443,22074,"rgb(220, 176, 242)"
22111,2020-05-28,Poland,4,399,22473,"rgb(220, 176, 242)"
22112,2020-05-29,Poland,10,352,22825,"rgb(220, 176, 242)"
22113,2020-05-30,Poland,13,330,23155,"rgb(220, 176, 242)"
22114,2020-05-31,Poland,10,416,23571,"rgb(220, 176, 242)"
22115,2020-06-01,Poland,3,215,23786,"rgb(220, 176, 242)"
22116,2020-06-02,Poland,10,379,24165,"rgb(220, 176, 242)"
22117,2020-06-03,Poland,18,230,24395,"rgb(220, 176, 242)"
22118,2020-06-04,Poland,0,0,24395,"rgb(220, 176, 242)"
22119,2020-06-05,Poland,25,653,25048,"rgb(220, 176, 242)"
22120,2020-06-06,Poland,20,371,25419,"rgb(220, 176, 242)"
22121,2020-06-07,Poland,16,567,25986,"rgb(220, 176, 242)"
22122,2020-06-08,Poland,4,575,26561,"rgb(220, 176, 242)"
22123,2020-06-09,Poland,9,599,27160,"rgb(220, 176, 242)"
22124,2020-06-10,Poland,17,400,27560,"rgb(220, 176, 242)"
22125,2020-06-11,Poland,23,197,27757,"rgb(220, 176, 242)"
22126,2020-06-12,Poland,9,444,28201,"rgb(220, 176, 242)"
22127,2020-06-13,Poland,7,376,28577,"rgb(220, 176, 242)"
22128,2020-06-14,Poland,15,440,29017,"rgb(220, 176, 242)"
22129,2020-06-15,Poland,10,375,29392,"rgb(220, 176, 242)"
22130,2020-06-16,Poland,9,396,29788,"rgb(220, 176, 242)"
22131,2020-06-17,Poland,16,407,30195,"rgb(220, 176, 242)"
22132,2020-06-18,Poland,14,506,30701,"rgb(220, 176, 242)"
22133,2020-06-19,Poland,30,314,31015,"rgb(220, 176, 242)"
22134,2020-06-20,Poland,18,301,31316,"rgb(220, 176, 242)"
22135,2020-06-21,Poland,12,304,31620,"rgb(220, 176, 242)"
22136,2020-06-22,Poland,10,311,31931,"rgb(220, 176, 242)"
22137,2020-06-23,Poland,3,296,32227,"rgb(220, 176, 242)"
22138,2020-06-24,Poland,16,300,32527,"rgb(220, 176, 242)"
22139,2020-06-25,Poland,21,294,32821,"rgb(220, 176, 242)"
22140,2020-06-26,Poland,16,298,33119,"rgb(220, 176, 242)"
22141,2020-06-27,Poland,17,276,33395,"rgb(220, 176, 242)"
22142,2020-06-28,Poland,6,319,33714,"rgb(220, 176, 242)"
22143,2020-06-29,Poland,3,193,33907,"rgb(220, 176, 242)"
22144,2020-06-30,Poland,6,247,34154,"rgb(220, 176, 242)"
22145,2020-07-01,Poland,19,239,34393,"rgb(220, 176, 242)"
22146,2020-07-02,Poland,14,382,34775,"rgb(220, 176, 242)"
22147,2020-07-03,Poland,15,371,35146,"rgb(220, 176, 242)"
22148,2020-07-04,Poland,15,259,35405,"rgb(220, 176, 242)"
22149,2020-07-05,Poland,5,314,35719,"rgb(220, 176, 242)"
22150,2020-07-06,Poland,5,231,35950,"rgb(220, 176, 242)"
22151,2020-07-07,Poland,4,205,36155,"rgb(220, 176, 242)"
22152,2020-07-08,Poland,7,257,36412,"rgb(220, 176, 242)"
22153,2020-07-09,Poland,14,277,36689,"rgb(220, 176, 242)"
22154,2020-07-10,Poland,9,262,36951,"rgb(220, 176, 242)"
22155,2020-07-11,Poland,11,265,37216,"rgb(220, 176, 242)"
22156,2020-07-12,Poland,6,305,37521,"rgb(220, 176, 242)"
22157,2020-07-13,Poland,3,370,37891,"rgb(220, 176, 242)"
22158,2020-03-28,Puerto Rico,2,64,64,"rgb(135, 197, 95)"
22159,2020-03-29,Puerto Rico,1,36,100,"rgb(135, 197, 95)"
22160,2020-03-30,Puerto Rico,2,27,127,"rgb(135, 197, 95)"
22161,2020-03-31,Puerto Rico,1,47,174,"rgb(135, 197, 95)"
22162,2020-04-01,Puerto Rico,2,65,239,"rgb(135, 197, 95)"
22163,2020-04-02,Puerto Rico,3,47,286,"rgb(135, 197, 95)"
22164,2020-04-03,Puerto Rico,1,30,316,"rgb(135, 197, 95)"
22165,2020-04-04,Puerto Rico,3,62,378,"rgb(135, 197, 95)"
22166,2020-04-05,Puerto Rico,3,74,452,"rgb(135, 197, 95)"
22167,2020-04-06,Puerto Rico,2,23,475,"rgb(135, 197, 95)"
22168,2020-04-07,Puerto Rico,1,38,513,"rgb(135, 197, 95)"
22169,2020-04-08,Puerto Rico,2,60,573,"rgb(135, 197, 95)"
22170,2020-04-09,Puerto Rico,1,47,620,"rgb(135, 197, 95)"
22171,2020-04-10,Puerto Rico,9,63,683,"rgb(135, 197, 95)"
22172,2020-04-11,Puerto Rico,6,42,725,"rgb(135, 197, 95)"
22173,2020-04-12,Puerto Rico,3,63,788,"rgb(135, 197, 95)"
22174,2020-04-13,Puerto Rico,2,109,897,"rgb(135, 197, 95)"
22175,2020-04-14,Puerto Rico,1,6,903,"rgb(135, 197, 95)"
22176,2020-04-15,Puerto Rico,0,20,923,"rgb(135, 197, 95)"
22177,2020-04-16,Puerto Rico,6,51,974,"rgb(135, 197, 95)"
22178,2020-04-17,Puerto Rico,5,69,1043,"rgb(135, 197, 95)"
22179,2020-04-18,Puerto Rico,2,25,1068,"rgb(135, 197, 95)"
22180,2020-04-19,Puerto Rico,2,50,1118,"rgb(135, 197, 95)"
22181,2020-04-20,Puerto Rico,2,95,1213,"rgb(135, 197, 95)"
22182,2020-04-21,Puerto Rico,1,39,1252,"rgb(135, 197, 95)"
22183,2020-04-22,Puerto Rico,0,0,1252,"rgb(135, 197, 95)"
22184,2020-04-23,Puerto Rico,1,0,1252,"rgb(135, 197, 95)"
22185,2020-04-24,Puerto Rico,5,0,1252,"rgb(135, 197, 95)"
22186,2020-04-25,Puerto Rico,8,24,1276,"rgb(135, 197, 95)"
22187,2020-04-26,Puerto Rico,6,31,1307,"rgb(135, 197, 95)"
22188,2020-04-27,Puerto Rico,1,64,1371,"rgb(135, 197, 95)"
22189,2020-04-28,Puerto Rico,0,18,1389,"rgb(135, 197, 95)"
22190,2020-04-29,Puerto Rico,2,11,1400,"rgb(135, 197, 95)"
22191,2020-04-30,Puerto Rico,0,33,1433,"rgb(135, 197, 95)"
22192,2020-05-01,Puerto Rico,6,106,1539,"rgb(135, 197, 95)"
22193,2020-05-02,Puerto Rico,2,36,1575,"rgb(135, 197, 95)"
22194,2020-05-03,Puerto Rico,1,182,1757,"rgb(135, 197, 95)"
22195,2020-05-04,Puerto Rico,2,51,1808,"rgb(135, 197, 95)"
22196,2020-05-05,Puerto Rico,0,35,1843,"rgb(135, 197, 95)"
22197,2020-05-06,Puerto Rico,2,81,1924,"rgb(135, 197, 95)"
22198,2020-05-07,Puerto Rico,0,44,1968,"rgb(135, 197, 95)"
22199,2020-05-08,Puerto Rico,3,63,2031,"rgb(135, 197, 95)"
22200,2020-05-09,Puerto Rico,5,125,2156,"rgb(135, 197, 95)"
22201,2020-05-10,Puerto Rico,1,17,2173,"rgb(135, 197, 95)"
22202,2020-05-11,Puerto Rico,3,25,2198,"rgb(135, 197, 95)"
22203,2020-05-12,Puerto Rico,2,58,2256,"rgb(135, 197, 95)"
22204,2020-05-13,Puerto Rico,1,43,2299,"rgb(135, 197, 95)"
22205,2020-05-14,Puerto Rico,1,30,2329,"rgb(135, 197, 95)"
22206,2020-05-15,Puerto Rico,2,98,2427,"rgb(135, 197, 95)"
22207,2020-05-16,Puerto Rico,5,115,2542,"rgb(135, 197, 95)"
22208,2020-05-17,Puerto Rico,0,47,2589,"rgb(135, 197, 95)"
22209,2020-05-18,Puerto Rico,1,57,2646,"rgb(135, 197, 95)"
22210,2020-05-19,Puerto Rico,1,64,2710,"rgb(135, 197, 95)"
22211,2020-05-20,Puerto Rico,0,95,2805,"rgb(135, 197, 95)"
22212,2020-05-21,Puerto Rico,1,61,2866,"rgb(135, 197, 95)"
22213,2020-05-22,Puerto Rico,1,47,2913,"rgb(135, 197, 95)"
22214,2020-05-23,Puerto Rico,0,117,3030,"rgb(135, 197, 95)"
22215,2020-05-24,Puerto Rico,1,70,3100,"rgb(135, 197, 95)"
22216,2020-05-25,Puerto Rico,0,89,3189,"rgb(135, 197, 95)"
22217,2020-05-26,Puerto Rico,2,71,3260,"rgb(135, 197, 95)"
22218,2020-05-27,Puerto Rico,0,64,3324,"rgb(135, 197, 95)"
22219,2020-05-28,Puerto Rico,0,73,3397,"rgb(135, 197, 95)"
22220,2020-05-29,Puerto Rico,2,89,3486,"rgb(135, 197, 95)"
22221,2020-05-30,Puerto Rico,1,161,3647,"rgb(135, 197, 95)"
22222,2020-05-31,Puerto Rico,1,71,3718,"rgb(135, 197, 95)"
22223,2020-06-01,Puerto Rico,3,58,3776,"rgb(135, 197, 95)"
22224,2020-06-02,Puerto Rico,0,97,3873,"rgb(135, 197, 95)"
22225,2020-06-03,Puerto Rico,2,62,3935,"rgb(135, 197, 95)"
22226,2020-06-04,Puerto Rico,2,88,4023,"rgb(135, 197, 95)"
22227,2020-06-05,Puerto Rico,0,485,4508,"rgb(135, 197, 95)"
22228,2020-06-06,Puerto Rico,1,112,4620,"rgb(135, 197, 95)"
22229,2020-06-07,Puerto Rico,1,295,4915,"rgb(135, 197, 95)"
22230,2020-06-08,Puerto Rico,0,70,4985,"rgb(135, 197, 95)"
22231,2020-06-09,Puerto Rico,0,61,5046,"rgb(135, 197, 95)"
22232,2020-06-10,Puerto Rico,0,139,5185,"rgb(135, 197, 95)"
22233,2020-06-11,Puerto Rico,1,144,5329,"rgb(135, 197, 95)"
22234,2020-06-12,Puerto Rico,1,23,5352,"rgb(135, 197, 95)"
22235,2020-06-13,Puerto Rico,2,184,5536,"rgb(135, 197, 95)"
22236,2020-06-14,Puerto Rico,0,154,5690,"rgb(135, 197, 95)"
22237,2020-06-15,Puerto Rico,1,121,5811,"rgb(135, 197, 95)"
22238,2020-06-16,Puerto Rico,0,79,5890,"rgb(135, 197, 95)"
22239,2020-06-17,Puerto Rico,0,61,5951,"rgb(135, 197, 95)"
22240,2020-06-18,Puerto Rico,0,52,6003,"rgb(135, 197, 95)"
22241,2020-06-19,Puerto Rico,0,108,6111,"rgb(135, 197, 95)"
22242,2020-06-20,Puerto Rico,0,0,6111,"rgb(135, 197, 95)"
22243,2020-06-21,Puerto Rico,0,352,6463,"rgb(135, 197, 95)"
22244,2020-06-22,Puerto Rico,2,62,6525,"rgb(135, 197, 95)"
22245,2020-06-23,Puerto Rico,0,39,6564,"rgb(135, 197, 95)"
22246,2020-06-24,Puerto Rico,0,121,6685,"rgb(135, 197, 95)"
22247,2020-06-25,Puerto Rico,0,135,6820,"rgb(135, 197, 95)"
22248,2020-06-26,Puerto Rico,2,57,6877,"rgb(135, 197, 95)"
22249,2020-06-27,Puerto Rico,0,45,6922,"rgb(135, 197, 95)"
22250,2020-06-28,Puerto Rico,1,144,7066,"rgb(135, 197, 95)"
22251,2020-06-29,Puerto Rico,1,123,7189,"rgb(135, 197, 95)"
22252,2020-06-30,Puerto Rico,0,61,7250,"rgb(135, 197, 95)"
22253,2020-07-01,Puerto Rico,0,215,7465,"rgb(135, 197, 95)"
22254,2020-07-02,Puerto Rico,0,72,7537,"rgb(135, 197, 95)"
22255,2020-07-03,Puerto Rico,0,71,7608,"rgb(135, 197, 95)"
22256,2020-07-04,Puerto Rico,1,75,7683,"rgb(135, 197, 95)"
22257,2020-07-05,Puerto Rico,1,4,7687,"rgb(135, 197, 95)"
22258,2020-07-06,Puerto Rico,0,229,7916,"rgb(135, 197, 95)"
22259,2020-07-07,Puerto Rico,0,669,8585,"rgb(135, 197, 95)"
22260,2020-07-08,Puerto Rico,2,129,8714,"rgb(135, 197, 95)"
22261,2020-07-09,Puerto Rico,2,190,8904,"rgb(135, 197, 95)"
22262,2020-07-10,Puerto Rico,0,0,8904,"rgb(135, 197, 95)"
22263,2020-07-11,Puerto Rico,0,392,9296,"rgb(135, 197, 95)"
22264,2020-07-12,Puerto Rico,8,237,9533,"rgb(135, 197, 95)"
22265,2020-07-13,Puerto Rico,0,288,9821,"rgb(135, 197, 95)"
22266,2020-03-06,West Bank and the Gaza Strip,0,7,7,"rgb(158, 185, 243)"
22267,2020-03-07,West Bank and the Gaza Strip,0,9,16,"rgb(158, 185, 243)"
22268,2020-03-08,West Bank and the Gaza Strip,0,3,19,"rgb(158, 185, 243)"
22269,2020-03-10,West Bank and the Gaza Strip,0,1,20,"rgb(158, 185, 243)"
22270,2020-03-11,West Bank and the Gaza Strip,0,9,29,"rgb(158, 185, 243)"
22271,2020-03-12,West Bank and the Gaza Strip,0,1,30,"rgb(158, 185, 243)"
22272,2020-03-14,West Bank and the Gaza Strip,0,5,35,"rgb(158, 185, 243)"
22273,2020-03-15,West Bank and the Gaza Strip,0,3,38,"rgb(158, 185, 243)"
22274,2020-03-16,West Bank and the Gaza Strip,0,0,38,"rgb(158, 185, 243)"
22275,2020-03-17,West Bank and the Gaza Strip,0,1,39,"rgb(158, 185, 243)"
22276,2020-03-18,West Bank and the Gaza Strip,0,2,41,"rgb(158, 185, 243)"
22277,2020-03-19,West Bank and the Gaza Strip,0,3,44,"rgb(158, 185, 243)"
22278,2020-03-20,West Bank and the Gaza Strip,0,3,47,"rgb(158, 185, 243)"
22279,2020-03-21,West Bank and the Gaza Strip,0,1,48,"rgb(158, 185, 243)"
22280,2020-03-22,West Bank and the Gaza Strip,0,4,52,"rgb(158, 185, 243)"
22281,2020-03-23,West Bank and the Gaza Strip,0,7,59,"rgb(158, 185, 243)"
22282,2020-03-24,West Bank and the Gaza Strip,0,0,59,"rgb(158, 185, 243)"
22283,2020-03-25,West Bank and the Gaza Strip,0,1,60,"rgb(158, 185, 243)"
22284,2020-03-26,West Bank and the Gaza Strip,0,2,62,"rgb(158, 185, 243)"
22285,2020-03-27,West Bank and the Gaza Strip,1,22,84,"rgb(158, 185, 243)"
22286,2020-03-28,West Bank and the Gaza Strip,0,7,91,"rgb(158, 185, 243)"
22287,2020-03-29,West Bank and the Gaza Strip,0,6,97,"rgb(158, 185, 243)"
22288,2020-03-30,West Bank and the Gaza Strip,0,9,106,"rgb(158, 185, 243)"
22289,2020-03-31,West Bank and the Gaza Strip,0,9,115,"rgb(158, 185, 243)"
22290,2020-04-01,West Bank and the Gaza Strip,0,2,117,"rgb(158, 185, 243)"
22291,2020-04-02,West Bank and the Gaza Strip,0,17,134,"rgb(158, 185, 243)"
22292,2020-04-03,West Bank and the Gaza Strip,0,21,155,"rgb(158, 185, 243)"
22293,2020-04-04,West Bank and the Gaza Strip,0,0,155,"rgb(158, 185, 243)"
22294,2020-04-06,West Bank and the Gaza Strip,0,62,217,"rgb(158, 185, 243)"
22295,2020-04-07,West Bank and the Gaza Strip,0,36,253,"rgb(158, 185, 243)"
22296,2020-04-08,West Bank and the Gaza Strip,0,7,260,"rgb(158, 185, 243)"
22297,2020-04-09,West Bank and the Gaza Strip,0,3,263,"rgb(158, 185, 243)"
22298,2020-04-10,West Bank and the Gaza Strip,0,0,263,"rgb(158, 185, 243)"
22299,2020-04-11,West Bank and the Gaza Strip,1,3,266,"rgb(158, 185, 243)"
22300,2020-04-12,West Bank and the Gaza Strip,0,2,268,"rgb(158, 185, 243)"
22301,2020-04-13,West Bank and the Gaza Strip,0,0,268,"rgb(158, 185, 243)"
22302,2020-04-14,West Bank and the Gaza Strip,0,0,268,"rgb(158, 185, 243)"
22303,2020-04-15,West Bank and the Gaza Strip,0,19,287,"rgb(158, 185, 243)"
22304,2020-04-16,West Bank and the Gaza Strip,0,4,291,"rgb(158, 185, 243)"
22305,2020-04-17,West Bank and the Gaza Strip,0,3,294,"rgb(158, 185, 243)"
22306,2020-04-18,West Bank and the Gaza Strip,0,13,307,"rgb(158, 185, 243)"
22307,2020-04-19,West Bank and the Gaza Strip,0,6,313,"rgb(158, 185, 243)"
22308,2020-04-20,West Bank and the Gaza Strip,0,9,322,"rgb(158, 185, 243)"
22309,2020-04-21,West Bank and the Gaza Strip,0,7,329,"rgb(158, 185, 243)"
22310,2020-04-22,West Bank and the Gaza Strip,0,0,329,"rgb(158, 185, 243)"
22311,2020-04-23,West Bank and the Gaza Strip,0,6,335,"rgb(158, 185, 243)"
22312,2020-04-24,West Bank and the Gaza Strip,0,1,336,"rgb(158, 185, 243)"
22313,2020-04-25,West Bank and the Gaza Strip,0,4,340,"rgb(158, 185, 243)"
22314,2020-04-26,West Bank and the Gaza Strip,0,2,342,"rgb(158, 185, 243)"
22315,2020-04-27,West Bank and the Gaza Strip,0,153,495,"rgb(158, 185, 243)"
22316,2020-04-28,West Bank and the Gaza Strip,0,0,495,"rgb(158, 185, 243)"
22317,2020-04-29,West Bank and the Gaza Strip,0,0,495,"rgb(158, 185, 243)"
22318,2020-04-30,West Bank and the Gaza Strip,0,12,507,"rgb(158, 185, 243)"
22319,2020-05-01,West Bank and the Gaza Strip,2,0,507,"rgb(158, 185, 243)"
22320,2020-05-02,West Bank and the Gaza Strip,0,10,517,"rgb(158, 185, 243)"
22321,2020-05-03,West Bank and the Gaza Strip,0,0,517,"rgb(158, 185, 243)"
22322,2020-05-04,West Bank and the Gaza Strip,0,5,522,"rgb(158, 185, 243)"
22323,2020-05-05,West Bank and the Gaza Strip,0,2,524,"rgb(158, 185, 243)"
22324,2020-05-06,West Bank and the Gaza Strip,0,14,538,"rgb(158, 185, 243)"
22325,2020-05-07,West Bank and the Gaza Strip,0,8,546,"rgb(158, 185, 243)"
22326,2020-05-08,West Bank and the Gaza Strip,0,1,547,"rgb(158, 185, 243)"
22327,2020-05-09,West Bank and the Gaza Strip,0,0,547,"rgb(158, 185, 243)"
22328,2020-05-10,West Bank and the Gaza Strip,0,0,547,"rgb(158, 185, 243)"
22329,2020-05-11,West Bank and the Gaza Strip,0,0,547,"rgb(158, 185, 243)"
22330,2020-05-12,West Bank and the Gaza Strip,0,0,547,"rgb(158, 185, 243)"
22331,2020-05-13,West Bank and the Gaza Strip,0,0,547,"rgb(158, 185, 243)"
22332,2020-05-14,West Bank and the Gaza Strip,0,1,548,"rgb(158, 185, 243)"
22333,2020-05-15,West Bank and the Gaza Strip,0,0,548,"rgb(158, 185, 243)"
22334,2020-05-16,West Bank and the Gaza Strip,0,6,554,"rgb(158, 185, 243)"
22335,2020-05-17,West Bank and the Gaza Strip,0,0,554,"rgb(158, 185, 243)"
22336,2020-05-18,West Bank and the Gaza Strip,0,6,560,"rgb(158, 185, 243)"
22337,2020-05-19,West Bank and the Gaza Strip,0,7,567,"rgb(158, 185, 243)"
22338,2020-05-20,West Bank and the Gaza Strip,0,3,570,"rgb(158, 185, 243)"
22339,2020-05-21,West Bank and the Gaza Strip,0,7,577,"rgb(158, 185, 243)"
22340,2020-05-22,West Bank and the Gaza Strip,0,25,602,"rgb(158, 185, 243)"
22341,2020-05-23,West Bank and the Gaza Strip,0,0,602,"rgb(158, 185, 243)"
22342,2020-05-24,West Bank and the Gaza Strip,1,0,602,"rgb(158, 185, 243)"
22343,2020-05-25,West Bank and the Gaza Strip,0,0,602,"rgb(158, 185, 243)"
22344,2020-05-26,West Bank and the Gaza Strip,0,0,602,"rgb(158, 185, 243)"
22345,2020-05-27,West Bank and the Gaza Strip,0,3,605,"rgb(158, 185, 243)"
22346,2020-05-28,West Bank and the Gaza Strip,0,8,613,"rgb(158, 185, 243)"
22347,2020-05-29,West Bank and the Gaza Strip,0,12,625,"rgb(158, 185, 243)"
22348,2020-05-30,West Bank and the Gaza Strip,0,0,625,"rgb(158, 185, 243)"
22349,2020-05-31,West Bank and the Gaza Strip,0,1,626,"rgb(158, 185, 243)"
22350,2020-06-01,West Bank and the Gaza Strip,0,1,627,"rgb(158, 185, 243)"
22351,2020-06-02,West Bank and the Gaza Strip,0,1,628,"rgb(158, 185, 243)"
22352,2020-06-03,West Bank and the Gaza Strip,0,2,630,"rgb(158, 185, 243)"
22353,2020-06-04,West Bank and the Gaza Strip,0,5,635,"rgb(158, 185, 243)"
22354,2020-06-05,West Bank and the Gaza Strip,0,8,643,"rgb(158, 185, 243)"
22355,2020-06-06,West Bank and the Gaza Strip,0,0,643,"rgb(158, 185, 243)"
22356,2020-06-07,West Bank and the Gaza Strip,0,0,643,"rgb(158, 185, 243)"
22357,2020-06-08,West Bank and the Gaza Strip,0,8,651,"rgb(158, 185, 243)"
22358,2020-06-09,West Bank and the Gaza Strip,0,1,652,"rgb(158, 185, 243)"
22359,2020-06-10,West Bank and the Gaza Strip,0,9,661,"rgb(158, 185, 243)"
22360,2020-06-11,West Bank and the Gaza Strip,0,4,665,"rgb(158, 185, 243)"
22361,2020-06-12,West Bank and the Gaza Strip,0,2,667,"rgb(158, 185, 243)"
22362,2020-06-13,West Bank and the Gaza Strip,0,2,669,"rgb(158, 185, 243)"
22363,2020-06-14,West Bank and the Gaza Strip,0,4,673,"rgb(158, 185, 243)"
22364,2020-06-15,West Bank and the Gaza Strip,0,0,673,"rgb(158, 185, 243)"
22365,2020-06-16,West Bank and the Gaza Strip,0,13,686,"rgb(158, 185, 243)"
22366,2020-06-17,West Bank and the Gaza Strip,0,4,690,"rgb(158, 185, 243)"
22367,2020-06-18,West Bank and the Gaza Strip,0,11,701,"rgb(158, 185, 243)"
22368,2020-06-19,West Bank and the Gaza Strip,0,94,795,"rgb(158, 185, 243)"
22369,2020-06-20,West Bank and the Gaza Strip,0,63,858,"rgb(158, 185, 243)"
22370,2020-06-21,West Bank and the Gaza Strip,0,121,979,"rgb(158, 185, 243)"
22371,2020-06-22,West Bank and the Gaza Strip,0,43,1022,"rgb(158, 185, 243)"
22372,2020-06-23,West Bank and the Gaza Strip,0,174,1196,"rgb(158, 185, 243)"
22373,2020-06-24,West Bank and the Gaza Strip,0,179,1375,"rgb(158, 185, 243)"
22374,2020-06-25,West Bank and the Gaza Strip,0,159,1534,"rgb(158, 185, 243)"
22375,2020-06-26,West Bank and the Gaza Strip,0,54,1588,"rgb(158, 185, 243)"
22376,2020-06-27,West Bank and the Gaza Strip,0,207,1795,"rgb(158, 185, 243)"
22377,2020-06-28,West Bank and the Gaza Strip,1,258,2053,"rgb(158, 185, 243)"
22378,2020-06-29,West Bank and the Gaza Strip,1,195,2248,"rgb(158, 185, 243)"
22379,2020-06-30,West Bank and the Gaza Strip,1,195,2443,"rgb(158, 185, 243)"
22380,2020-07-01,West Bank and the Gaza Strip,1,322,2765,"rgb(158, 185, 243)"
22381,2020-07-02,West Bank and the Gaza Strip,2,330,3095,"rgb(158, 185, 243)"
22382,2020-07-03,West Bank and the Gaza Strip,0,322,3417,"rgb(158, 185, 243)"
22383,2020-07-04,West Bank and the Gaza Strip,4,272,3689,"rgb(158, 185, 243)"
22384,2020-07-05,West Bank and the Gaza Strip,1,561,4250,"rgb(158, 185, 243)"
22385,2020-07-06,West Bank and the Gaza Strip,4,208,4458,"rgb(158, 185, 243)"
22386,2020-07-07,West Bank and the Gaza Strip,1,328,4786,"rgb(158, 185, 243)"
22387,2020-07-08,West Bank and the Gaza Strip,1,306,5092,"rgb(158, 185, 243)"
22388,2020-07-09,West Bank and the Gaza Strip,3,475,5567,"rgb(158, 185, 243)"
22389,2020-07-10,West Bank and the Gaza Strip,2,262,5829,"rgb(158, 185, 243)"
22390,2020-07-11,West Bank and the Gaza Strip,3,396,6225,"rgb(158, 185, 243)"
22391,2020-07-12,West Bank and the Gaza Strip,2,472,6697,"rgb(158, 185, 243)"
22392,2020-07-13,West Bank and the Gaza Strip,5,341,7038,"rgb(158, 185, 243)"
22393,2020-03-03,Portugal,0,2,2,"rgb(254, 136, 177)"
22394,2020-03-04,Portugal,0,2,4,"rgb(254, 136, 177)"
22395,2020-03-05,Portugal,0,1,5,"rgb(254, 136, 177)"
22396,2020-03-06,Portugal,0,4,9,"rgb(254, 136, 177)"
22397,2020-03-07,Portugal,0,4,13,"rgb(254, 136, 177)"
22398,2020-03-08,Portugal,0,8,21,"rgb(254, 136, 177)"
22399,2020-03-09,Portugal,0,9,30,"rgb(254, 136, 177)"
22400,2020-03-10,Portugal,0,9,39,"rgb(254, 136, 177)"
22401,2020-03-11,Portugal,0,2,41,"rgb(254, 136, 177)"
22402,2020-03-12,Portugal,0,18,59,"rgb(254, 136, 177)"
22403,2020-03-13,Portugal,0,19,78,"rgb(254, 136, 177)"
22404,2020-03-14,Portugal,0,34,112,"rgb(254, 136, 177)"
22405,2020-03-15,Portugal,0,57,169,"rgb(254, 136, 177)"
22406,2020-03-16,Portugal,0,76,245,"rgb(254, 136, 177)"
22407,2020-03-17,Portugal,0,86,331,"rgb(254, 136, 177)"
22408,2020-03-18,Portugal,1,117,448,"rgb(254, 136, 177)"
22409,2020-03-19,Portugal,1,194,642,"rgb(254, 136, 177)"
22410,2020-03-20,Portugal,1,143,785,"rgb(254, 136, 177)"
22411,2020-03-21,Portugal,3,235,1020,"rgb(254, 136, 177)"
22412,2020-03-22,Portugal,6,260,1280,"rgb(254, 136, 177)"
22413,2020-03-23,Portugal,2,320,1600,"rgb(254, 136, 177)"
22414,2020-03-24,Portugal,9,460,2060,"rgb(254, 136, 177)"
22415,2020-03-25,Portugal,10,302,2362,"rgb(254, 136, 177)"
22416,2020-03-26,Portugal,10,633,2995,"rgb(254, 136, 177)"
22417,2020-03-27,Portugal,17,549,3544,"rgb(254, 136, 177)"
22418,2020-03-28,Portugal,16,724,4268,"rgb(254, 136, 177)"
22419,2020-03-29,Portugal,24,902,5170,"rgb(254, 136, 177)"
22420,2020-03-30,Portugal,19,792,5962,"rgb(254, 136, 177)"
22421,2020-03-31,Portugal,21,446,6408,"rgb(254, 136, 177)"
22422,2020-04-01,Portugal,20,1035,7443,"rgb(254, 136, 177)"
22423,2020-04-02,Portugal,27,808,8251,"rgb(254, 136, 177)"
22424,2020-04-03,Portugal,22,783,9034,"rgb(254, 136, 177)"
22425,2020-04-04,Portugal,37,852,9886,"rgb(254, 136, 177)"
22426,2020-04-05,Portugal,20,638,10524,"rgb(254, 136, 177)"
22427,2020-04-06,Portugal,29,754,11278,"rgb(254, 136, 177)"
22428,2020-04-07,Portugal,16,452,11730,"rgb(254, 136, 177)"
22429,2020-04-08,Portugal,34,712,12442,"rgb(254, 136, 177)"
22430,2020-04-09,Portugal,35,699,13141,"rgb(254, 136, 177)"
22431,2020-04-10,Portugal,29,815,13956,"rgb(254, 136, 177)"
22432,2020-04-11,Portugal,26,1516,15472,"rgb(254, 136, 177)"
22433,2020-04-12,Portugal,35,515,15987,"rgb(254, 136, 177)"
22434,2020-04-13,Portugal,34,598,16585,"rgb(254, 136, 177)"
22435,2020-04-14,Portugal,31,349,16934,"rgb(254, 136, 177)"
22436,2020-04-15,Portugal,32,514,17448,"rgb(254, 136, 177)"
22437,2020-04-16,Portugal,32,643,18091,"rgb(254, 136, 177)"
22438,2020-04-17,Portugal,30,750,18841,"rgb(254, 136, 177)"
22439,2020-04-18,Portugal,28,181,19022,"rgb(254, 136, 177)"
22440,2020-04-19,Portugal,30,663,19685,"rgb(254, 136, 177)"
22441,2020-04-20,Portugal,27,521,20206,"rgb(254, 136, 177)"
22442,2020-04-21,Portugal,21,657,20863,"rgb(254, 136, 177)"
22443,2020-04-22,Portugal,27,516,21379,"rgb(254, 136, 177)"
22444,2020-04-23,Portugal,23,603,21982,"rgb(254, 136, 177)"
22445,2020-04-24,Portugal,35,371,22353,"rgb(254, 136, 177)"
22446,2020-04-25,Portugal,60,918,23271,"rgb(254, 136, 177)"
22447,2020-04-26,Portugal,23,412,23683,"rgb(254, 136, 177)"
22448,2020-04-27,Portugal,25,163,23846,"rgb(254, 136, 177)"
22449,2020-04-28,Portugal,20,298,24144,"rgb(254, 136, 177)"
22450,2020-04-29,Portugal,25,180,24324,"rgb(254, 136, 177)"
22451,2020-04-30,Portugal,16,368,24692,"rgb(254, 136, 177)"
22452,2020-05-01,Portugal,18,295,24987,"rgb(254, 136, 177)"
22453,2020-05-02,Portugal,0,364,25351,"rgb(254, 136, 177)"
22454,2020-05-03,Portugal,16,-161,25190,"rgb(254, 136, 177)"
22455,2020-05-04,Portugal,40,334,25524,"rgb(254, 136, 177)"
22456,2020-05-05,Portugal,0,0,25524,"rgb(254, 136, 177)"
22457,2020-05-06,Portugal,11,178,25702,"rgb(254, 136, 177)"
22458,2020-05-07,Portugal,15,480,26182,"rgb(254, 136, 177)"
22459,2020-05-08,Portugal,16,533,26715,"rgb(254, 136, 177)"
22460,2020-05-09,Portugal,9,553,27268,"rgb(254, 136, 177)"
22461,2020-05-10,Portugal,12,138,27406,"rgb(254, 136, 177)"
22462,2020-05-11,Portugal,9,175,27581,"rgb(254, 136, 177)"
22463,2020-05-12,Portugal,9,98,27679,"rgb(254, 136, 177)"
22464,2020-05-13,Portugal,19,234,27913,"rgb(254, 136, 177)"
22465,2020-05-14,Portugal,12,219,28132,"rgb(254, 136, 177)"
22466,2020-05-15,Portugal,9,187,28319,"rgb(254, 136, 177)"
22467,2020-05-16,Portugal,6,264,28583,"rgb(254, 136, 177)"
22468,2020-05-17,Portugal,13,227,28810,"rgb(254, 136, 177)"
22469,2020-05-18,Portugal,15,226,29036,"rgb(254, 136, 177)"
22470,2020-05-19,Portugal,13,173,29209,"rgb(254, 136, 177)"
22471,2020-05-20,Portugal,16,223,29432,"rgb(254, 136, 177)"
22472,2020-05-21,Portugal,16,228,29660,"rgb(254, 136, 177)"
22473,2020-05-22,Portugal,14,252,29912,"rgb(254, 136, 177)"
22474,2020-05-23,Portugal,12,288,30200,"rgb(254, 136, 177)"
22475,2020-05-24,Portugal,13,271,30471,"rgb(254, 136, 177)"
22476,2020-05-25,Portugal,14,152,30623,"rgb(254, 136, 177)"
22477,2020-05-26,Portugal,14,165,30788,"rgb(254, 136, 177)"
22478,2020-05-27,Portugal,12,219,31007,"rgb(254, 136, 177)"
22479,2020-05-28,Portugal,14,285,31292,"rgb(254, 136, 177)"
22480,2020-05-29,Portugal,13,304,31596,"rgb(254, 136, 177)"
22481,2020-05-30,Portugal,14,350,31946,"rgb(254, 136, 177)"
22482,2020-05-31,Portugal,13,257,32203,"rgb(254, 136, 177)"
22483,2020-06-01,Portugal,14,297,32500,"rgb(254, 136, 177)"
22484,2020-06-02,Portugal,14,200,32700,"rgb(254, 136, 177)"
22485,2020-06-03,Portugal,12,195,32895,"rgb(254, 136, 177)"
22486,2020-06-04,Portugal,11,366,33261,"rgb(254, 136, 177)"
22487,2020-06-05,Portugal,8,331,33592,"rgb(254, 136, 177)"
22488,2020-06-06,Portugal,10,377,33969,"rgb(254, 136, 177)"
22489,2020-06-07,Portugal,9,382,34351,"rgb(254, 136, 177)"
22490,2020-06-08,Portugal,5,142,34493,"rgb(254, 136, 177)"
22491,2020-06-09,Portugal,6,392,34885,"rgb(254, 136, 177)"
22492,2020-06-10,Portugal,7,421,35306,"rgb(254, 136, 177)"
22493,2020-06-11,Portugal,3,294,35600,"rgb(254, 136, 177)"
22494,2020-06-12,Portugal,9,310,35910,"rgb(254, 136, 177)"
22495,2020-06-13,Portugal,1,270,36180,"rgb(254, 136, 177)"
22496,2020-06-14,Portugal,7,283,36463,"rgb(254, 136, 177)"
22497,2020-06-15,Portugal,5,227,36690,"rgb(254, 136, 177)"
22498,2020-06-16,Portugal,3,346,37036,"rgb(254, 136, 177)"
22499,2020-06-17,Portugal,2,300,37336,"rgb(254, 136, 177)"
22500,2020-06-18,Portugal,1,336,37672,"rgb(254, 136, 177)"
22501,2020-06-19,Portugal,1,417,38089,"rgb(254, 136, 177)"
22502,2020-06-20,Portugal,3,375,38464,"rgb(254, 136, 177)"
22503,2020-06-21,Portugal,1,377,38841,"rgb(254, 136, 177)"
22504,2020-06-22,Portugal,2,292,39133,"rgb(254, 136, 177)"
22505,2020-06-23,Portugal,4,259,39392,"rgb(254, 136, 177)"
22506,2020-06-24,Portugal,6,345,39737,"rgb(254, 136, 177)"
22507,2020-06-25,Portugal,3,367,40104,"rgb(254, 136, 177)"
22508,2020-06-26,Portugal,6,311,40415,"rgb(254, 136, 177)"
22509,2020-06-27,Portugal,6,451,40866,"rgb(254, 136, 177)"
22510,2020-06-28,Portugal,6,323,41189,"rgb(254, 136, 177)"
22511,2020-06-29,Portugal,3,457,41646,"rgb(254, 136, 177)"
22512,2020-06-30,Portugal,4,266,41912,"rgb(254, 136, 177)"
22513,2020-07-01,Portugal,8,229,42141,"rgb(254, 136, 177)"
22514,2020-07-02,Portugal,3,313,42454,"rgb(254, 136, 177)"
22515,2020-07-03,Portugal,8,328,42782,"rgb(254, 136, 177)"
22516,2020-07-04,Portugal,11,374,43156,"rgb(254, 136, 177)"
22517,2020-07-05,Portugal,7,413,43569,"rgb(254, 136, 177)"
22518,2020-07-06,Portugal,9,328,43897,"rgb(254, 136, 177)"
22519,2020-07-07,Portugal,6,232,44129,"rgb(254, 136, 177)"
22520,2020-07-08,Portugal,9,287,44416,"rgb(254, 136, 177)"
22521,2020-07-09,Portugal,2,443,44859,"rgb(254, 136, 177)"
22522,2020-07-10,Portugal,13,418,45277,"rgb(254, 136, 177)"
22523,2020-07-11,Portugal,2,402,45679,"rgb(254, 136, 177)"
22524,2020-07-12,Portugal,8,542,46221,"rgb(254, 136, 177)"
22525,2020-07-13,Portugal,6,291,46512,"rgb(254, 136, 177)"
22526,2020-03-08,Paraguay,0,1,1,"rgb(201, 219, 116)"
22527,2020-03-11,Paraguay,0,4,5,"rgb(201, 219, 116)"
22528,2020-03-13,Paraguay,0,1,6,"rgb(201, 219, 116)"
22529,2020-03-14,Paraguay,0,1,7,"rgb(201, 219, 116)"
22530,2020-03-16,Paraguay,0,1,8,"rgb(201, 219, 116)"
22531,2020-03-17,Paraguay,0,1,9,"rgb(201, 219, 116)"
22532,2020-03-18,Paraguay,0,2,11,"rgb(201, 219, 116)"
22533,2020-03-19,Paraguay,0,0,11,"rgb(201, 219, 116)"
22534,2020-03-20,Paraguay,0,2,13,"rgb(201, 219, 116)"
22535,2020-03-21,Paraguay,1,5,18,"rgb(201, 219, 116)"
22536,2020-03-22,Paraguay,0,4,22,"rgb(201, 219, 116)"
22537,2020-03-23,Paraguay,0,0,22,"rgb(201, 219, 116)"
22538,2020-03-24,Paraguay,0,5,27,"rgb(201, 219, 116)"
22539,2020-03-25,Paraguay,2,10,37,"rgb(201, 219, 116)"
22540,2020-03-26,Paraguay,0,4,41,"rgb(201, 219, 116)"
22541,2020-03-27,Paraguay,0,11,52,"rgb(201, 219, 116)"
22542,2020-03-28,Paraguay,0,4,56,"rgb(201, 219, 116)"
22543,2020-03-29,Paraguay,0,3,59,"rgb(201, 219, 116)"
22544,2020-03-30,Paraguay,0,5,64,"rgb(201, 219, 116)"
22545,2020-03-31,Paraguay,0,1,65,"rgb(201, 219, 116)"
22546,2020-04-01,Paraguay,0,4,69,"rgb(201, 219, 116)"
22547,2020-04-02,Paraguay,0,0,69,"rgb(201, 219, 116)"
22548,2020-04-03,Paraguay,0,8,77,"rgb(201, 219, 116)"
22549,2020-04-04,Paraguay,0,19,96,"rgb(201, 219, 116)"
22550,2020-04-05,Paraguay,0,8,104,"rgb(201, 219, 116)"
22551,2020-04-06,Paraguay,2,9,113,"rgb(201, 219, 116)"
22552,2020-04-07,Paraguay,0,0,113,"rgb(201, 219, 116)"
22553,2020-04-08,Paraguay,0,2,115,"rgb(201, 219, 116)"
22554,2020-04-09,Paraguay,0,9,124,"rgb(201, 219, 116)"
22555,2020-04-10,Paraguay,1,5,129,"rgb(201, 219, 116)"
22556,2020-04-11,Paraguay,0,4,133,"rgb(201, 219, 116)"
22557,2020-04-12,Paraguay,0,1,134,"rgb(201, 219, 116)"
22558,2020-04-13,Paraguay,0,13,147,"rgb(201, 219, 116)"
22559,2020-04-14,Paraguay,1,12,159,"rgb(201, 219, 116)"
22560,2020-04-15,Paraguay,1,2,161,"rgb(201, 219, 116)"
22561,2020-04-16,Paraguay,0,13,174,"rgb(201, 219, 116)"
22562,2020-04-17,Paraguay,0,0,174,"rgb(201, 219, 116)"
22563,2020-04-18,Paraguay,0,28,202,"rgb(201, 219, 116)"
22564,2020-04-19,Paraguay,0,0,202,"rgb(201, 219, 116)"
22565,2020-04-20,Paraguay,0,4,206,"rgb(201, 219, 116)"
22566,2020-04-21,Paraguay,0,2,208,"rgb(201, 219, 116)"
22567,2020-04-22,Paraguay,1,5,213,"rgb(201, 219, 116)"
22568,2020-04-23,Paraguay,0,0,213,"rgb(201, 219, 116)"
22569,2020-04-24,Paraguay,0,7,220,"rgb(201, 219, 116)"
22570,2020-04-25,Paraguay,0,3,223,"rgb(201, 219, 116)"
22571,2020-04-26,Paraguay,0,5,228,"rgb(201, 219, 116)"
22572,2020-04-27,Paraguay,0,0,228,"rgb(201, 219, 116)"
22573,2020-04-28,Paraguay,0,2,230,"rgb(201, 219, 116)"
22574,2020-04-29,Paraguay,0,9,239,"rgb(201, 219, 116)"
22575,2020-04-30,Paraguay,0,10,249,"rgb(201, 219, 116)"
22576,2020-05-01,Paraguay,1,17,266,"rgb(201, 219, 116)"
22577,2020-05-02,Paraguay,0,67,333,"rgb(201, 219, 116)"
22578,2020-05-03,Paraguay,0,37,370,"rgb(201, 219, 116)"
22579,2020-05-04,Paraguay,0,26,396,"rgb(201, 219, 116)"
22580,2020-05-05,Paraguay,0,19,415,"rgb(201, 219, 116)"
22581,2020-05-06,Paraguay,0,16,431,"rgb(201, 219, 116)"
22582,2020-05-07,Paraguay,0,9,440,"rgb(201, 219, 116)"
22583,2020-05-08,Paraguay,0,22,462,"rgb(201, 219, 116)"
22584,2020-05-09,Paraguay,0,101,563,"rgb(201, 219, 116)"
22585,2020-05-10,Paraguay,0,126,689,"rgb(201, 219, 116)"
22586,2020-05-11,Paraguay,0,24,713,"rgb(201, 219, 116)"
22587,2020-05-12,Paraguay,0,11,724,"rgb(201, 219, 116)"
22588,2020-05-13,Paraguay,0,13,737,"rgb(201, 219, 116)"
22589,2020-05-14,Paraguay,1,3,740,"rgb(201, 219, 116)"
22590,2020-05-15,Paraguay,0,14,754,"rgb(201, 219, 116)"
22591,2020-05-16,Paraguay,0,5,759,"rgb(201, 219, 116)"
22592,2020-05-17,Paraguay,0,19,778,"rgb(201, 219, 116)"
22593,2020-05-18,Paraguay,0,8,786,"rgb(201, 219, 116)"
22594,2020-05-19,Paraguay,0,2,788,"rgb(201, 219, 116)"
22595,2020-05-20,Paraguay,0,41,829,"rgb(201, 219, 116)"
22596,2020-05-21,Paraguay,0,4,833,"rgb(201, 219, 116)"
22597,2020-05-22,Paraguay,0,3,836,"rgb(201, 219, 116)"
22598,2020-05-23,Paraguay,0,2,838,"rgb(201, 219, 116)"
22599,2020-05-24,Paraguay,0,12,850,"rgb(201, 219, 116)"
22600,2020-05-25,Paraguay,0,12,862,"rgb(201, 219, 116)"
22601,2020-05-26,Paraguay,0,3,865,"rgb(201, 219, 116)"
22602,2020-05-27,Paraguay,0,12,877,"rgb(201, 219, 116)"
22603,2020-05-28,Paraguay,0,7,884,"rgb(201, 219, 116)"
22604,2020-05-29,Paraguay,0,16,900,"rgb(201, 219, 116)"
22605,2020-05-30,Paraguay,0,17,917,"rgb(201, 219, 116)"
22606,2020-05-31,Paraguay,0,47,964,"rgb(201, 219, 116)"
22607,2020-06-01,Paraguay,0,22,986,"rgb(201, 219, 116)"
22608,2020-06-02,Paraguay,0,9,995,"rgb(201, 219, 116)"
22609,2020-06-03,Paraguay,0,18,1013,"rgb(201, 219, 116)"
22610,2020-06-04,Paraguay,0,57,1070,"rgb(201, 219, 116)"
22611,2020-06-05,Paraguay,0,16,1086,"rgb(201, 219, 116)"
22612,2020-06-06,Paraguay,0,1,1087,"rgb(201, 219, 116)"
22613,2020-06-07,Paraguay,0,3,1090,"rgb(201, 219, 116)"
22614,2020-06-08,Paraguay,0,45,1135,"rgb(201, 219, 116)"
22615,2020-06-09,Paraguay,0,10,1145,"rgb(201, 219, 116)"
22616,2020-06-10,Paraguay,0,42,1187,"rgb(201, 219, 116)"
22617,2020-06-11,Paraguay,0,15,1202,"rgb(201, 219, 116)"
22618,2020-06-12,Paraguay,0,28,1230,"rgb(201, 219, 116)"
22619,2020-06-13,Paraguay,0,24,1254,"rgb(201, 219, 116)"
22620,2020-06-14,Paraguay,0,7,1261,"rgb(201, 219, 116)"
22621,2020-06-15,Paraguay,0,28,1289,"rgb(201, 219, 116)"
22622,2020-06-16,Paraguay,1,0,1289,"rgb(201, 219, 116)"
22623,2020-06-17,Paraguay,1,14,1303,"rgb(201, 219, 116)"
22624,2020-06-18,Paraguay,0,5,1308,"rgb(201, 219, 116)"
22625,2020-06-19,Paraguay,0,22,1330,"rgb(201, 219, 116)"
22626,2020-06-20,Paraguay,0,6,1336,"rgb(201, 219, 116)"
22627,2020-06-21,Paraguay,0,26,1362,"rgb(201, 219, 116)"
22628,2020-06-22,Paraguay,0,17,1379,"rgb(201, 219, 116)"
22629,2020-06-23,Paraguay,0,13,1392,"rgb(201, 219, 116)"
22630,2020-06-24,Paraguay,0,30,1422,"rgb(201, 219, 116)"
22631,2020-06-25,Paraguay,0,106,1528,"rgb(201, 219, 116)"
22632,2020-06-26,Paraguay,0,41,1569,"rgb(201, 219, 116)"
22633,2020-06-27,Paraguay,0,142,1711,"rgb(201, 219, 116)"
22634,2020-06-28,Paraguay,2,231,1942,"rgb(201, 219, 116)"
22635,2020-06-29,Paraguay,0,185,2127,"rgb(201, 219, 116)"
22636,2020-06-30,Paraguay,1,64,2191,"rgb(201, 219, 116)"
22637,2020-07-01,Paraguay,1,30,2221,"rgb(201, 219, 116)"
22638,2020-07-02,Paraguay,2,39,2260,"rgb(201, 219, 116)"
22639,2020-07-03,Paraguay,0,43,2303,"rgb(201, 219, 116)"
22640,2020-07-04,Paraguay,0,46,2349,"rgb(201, 219, 116)"
22641,2020-07-05,Paraguay,1,36,2385,"rgb(201, 219, 116)"
22642,2020-07-06,Paraguay,0,42,2427,"rgb(201, 219, 116)"
22643,2020-07-07,Paraguay,0,29,2456,"rgb(201, 219, 116)"
22644,2020-07-08,Paraguay,0,46,2502,"rgb(201, 219, 116)"
22645,2020-07-09,Paraguay,0,52,2554,"rgb(201, 219, 116)"
22646,2020-07-10,Paraguay,0,84,2638,"rgb(201, 219, 116)"
22647,2020-07-11,Paraguay,0,98,2736,"rgb(201, 219, 116)"
22648,2020-07-12,Paraguay,1,84,2820,"rgb(201, 219, 116)"
22649,2020-07-13,Paraguay,1,128,2948,"rgb(201, 219, 116)"
22650,2019-12-31,Qatar,0,0,0,"rgb(139, 224, 164)"
22651,2020-01-01,Qatar,0,0,0,"rgb(139, 224, 164)"
22652,2020-01-02,Qatar,0,0,0,"rgb(139, 224, 164)"
22653,2020-01-03,Qatar,0,0,0,"rgb(139, 224, 164)"
22654,2020-01-04,Qatar,0,0,0,"rgb(139, 224, 164)"
22655,2020-01-05,Qatar,0,0,0,"rgb(139, 224, 164)"
22656,2020-01-06,Qatar,0,0,0,"rgb(139, 224, 164)"
22657,2020-01-07,Qatar,0,0,0,"rgb(139, 224, 164)"
22658,2020-01-08,Qatar,0,0,0,"rgb(139, 224, 164)"
22659,2020-01-09,Qatar,0,0,0,"rgb(139, 224, 164)"
22660,2020-01-10,Qatar,0,0,0,"rgb(139, 224, 164)"
22661,2020-01-11,Qatar,0,0,0,"rgb(139, 224, 164)"
22662,2020-01-12,Qatar,0,0,0,"rgb(139, 224, 164)"
22663,2020-01-13,Qatar,0,0,0,"rgb(139, 224, 164)"
22664,2020-01-14,Qatar,0,0,0,"rgb(139, 224, 164)"
22665,2020-01-15,Qatar,0,0,0,"rgb(139, 224, 164)"
22666,2020-01-16,Qatar,0,0,0,"rgb(139, 224, 164)"
22667,2020-01-17,Qatar,0,0,0,"rgb(139, 224, 164)"
22668,2020-01-18,Qatar,0,0,0,"rgb(139, 224, 164)"
22669,2020-01-19,Qatar,0,0,0,"rgb(139, 224, 164)"
22670,2020-01-20,Qatar,0,0,0,"rgb(139, 224, 164)"
22671,2020-01-21,Qatar,0,0,0,"rgb(139, 224, 164)"
22672,2020-01-22,Qatar,0,0,0,"rgb(139, 224, 164)"
22673,2020-01-23,Qatar,0,0,0,"rgb(139, 224, 164)"
22674,2020-01-24,Qatar,0,0,0,"rgb(139, 224, 164)"
22675,2020-01-25,Qatar,0,0,0,"rgb(139, 224, 164)"
22676,2020-01-26,Qatar,0,0,0,"rgb(139, 224, 164)"
22677,2020-01-27,Qatar,0,0,0,"rgb(139, 224, 164)"
22678,2020-01-28,Qatar,0,0,0,"rgb(139, 224, 164)"
22679,2020-01-29,Qatar,0,0,0,"rgb(139, 224, 164)"
22680,2020-01-30,Qatar,0,0,0,"rgb(139, 224, 164)"
22681,2020-01-31,Qatar,0,0,0,"rgb(139, 224, 164)"
22682,2020-02-01,Qatar,0,0,0,"rgb(139, 224, 164)"
22683,2020-02-02,Qatar,0,0,0,"rgb(139, 224, 164)"
22684,2020-02-03,Qatar,0,0,0,"rgb(139, 224, 164)"
22685,2020-02-04,Qatar,0,0,0,"rgb(139, 224, 164)"
22686,2020-02-05,Qatar,0,0,0,"rgb(139, 224, 164)"
22687,2020-02-06,Qatar,0,0,0,"rgb(139, 224, 164)"
22688,2020-02-07,Qatar,0,0,0,"rgb(139, 224, 164)"
22689,2020-02-08,Qatar,0,0,0,"rgb(139, 224, 164)"
22690,2020-02-09,Qatar,0,0,0,"rgb(139, 224, 164)"
22691,2020-02-10,Qatar,0,0,0,"rgb(139, 224, 164)"
22692,2020-02-11,Qatar,0,0,0,"rgb(139, 224, 164)"
22693,2020-02-12,Qatar,0,0,0,"rgb(139, 224, 164)"
22694,2020-02-13,Qatar,0,0,0,"rgb(139, 224, 164)"
22695,2020-02-14,Qatar,0,0,0,"rgb(139, 224, 164)"
22696,2020-02-15,Qatar,0,0,0,"rgb(139, 224, 164)"
22697,2020-02-16,Qatar,0,0,0,"rgb(139, 224, 164)"
22698,2020-02-17,Qatar,0,0,0,"rgb(139, 224, 164)"
22699,2020-02-18,Qatar,0,0,0,"rgb(139, 224, 164)"
22700,2020-02-19,Qatar,0,0,0,"rgb(139, 224, 164)"
22701,2020-02-20,Qatar,0,0,0,"rgb(139, 224, 164)"
22702,2020-02-21,Qatar,0,0,0,"rgb(139, 224, 164)"
22703,2020-02-22,Qatar,0,0,0,"rgb(139, 224, 164)"
22704,2020-02-23,Qatar,0,0,0,"rgb(139, 224, 164)"
22705,2020-02-24,Qatar,0,0,0,"rgb(139, 224, 164)"
22706,2020-02-25,Qatar,0,0,0,"rgb(139, 224, 164)"
22707,2020-02-26,Qatar,0,0,0,"rgb(139, 224, 164)"
22708,2020-02-27,Qatar,0,0,0,"rgb(139, 224, 164)"
22709,2020-02-28,Qatar,0,0,0,"rgb(139, 224, 164)"
22710,2020-02-29,Qatar,0,0,0,"rgb(139, 224, 164)"
22711,2020-03-01,Qatar,0,1,1,"rgb(139, 224, 164)"
22712,2020-03-02,Qatar,0,2,3,"rgb(139, 224, 164)"
22713,2020-03-04,Qatar,0,5,8,"rgb(139, 224, 164)"
22714,2020-03-07,Qatar,0,3,11,"rgb(139, 224, 164)"
22715,2020-03-08,Qatar,0,1,12,"rgb(139, 224, 164)"
22716,2020-03-09,Qatar,0,3,15,"rgb(139, 224, 164)"
22717,2020-03-10,Qatar,0,3,18,"rgb(139, 224, 164)"
22718,2020-03-11,Qatar,0,6,24,"rgb(139, 224, 164)"
22719,2020-03-12,Qatar,0,238,262,"rgb(139, 224, 164)"
22720,2020-03-14,Qatar,0,58,320,"rgb(139, 224, 164)"
22721,2020-03-15,Qatar,0,17,337,"rgb(139, 224, 164)"
22722,2020-03-16,Qatar,0,64,401,"rgb(139, 224, 164)"
22723,2020-03-17,Qatar,0,38,439,"rgb(139, 224, 164)"
22724,2020-03-18,Qatar,0,3,442,"rgb(139, 224, 164)"
22725,2020-03-19,Qatar,0,10,452,"rgb(139, 224, 164)"
22726,2020-03-20,Qatar,0,8,460,"rgb(139, 224, 164)"
22727,2020-03-21,Qatar,0,10,470,"rgb(139, 224, 164)"
22728,2020-03-22,Qatar,0,11,481,"rgb(139, 224, 164)"
22729,2020-03-23,Qatar,0,13,494,"rgb(139, 224, 164)"
22730,2020-03-24,Qatar,0,7,501,"rgb(139, 224, 164)"
22731,2020-03-25,Qatar,0,25,526,"rgb(139, 224, 164)"
22732,2020-03-26,Qatar,0,11,537,"rgb(139, 224, 164)"
22733,2020-03-27,Qatar,0,12,549,"rgb(139, 224, 164)"
22734,2020-03-28,Qatar,0,13,562,"rgb(139, 224, 164)"
22735,2020-03-29,Qatar,1,28,590,"rgb(139, 224, 164)"
22736,2020-03-30,Qatar,0,44,634,"rgb(139, 224, 164)"
22737,2020-03-31,Qatar,0,59,693,"rgb(139, 224, 164)"
22738,2020-04-01,Qatar,1,88,781,"rgb(139, 224, 164)"
22739,2020-04-02,Qatar,0,54,835,"rgb(139, 224, 164)"
22740,2020-04-03,Qatar,1,114,949,"rgb(139, 224, 164)"
22741,2020-04-04,Qatar,0,0,949,"rgb(139, 224, 164)"
22742,2020-04-05,Qatar,0,376,1325,"rgb(139, 224, 164)"
22743,2020-04-06,Qatar,1,279,1604,"rgb(139, 224, 164)"
22744,2020-04-07,Qatar,0,228,1832,"rgb(139, 224, 164)"
22745,2020-04-08,Qatar,2,225,2057,"rgb(139, 224, 164)"
22746,2020-04-09,Qatar,0,153,2210,"rgb(139, 224, 164)"
22747,2020-04-10,Qatar,0,166,2376,"rgb(139, 224, 164)"
22748,2020-04-11,Qatar,0,136,2512,"rgb(139, 224, 164)"
22749,2020-04-12,Qatar,0,216,2728,"rgb(139, 224, 164)"
22750,2020-04-13,Qatar,1,251,2979,"rgb(139, 224, 164)"
22751,2020-04-14,Qatar,0,252,3231,"rgb(139, 224, 164)"
22752,2020-04-15,Qatar,0,197,3428,"rgb(139, 224, 164)"
22753,2020-04-16,Qatar,0,283,3711,"rgb(139, 224, 164)"
22754,2020-04-17,Qatar,0,392,4103,"rgb(139, 224, 164)"
22755,2020-04-18,Qatar,0,560,4663,"rgb(139, 224, 164)"
22756,2020-04-19,Qatar,1,345,5008,"rgb(139, 224, 164)"
22757,2020-04-20,Qatar,0,440,5448,"rgb(139, 224, 164)"
22758,2020-04-21,Qatar,1,567,6015,"rgb(139, 224, 164)"
22759,2020-04-22,Qatar,0,518,6533,"rgb(139, 224, 164)"
22760,2020-04-23,Qatar,1,608,7141,"rgb(139, 224, 164)"
22761,2020-04-24,Qatar,0,623,7764,"rgb(139, 224, 164)"
22762,2020-04-25,Qatar,0,761,8525,"rgb(139, 224, 164)"
22763,2020-04-26,Qatar,0,833,9358,"rgb(139, 224, 164)"
22764,2020-04-27,Qatar,0,929,10287,"rgb(139, 224, 164)"
22765,2020-04-28,Qatar,0,957,11244,"rgb(139, 224, 164)"
22766,2020-04-29,Qatar,0,677,11921,"rgb(139, 224, 164)"
22767,2020-04-30,Qatar,0,643,12564,"rgb(139, 224, 164)"
22768,2020-05-01,Qatar,0,845,13409,"rgb(139, 224, 164)"
22769,2020-05-02,Qatar,2,687,14096,"rgb(139, 224, 164)"
22770,2020-05-03,Qatar,0,776,14872,"rgb(139, 224, 164)"
22771,2020-05-04,Qatar,0,679,15551,"rgb(139, 224, 164)"
22772,2020-05-05,Qatar,0,640,16191,"rgb(139, 224, 164)"
22773,2020-05-06,Qatar,0,951,17142,"rgb(139, 224, 164)"
22774,2020-05-07,Qatar,0,830,17972,"rgb(139, 224, 164)"
22775,2020-05-08,Qatar,0,918,18890,"rgb(139, 224, 164)"
22776,2020-05-09,Qatar,0,1311,20201,"rgb(139, 224, 164)"
22777,2020-05-10,Qatar,1,1130,21331,"rgb(139, 224, 164)"
22778,2020-05-11,Qatar,1,1189,22520,"rgb(139, 224, 164)"
22779,2020-05-12,Qatar,0,1103,23623,"rgb(139, 224, 164)"
22780,2020-05-13,Qatar,0,1526,25149,"rgb(139, 224, 164)"
22781,2020-05-14,Qatar,0,1390,26539,"rgb(139, 224, 164)"
22782,2020-05-15,Qatar,0,1733,28272,"rgb(139, 224, 164)"
22783,2020-05-16,Qatar,0,1153,29425,"rgb(139, 224, 164)"
22784,2020-05-17,Qatar,1,1547,30972,"rgb(139, 224, 164)"
22785,2020-05-18,Qatar,0,1632,32604,"rgb(139, 224, 164)"
22786,2020-05-19,Qatar,0,1365,33969,"rgb(139, 224, 164)"
22787,2020-05-20,Qatar,0,1637,35606,"rgb(139, 224, 164)"
22788,2020-05-21,Qatar,1,1491,37097,"rgb(139, 224, 164)"
22789,2020-05-22,Qatar,1,1554,38651,"rgb(139, 224, 164)"
22790,2020-05-23,Qatar,2,1830,40481,"rgb(139, 224, 164)"
22791,2020-05-24,Qatar,2,1732,42213,"rgb(139, 224, 164)"
22792,2020-05-25,Qatar,2,1501,43714,"rgb(139, 224, 164)"
22793,2020-05-26,Qatar,3,1751,45465,"rgb(139, 224, 164)"
22794,2020-05-27,Qatar,2,1742,47207,"rgb(139, 224, 164)"
22795,2020-05-28,Qatar,2,1740,48947,"rgb(139, 224, 164)"
22796,2020-05-29,Qatar,3,1967,50914,"rgb(139, 224, 164)"
22797,2020-05-30,Qatar,3,1993,52907,"rgb(139, 224, 164)"
22798,2020-05-31,Qatar,0,2355,55262,"rgb(139, 224, 164)"
22799,2020-06-01,Qatar,2,1648,56910,"rgb(139, 224, 164)"
22800,2020-06-02,Qatar,2,1523,58433,"rgb(139, 224, 164)"
22801,2020-06-03,Qatar,3,1826,60259,"rgb(139, 224, 164)"
22802,2020-06-04,Qatar,2,1901,62160,"rgb(139, 224, 164)"
22803,2020-06-05,Qatar,0,1581,63741,"rgb(139, 224, 164)"
22804,2020-06-06,Qatar,4,1754,65495,"rgb(139, 224, 164)"
22805,2020-06-07,Qatar,2,1700,67195,"rgb(139, 224, 164)"
22806,2020-06-08,Qatar,3,1595,68790,"rgb(139, 224, 164)"
22807,2020-06-09,Qatar,3,1368,70158,"rgb(139, 224, 164)"
22808,2020-06-10,Qatar,5,1721,71879,"rgb(139, 224, 164)"
22809,2020-06-11,Qatar,4,1716,73595,"rgb(139, 224, 164)"
22810,2020-06-12,Qatar,3,1476,75071,"rgb(139, 224, 164)"
22811,2020-06-13,Qatar,1,1517,76588,"rgb(139, 224, 164)"
22812,2020-06-14,Qatar,0,1828,78416,"rgb(139, 224, 164)"
22813,2020-06-15,Qatar,3,1186,79602,"rgb(139, 224, 164)"
22814,2020-06-16,Qatar,3,1274,80876,"rgb(139, 224, 164)"
22815,2020-06-17,Qatar,4,1201,82077,"rgb(139, 224, 164)"
22816,2020-06-18,Qatar,2,1097,83174,"rgb(139, 224, 164)"
22817,2020-06-19,Qatar,4,1267,84441,"rgb(139, 224, 164)"
22818,2020-06-20,Qatar,7,1021,85462,"rgb(139, 224, 164)"
22819,2020-06-21,Qatar,1,1026,86488,"rgb(139, 224, 164)"
22820,2020-06-22,Qatar,4,881,87369,"rgb(139, 224, 164)"
22821,2020-06-23,Qatar,1,1034,88403,"rgb(139, 224, 164)"
22822,2020-06-24,Qatar,0,1176,89579,"rgb(139, 224, 164)"
22823,2020-06-25,Qatar,5,1199,90778,"rgb(139, 224, 164)"
22824,2020-06-26,Qatar,2,1060,91838,"rgb(139, 224, 164)"
22825,2020-06-27,Qatar,3,946,92784,"rgb(139, 224, 164)"
22826,2020-06-28,Qatar,1,879,93663,"rgb(139, 224, 164)"
22827,2020-06-29,Qatar,0,750,94413,"rgb(139, 224, 164)"
22828,2020-06-30,Qatar,3,693,95106,"rgb(139, 224, 164)"
22829,2020-07-01,Qatar,0,982,96088,"rgb(139, 224, 164)"
22830,2020-07-02,Qatar,2,915,97003,"rgb(139, 224, 164)"
22831,2020-07-03,Qatar,3,894,97897,"rgb(139, 224, 164)"
22832,2020-07-04,Qatar,3,756,98653,"rgb(139, 224, 164)"
22833,2020-07-05,Qatar,2,530,99183,"rgb(139, 224, 164)"
22834,2020-07-06,Qatar,5,616,99799,"rgb(139, 224, 164)"
22835,2020-07-07,Qatar,5,546,100345,"rgb(139, 224, 164)"
22836,2020-07-08,Qatar,1,600,100945,"rgb(139, 224, 164)"
22837,2020-07-09,Qatar,4,608,101553,"rgb(139, 224, 164)"
22838,2020-07-10,Qatar,4,557,102110,"rgb(139, 224, 164)"
22839,2020-07-11,Qatar,4,520,102630,"rgb(139, 224, 164)"
22840,2020-07-12,Qatar,0,498,103128,"rgb(139, 224, 164)"
22841,2020-07-13,Qatar,1,470,103598,"rgb(139, 224, 164)"
22842,2019-12-31,Romania,0,0,0,"rgb(180, 151, 231)"
22843,2020-01-01,Romania,0,0,0,"rgb(180, 151, 231)"
22844,2020-01-02,Romania,0,0,0,"rgb(180, 151, 231)"
22845,2020-01-03,Romania,0,0,0,"rgb(180, 151, 231)"
22846,2020-01-04,Romania,0,0,0,"rgb(180, 151, 231)"
22847,2020-01-05,Romania,0,0,0,"rgb(180, 151, 231)"
22848,2020-01-06,Romania,0,0,0,"rgb(180, 151, 231)"
22849,2020-01-07,Romania,0,0,0,"rgb(180, 151, 231)"
22850,2020-01-08,Romania,0,0,0,"rgb(180, 151, 231)"
22851,2020-01-09,Romania,0,0,0,"rgb(180, 151, 231)"
22852,2020-01-10,Romania,0,0,0,"rgb(180, 151, 231)"
22853,2020-01-11,Romania,0,0,0,"rgb(180, 151, 231)"
22854,2020-01-12,Romania,0,0,0,"rgb(180, 151, 231)"
22855,2020-01-13,Romania,0,0,0,"rgb(180, 151, 231)"
22856,2020-01-14,Romania,0,0,0,"rgb(180, 151, 231)"
22857,2020-01-15,Romania,0,0,0,"rgb(180, 151, 231)"
22858,2020-01-16,Romania,0,0,0,"rgb(180, 151, 231)"
22859,2020-01-17,Romania,0,0,0,"rgb(180, 151, 231)"
22860,2020-01-18,Romania,0,0,0,"rgb(180, 151, 231)"
22861,2020-01-19,Romania,0,0,0,"rgb(180, 151, 231)"
22862,2020-01-20,Romania,0,0,0,"rgb(180, 151, 231)"
22863,2020-01-21,Romania,0,0,0,"rgb(180, 151, 231)"
22864,2020-01-22,Romania,0,0,0,"rgb(180, 151, 231)"
22865,2020-01-23,Romania,0,0,0,"rgb(180, 151, 231)"
22866,2020-01-24,Romania,0,0,0,"rgb(180, 151, 231)"
22867,2020-01-25,Romania,0,0,0,"rgb(180, 151, 231)"
22868,2020-01-26,Romania,0,0,0,"rgb(180, 151, 231)"
22869,2020-01-27,Romania,0,0,0,"rgb(180, 151, 231)"
22870,2020-01-28,Romania,0,0,0,"rgb(180, 151, 231)"
22871,2020-01-29,Romania,0,0,0,"rgb(180, 151, 231)"
22872,2020-01-30,Romania,0,0,0,"rgb(180, 151, 231)"
22873,2020-01-31,Romania,0,0,0,"rgb(180, 151, 231)"
22874,2020-02-01,Romania,0,0,0,"rgb(180, 151, 231)"
22875,2020-02-02,Romania,0,0,0,"rgb(180, 151, 231)"
22876,2020-02-03,Romania,0,0,0,"rgb(180, 151, 231)"
22877,2020-02-04,Romania,0,0,0,"rgb(180, 151, 231)"
22878,2020-02-05,Romania,0,0,0,"rgb(180, 151, 231)"
22879,2020-02-06,Romania,0,0,0,"rgb(180, 151, 231)"
22880,2020-02-07,Romania,0,0,0,"rgb(180, 151, 231)"
22881,2020-02-08,Romania,0,0,0,"rgb(180, 151, 231)"
22882,2020-02-09,Romania,0,0,0,"rgb(180, 151, 231)"
22883,2020-02-10,Romania,0,0,0,"rgb(180, 151, 231)"
22884,2020-02-11,Romania,0,0,0,"rgb(180, 151, 231)"
22885,2020-02-12,Romania,0,0,0,"rgb(180, 151, 231)"
22886,2020-02-13,Romania,0,0,0,"rgb(180, 151, 231)"
22887,2020-02-14,Romania,0,0,0,"rgb(180, 151, 231)"
22888,2020-02-15,Romania,0,0,0,"rgb(180, 151, 231)"
22889,2020-02-16,Romania,0,0,0,"rgb(180, 151, 231)"
22890,2020-02-17,Romania,0,0,0,"rgb(180, 151, 231)"
22891,2020-02-18,Romania,0,0,0,"rgb(180, 151, 231)"
22892,2020-02-19,Romania,0,0,0,"rgb(180, 151, 231)"
22893,2020-02-20,Romania,0,0,0,"rgb(180, 151, 231)"
22894,2020-02-21,Romania,0,0,0,"rgb(180, 151, 231)"
22895,2020-02-22,Romania,0,0,0,"rgb(180, 151, 231)"
22896,2020-02-23,Romania,0,0,0,"rgb(180, 151, 231)"
22897,2020-02-24,Romania,0,0,0,"rgb(180, 151, 231)"
22898,2020-02-25,Romania,0,0,0,"rgb(180, 151, 231)"
22899,2020-02-26,Romania,0,0,0,"rgb(180, 151, 231)"
22900,2020-02-27,Romania,0,1,1,"rgb(180, 151, 231)"
22901,2020-02-28,Romania,0,0,1,"rgb(180, 151, 231)"
22902,2020-02-29,Romania,0,2,3,"rgb(180, 151, 231)"
22903,2020-03-01,Romania,0,0,3,"rgb(180, 151, 231)"
22904,2020-03-02,Romania,0,0,3,"rgb(180, 151, 231)"
22905,2020-03-04,Romania,0,1,4,"rgb(180, 151, 231)"
22906,2020-03-06,Romania,0,2,6,"rgb(180, 151, 231)"
22907,2020-03-07,Romania,0,1,7,"rgb(180, 151, 231)"
22908,2020-03-08,Romania,0,6,13,"rgb(180, 151, 231)"
22909,2020-03-09,Romania,0,2,15,"rgb(180, 151, 231)"
22910,2020-03-10,Romania,0,2,17,"rgb(180, 151, 231)"
22911,2020-03-11,Romania,0,8,25,"rgb(180, 151, 231)"
22912,2020-03-12,Romania,0,20,45,"rgb(180, 151, 231)"
22913,2020-03-13,Romania,0,19,64,"rgb(180, 151, 231)"
22914,2020-03-14,Romania,0,25,89,"rgb(180, 151, 231)"
22915,2020-03-15,Romania,0,24,113,"rgb(180, 151, 231)"
22916,2020-03-16,Romania,0,26,139,"rgb(180, 151, 231)"
22917,2020-03-17,Romania,0,45,184,"rgb(180, 151, 231)"
22918,2020-03-18,Romania,0,33,217,"rgb(180, 151, 231)"
22919,2020-03-19,Romania,0,43,260,"rgb(180, 151, 231)"
22920,2020-03-20,Romania,0,17,277,"rgb(180, 151, 231)"
22921,2020-03-21,Romania,0,31,308,"rgb(180, 151, 231)"
22922,2020-03-22,Romania,0,59,367,"rgb(180, 151, 231)"
22923,2020-03-23,Romania,2,66,433,"rgb(180, 151, 231)"
22924,2020-03-24,Romania,5,143,576,"rgb(180, 151, 231)"
22925,2020-03-25,Romania,4,186,762,"rgb(180, 151, 231)"
22926,2020-03-26,Romania,2,144,906,"rgb(180, 151, 231)"
22927,2020-03-27,Romania,4,123,1029,"rgb(180, 151, 231)"
22928,2020-03-28,Romania,7,263,1292,"rgb(180, 151, 231)"
22929,2020-03-29,Romania,5,160,1452,"rgb(180, 151, 231)"
22930,2020-03-30,Romania,11,308,1760,"rgb(180, 151, 231)"
22931,2020-03-31,Romania,4,192,1952,"rgb(180, 151, 231)"
22932,2020-04-01,Romania,25,293,2245,"rgb(180, 151, 231)"
22933,2020-04-02,Romania,16,215,2460,"rgb(180, 151, 231)"
22934,2020-04-03,Romania,9,278,2738,"rgb(180, 151, 231)"
22935,2020-04-04,Romania,39,445,3183,"rgb(180, 151, 231)"
22936,2020-04-05,Romania,8,430,3613,"rgb(180, 151, 231)"
22937,2020-04-06,Romania,7,251,3864,"rgb(180, 151, 231)"
22938,2020-04-07,Romania,9,193,4057,"rgb(180, 151, 231)"
22939,2020-04-08,Romania,25,360,4417,"rgb(180, 151, 231)"
22940,2020-04-09,Romania,27,344,4761,"rgb(180, 151, 231)"
22941,2020-04-10,Romania,20,441,5202,"rgb(180, 151, 231)"
22942,2020-04-11,Romania,28,265,5467,"rgb(180, 151, 231)"
22943,2020-04-12,Romania,25,523,5990,"rgb(180, 151, 231)"
22944,2020-04-13,Romania,24,310,6300,"rgb(180, 151, 231)"
22945,2020-04-14,Romania,12,333,6633,"rgb(180, 151, 231)"
22946,2020-04-15,Romania,26,246,6879,"rgb(180, 151, 231)"
22947,2020-04-16,Romania,28,337,7216,"rgb(180, 151, 231)"
22948,2020-04-17,Romania,15,491,7707,"rgb(180, 151, 231)"
22949,2020-04-18,Romania,13,360,8067,"rgb(180, 151, 231)"
22950,2020-04-19,Romania,17,351,8418,"rgb(180, 151, 231)"
22951,2020-04-20,Romania,17,328,8746,"rgb(180, 151, 231)"
22952,2020-04-21,Romania,17,190,8936,"rgb(180, 151, 231)"
22953,2020-04-22,Romania,32,306,9242,"rgb(180, 151, 231)"
22954,2020-04-23,Romania,25,468,9710,"rgb(180, 151, 231)"
22955,2020-04-24,Romania,19,386,10096,"rgb(180, 151, 231)"
22956,2020-04-25,Romania,25,321,10417,"rgb(180, 151, 231)"
22957,2020-04-26,Romania,23,218,10635,"rgb(180, 151, 231)"
22958,2020-04-27,Romania,33,401,11036,"rgb(180, 151, 231)"
22959,2020-04-28,Romania,23,303,11339,"rgb(180, 151, 231)"
22960,2020-04-29,Romania,19,277,11616,"rgb(180, 151, 231)"
22961,2020-04-30,Romania,25,362,11978,"rgb(180, 151, 231)"
22962,2020-05-01,Romania,42,262,12240,"rgb(180, 151, 231)"
22963,2020-05-02,Romania,27,327,12567,"rgb(180, 151, 231)"
22964,2020-05-03,Romania,27,165,12732,"rgb(180, 151, 231)"
22965,2020-05-04,Romania,9,431,13163,"rgb(180, 151, 231)"
22966,2020-05-05,Romania,23,349,13512,"rgb(180, 151, 231)"
22967,2020-05-06,Romania,24,325,13837,"rgb(180, 151, 231)"
22968,2020-05-07,Romania,31,270,14107,"rgb(180, 151, 231)"
22969,2020-05-08,Romania,18,392,14499,"rgb(180, 151, 231)"
22970,2020-05-09,Romania,22,312,14811,"rgb(180, 151, 231)"
22971,2020-05-10,Romania,28,320,15131,"rgb(180, 151, 231)"
22972,2020-05-11,Romania,26,231,15362,"rgb(180, 151, 231)"
22973,2020-05-12,Romania,20,226,15588,"rgb(180, 151, 231)"
22974,2020-05-13,Romania,30,190,15778,"rgb(180, 151, 231)"
22975,2020-05-14,Romania,14,224,16002,"rgb(180, 151, 231)"
22976,2020-05-15,Romania,30,245,16247,"rgb(180, 151, 231)"
22977,2020-05-16,Romania,10,190,16437,"rgb(180, 151, 231)"
22978,2020-05-17,Romania,25,267,16704,"rgb(180, 151, 231)"
22979,2020-05-18,Romania,16,167,16871,"rgb(180, 151, 231)"
22980,2020-05-19,Romania,10,165,17036,"rgb(180, 151, 231)"
22981,2020-05-20,Romania,19,155,17191,"rgb(180, 151, 231)"
22982,2020-05-21,Romania,15,196,17387,"rgb(180, 151, 231)"
22983,2020-05-22,Romania,10,198,17585,"rgb(180, 151, 231)"
22984,2020-05-23,Romania,8,127,17712,"rgb(180, 151, 231)"
22985,2020-05-24,Romania,11,145,17857,"rgb(180, 151, 231)"
22986,2020-05-25,Romania,9,213,18070,"rgb(180, 151, 231)"
22987,2020-05-26,Romania,18,213,18283,"rgb(180, 151, 231)"
22988,2020-05-27,Romania,13,146,18429,"rgb(180, 151, 231)"
22989,2020-05-28,Romania,9,165,18594,"rgb(180, 151, 231)"
22990,2020-05-29,Romania,10,197,18791,"rgb(180, 151, 231)"
22991,2020-05-30,Romania,11,191,18982,"rgb(180, 151, 231)"
22992,2020-05-31,Romania,13,151,19133,"rgb(180, 151, 231)"
22993,2020-06-01,Romania,9,124,19257,"rgb(180, 151, 231)"
22994,2020-06-02,Romania,17,141,19398,"rgb(180, 151, 231)"
22995,2020-06-03,Romania,0,119,19517,"rgb(180, 151, 231)"
22996,2020-06-04,Romania,9,152,19669,"rgb(180, 151, 231)"
22997,2020-06-05,Romania,11,238,19907,"rgb(180, 151, 231)"
22998,2020-06-06,Romania,9,196,20103,"rgb(180, 151, 231)"
22999,2020-06-07,Romania,10,187,20290,"rgb(180, 151, 231)"
23000,2020-06-08,Romania,8,189,20479,"rgb(180, 151, 231)"
23001,2020-06-09,Romania,8,125,20604,"rgb(180, 151, 231)"
23002,2020-06-10,Romania,11,145,20749,"rgb(180, 151, 231)"
23003,2020-06-11,Romania,15,196,20945,"rgb(180, 151, 231)"
23004,2020-06-12,Romania,9,237,21182,"rgb(180, 151, 231)"
23005,2020-06-13,Romania,11,222,21404,"rgb(180, 151, 231)"
23006,2020-06-14,Romania,11,275,21679,"rgb(180, 151, 231)"
23007,2020-06-15,Romania,19,320,21999,"rgb(180, 151, 231)"
23008,2020-06-16,Romania,17,166,22165,"rgb(180, 151, 231)"
23009,2020-06-17,Romania,10,250,22415,"rgb(180, 151, 231)"
23010,2020-06-18,Romania,14,345,22760,"rgb(180, 151, 231)"
23011,2020-06-19,Romania,22,320,23080,"rgb(180, 151, 231)"
23012,2020-06-20,Romania,11,320,23400,"rgb(180, 151, 231)"
23013,2020-06-21,Romania,16,330,23730,"rgb(180, 151, 231)"
23014,2020-06-22,Romania,12,315,24045,"rgb(180, 151, 231)"
23015,2020-06-23,Romania,11,246,24291,"rgb(180, 151, 231)"
23016,2020-06-24,Romania,16,214,24505,"rgb(180, 151, 231)"
23017,2020-06-25,Romania,16,321,24826,"rgb(180, 151, 231)"
23018,2020-06-26,Romania,10,460,25286,"rgb(180, 151, 231)"
23019,2020-06-27,Romania,14,411,25697,"rgb(180, 151, 231)"
23020,2020-06-28,Romania,10,325,26022,"rgb(180, 151, 231)"
23021,2020-06-29,Romania,23,291,26313,"rgb(180, 151, 231)"
23022,2020-06-30,Romania,22,269,26582,"rgb(180, 151, 231)"
23023,2020-07-01,Romania,17,388,26970,"rgb(180, 151, 231)"
23024,2020-07-02,Romania,16,326,27296,"rgb(180, 151, 231)"
23025,2020-07-03,Romania,20,450,27746,"rgb(180, 151, 231)"
23026,2020-07-04,Romania,21,420,28166,"rgb(180, 151, 231)"
23027,2020-07-05,Romania,23,416,28582,"rgb(180, 151, 231)"
23028,2020-07-06,Romania,19,391,28973,"rgb(180, 151, 231)"
23029,2020-07-07,Romania,18,250,29223,"rgb(180, 151, 231)"
23030,2020-07-08,Romania,31,397,29620,"rgb(180, 151, 231)"
23031,2020-07-09,Romania,18,555,30175,"rgb(180, 151, 231)"
23032,2020-07-10,Romania,17,614,30789,"rgb(180, 151, 231)"
23033,2020-07-11,Romania,13,592,31381,"rgb(180, 151, 231)"
23034,2020-07-12,Romania,24,698,32079,"rgb(180, 151, 231)"
23035,2020-07-13,Romania,13,456,32535,"rgb(180, 151, 231)"
23036,2020-03-07,Serbia,0,1,1,"rgb(179, 179, 179)"
23037,2020-03-11,Serbia,0,4,5,"rgb(179, 179, 179)"
23038,2020-03-12,Serbia,0,13,18,"rgb(179, 179, 179)"
23039,2020-03-13,Serbia,0,6,24,"rgb(179, 179, 179)"
23040,2020-03-14,Serbia,0,17,41,"rgb(179, 179, 179)"
23041,2020-03-15,Serbia,0,5,46,"rgb(179, 179, 179)"
23042,2020-03-16,Serbia,0,9,55,"rgb(179, 179, 179)"
23043,2020-03-17,Serbia,0,2,57,"rgb(179, 179, 179)"
23044,2020-03-18,Serbia,0,15,72,"rgb(179, 179, 179)"
23045,2020-03-19,Serbia,0,22,94,"rgb(179, 179, 179)"
23046,2020-03-20,Serbia,0,32,126,"rgb(179, 179, 179)"
23047,2020-03-21,Serbia,1,9,135,"rgb(179, 179, 179)"
23048,2020-03-22,Serbia,0,14,149,"rgb(179, 179, 179)"
23049,2020-03-23,Serbia,0,39,188,"rgb(179, 179, 179)"
23050,2020-03-24,Serbia,0,34,222,"rgb(179, 179, 179)"
23051,2020-03-25,Serbia,0,27,249,"rgb(179, 179, 179)"
23052,2020-03-26,Serbia,1,54,303,"rgb(179, 179, 179)"
23053,2020-03-27,Serbia,1,81,384,"rgb(179, 179, 179)"
23054,2020-03-28,Serbia,3,73,457,"rgb(179, 179, 179)"
23055,2020-03-29,Serbia,4,202,659,"rgb(179, 179, 179)"
23056,2020-03-30,Serbia,3,82,741,"rgb(179, 179, 179)"
23057,2020-03-31,Serbia,0,0,741,"rgb(179, 179, 179)"
23058,2020-04-01,Serbia,10,159,900,"rgb(179, 179, 179)"
23059,2020-04-02,Serbia,0,160,1060,"rgb(179, 179, 179)"
23060,2020-04-03,Serbia,8,111,1171,"rgb(179, 179, 179)"
23061,2020-04-04,Serbia,8,305,1476,"rgb(179, 179, 179)"
23062,2020-04-05,Serbia,5,148,1624,"rgb(179, 179, 179)"
23063,2020-04-06,Serbia,7,284,1908,"rgb(179, 179, 179)"
23064,2020-04-07,Serbia,7,292,2200,"rgb(179, 179, 179)"
23065,2020-04-08,Serbia,3,247,2447,"rgb(179, 179, 179)"
23066,2020-04-09,Serbia,4,219,2666,"rgb(179, 179, 179)"
23067,2020-04-10,Serbia,1,201,2867,"rgb(179, 179, 179)"
23068,2020-04-11,Serbia,5,238,3105,"rgb(179, 179, 179)"
23069,2020-04-12,Serbia,3,275,3380,"rgb(179, 179, 179)"
23070,2020-04-13,Serbia,6,250,3630,"rgb(179, 179, 179)"
23071,2020-04-14,Serbia,5,424,4054,"rgb(179, 179, 179)"
23072,2020-04-15,Serbia,9,411,4465,"rgb(179, 179, 179)"
23073,2020-04-16,Serbia,5,408,4873,"rgb(179, 179, 179)"
23074,2020-04-17,Serbia,4,445,5318,"rgb(179, 179, 179)"
23075,2020-04-18,Serbia,7,372,5690,"rgb(179, 179, 179)"
23076,2020-04-19,Serbia,7,304,5994,"rgb(179, 179, 179)"
23077,2020-04-20,Serbia,5,324,6318,"rgb(179, 179, 179)"
23078,2020-04-21,Serbia,3,312,6630,"rgb(179, 179, 179)"
23079,2020-04-22,Serbia,0,260,6890,"rgb(179, 179, 179)"
23080,2020-04-23,Serbia,9,224,7114,"rgb(179, 179, 179)"
23081,2020-04-24,Serbia,5,162,7276,"rgb(179, 179, 179)"
23082,2020-04-25,Serbia,5,207,7483,"rgb(179, 179, 179)"
23083,2020-04-26,Serbia,7,296,7779,"rgb(179, 179, 179)"
23084,2020-04-27,Serbia,5,263,8042,"rgb(179, 179, 179)"
23085,2020-04-28,Serbia,6,233,8275,"rgb(179, 179, 179)"
23086,2020-04-29,Serbia,6,222,8497,"rgb(179, 179, 179)"
23087,2020-04-30,Serbia,5,227,8724,"rgb(179, 179, 179)"
23088,2020-05-01,Serbia,6,285,9009,"rgb(179, 179, 179)"
23089,2020-05-02,Serbia,6,196,9205,"rgb(179, 179, 179)"
23090,2020-05-03,Serbia,4,157,9362,"rgb(179, 179, 179)"
23091,2020-05-04,Serbia,4,102,9464,"rgb(179, 179, 179)"
23092,2020-05-05,Serbia,4,93,9557,"rgb(179, 179, 179)"
23093,2020-05-06,Serbia,3,120,9677,"rgb(179, 179, 179)"
23094,2020-05-07,Serbia,3,114,9791,"rgb(179, 179, 179)"
23095,2020-05-08,Serbia,3,57,9848,"rgb(179, 179, 179)"
23096,2020-05-09,Serbia,3,95,9943,"rgb(179, 179, 179)"
23097,2020-05-10,Serbia,4,89,10032,"rgb(179, 179, 179)"
23098,2020-05-11,Serbia,2,82,10114,"rgb(179, 179, 179)"
23099,2020-05-12,Serbia,3,62,10176,"rgb(179, 179, 179)"
23100,2020-05-13,Serbia,2,67,10243,"rgb(179, 179, 179)"
23101,2020-05-14,Serbia,2,52,10295,"rgb(179, 179, 179)"
23102,2020-05-15,Serbia,2,79,10374,"rgb(179, 179, 179)"
23103,2020-05-16,Serbia,1,64,10438,"rgb(179, 179, 179)"
23104,2020-05-17,Serbia,3,58,10496,"rgb(179, 179, 179)"
23105,2020-05-18,Serbia,2,114,10610,"rgb(179, 179, 179)"
23106,2020-05-19,Serbia,1,89,10699,"rgb(179, 179, 179)"
23107,2020-05-20,Serbia,3,34,10733,"rgb(179, 179, 179)"
23108,2020-05-21,Serbia,1,100,10833,"rgb(179, 179, 179)"
23109,2020-05-22,Serbia,2,86,10919,"rgb(179, 179, 179)"
23110,2020-05-23,Serbia,0,105,11024,"rgb(179, 179, 179)"
23111,2020-05-24,Serbia,1,68,11092,"rgb(179, 179, 179)"
23112,2020-05-25,Serbia,0,67,11159,"rgb(179, 179, 179)"
23113,2020-05-26,Serbia,1,34,11193,"rgb(179, 179, 179)"
23114,2020-05-27,Serbia,0,34,11227,"rgb(179, 179, 179)"
23115,2020-05-28,Serbia,1,48,11275,"rgb(179, 179, 179)"
23116,2020-05-29,Serbia,1,25,11300,"rgb(179, 179, 179)"
23117,2020-05-30,Serbia,1,54,11354,"rgb(179, 179, 179)"
23118,2020-05-31,Serbia,0,27,11381,"rgb(179, 179, 179)"
23119,2020-06-01,Serbia,1,31,11412,"rgb(179, 179, 179)"
23120,2020-06-02,Serbia,1,18,11430,"rgb(179, 179, 179)"
23121,2020-06-03,Serbia,1,24,11454,"rgb(179, 179, 179)"
23122,2020-06-04,Serbia,0,69,11523,"rgb(179, 179, 179)"
23123,2020-06-05,Serbia,1,48,11571,"rgb(179, 179, 179)"
23124,2020-06-06,Serbia,1,96,11667,"rgb(179, 179, 179)"
23125,2020-06-07,Serbia,1,74,11741,"rgb(179, 179, 179)"
23126,2020-06-08,Serbia,1,82,11823,"rgb(179, 179, 179)"
23127,2020-06-09,Serbia,1,73,11896,"rgb(179, 179, 179)"
23128,2020-06-10,Serbia,0,69,11965,"rgb(179, 179, 179)"
23129,2020-06-11,Serbia,1,66,12031,"rgb(179, 179, 179)"
23130,2020-06-12,Serbia,1,71,12102,"rgb(179, 179, 179)"
23131,2020-06-13,Serbia,0,73,12175,"rgb(179, 179, 179)"
23132,2020-06-14,Serbia,1,76,12251,"rgb(179, 179, 179)"
23133,2020-06-15,Serbia,1,59,12310,"rgb(179, 179, 179)"
23134,2020-06-16,Serbia,1,57,12367,"rgb(179, 179, 179)"
23135,2020-06-17,Serbia,1,59,12426,"rgb(179, 179, 179)"
23136,2020-06-18,Serbia,1,96,12522,"rgb(179, 179, 179)"
23137,2020-06-19,Serbia,1,94,12616,"rgb(179, 179, 179)"
23138,2020-06-20,Serbia,1,93,12709,"rgb(179, 179, 179)"
23139,2020-06-21,Serbia,1,94,12803,"rgb(179, 179, 179)"
23140,2020-06-22,Serbia,1,91,12894,"rgb(179, 179, 179)"
23141,2020-06-23,Serbia,1,96,12990,"rgb(179, 179, 179)"
23142,2020-06-24,Serbia,1,102,13092,"rgb(179, 179, 179)"
23143,2020-06-25,Serbia,0,143,13235,"rgb(179, 179, 179)"
23144,2020-06-26,Serbia,1,137,13372,"rgb(179, 179, 179)"
23145,2020-06-27,Serbia,1,193,13565,"rgb(179, 179, 179)"
23146,2020-06-28,Serbia,2,227,13792,"rgb(179, 179, 179)"
23147,2020-06-29,Serbia,3,254,14046,"rgb(179, 179, 179)"
23148,2020-06-30,Serbia,4,242,14288,"rgb(179, 179, 179)"
23149,2020-07-01,Serbia,3,276,14564,"rgb(179, 179, 179)"
23150,2020-07-02,Serbia,4,272,14836,"rgb(179, 179, 179)"
23151,2020-07-03,Serbia,6,359,15195,"rgb(179, 179, 179)"
23152,2020-07-04,Serbia,11,309,15504,"rgb(179, 179, 179)"
23153,2020-07-05,Serbia,8,325,15829,"rgb(179, 179, 179)"
23154,2020-07-06,Serbia,5,302,16131,"rgb(179, 179, 179)"
23155,2020-07-07,Serbia,6,289,16420,"rgb(179, 179, 179)"
23156,2020-07-08,Serbia,13,299,16719,"rgb(179, 179, 179)"
23157,2020-07-09,Serbia,11,357,17076,"rgb(179, 179, 179)"
23158,2020-07-10,Serbia,11,266,17342,"rgb(179, 179, 179)"
23159,2020-07-11,Serbia,18,386,17728,"rgb(179, 179, 179)"
23160,2020-07-12,Serbia,12,345,18073,"rgb(179, 179, 179)"
23161,2020-07-13,Serbia,11,287,18360,"rgb(179, 179, 179)"
23162,2019-12-31,Russia,0,0,0,"rgb(229, 134, 6)"
23163,2020-01-01,Russia,0,0,0,"rgb(229, 134, 6)"
23164,2020-01-02,Russia,0,0,0,"rgb(229, 134, 6)"
23165,2020-01-03,Russia,0,0,0,"rgb(229, 134, 6)"
23166,2020-01-04,Russia,0,0,0,"rgb(229, 134, 6)"
23167,2020-01-05,Russia,0,0,0,"rgb(229, 134, 6)"
23168,2020-01-06,Russia,0,0,0,"rgb(229, 134, 6)"
23169,2020-01-07,Russia,0,0,0,"rgb(229, 134, 6)"
23170,2020-01-08,Russia,0,0,0,"rgb(229, 134, 6)"
23171,2020-01-09,Russia,0,0,0,"rgb(229, 134, 6)"
23172,2020-01-10,Russia,0,0,0,"rgb(229, 134, 6)"
23173,2020-01-11,Russia,0,0,0,"rgb(229, 134, 6)"
23174,2020-01-12,Russia,0,0,0,"rgb(229, 134, 6)"
23175,2020-01-13,Russia,0,0,0,"rgb(229, 134, 6)"
23176,2020-01-14,Russia,0,0,0,"rgb(229, 134, 6)"
23177,2020-01-15,Russia,0,0,0,"rgb(229, 134, 6)"
23178,2020-01-16,Russia,0,0,0,"rgb(229, 134, 6)"
23179,2020-01-17,Russia,0,0,0,"rgb(229, 134, 6)"
23180,2020-01-18,Russia,0,0,0,"rgb(229, 134, 6)"
23181,2020-01-19,Russia,0,0,0,"rgb(229, 134, 6)"
23182,2020-01-20,Russia,0,0,0,"rgb(229, 134, 6)"
23183,2020-01-21,Russia,0,0,0,"rgb(229, 134, 6)"
23184,2020-01-22,Russia,0,0,0,"rgb(229, 134, 6)"
23185,2020-01-23,Russia,0,0,0,"rgb(229, 134, 6)"
23186,2020-01-24,Russia,0,0,0,"rgb(229, 134, 6)"
23187,2020-01-25,Russia,0,0,0,"rgb(229, 134, 6)"
23188,2020-01-26,Russia,0,0,0,"rgb(229, 134, 6)"
23189,2020-01-27,Russia,0,0,0,"rgb(229, 134, 6)"
23190,2020-01-28,Russia,0,0,0,"rgb(229, 134, 6)"
23191,2020-01-29,Russia,0,0,0,"rgb(229, 134, 6)"
23192,2020-01-30,Russia,0,0,0,"rgb(229, 134, 6)"
23193,2020-01-31,Russia,0,0,0,"rgb(229, 134, 6)"
23194,2020-02-01,Russia,0,2,2,"rgb(229, 134, 6)"
23195,2020-02-02,Russia,0,0,2,"rgb(229, 134, 6)"
23196,2020-02-03,Russia,0,0,2,"rgb(229, 134, 6)"
23197,2020-02-04,Russia,0,0,2,"rgb(229, 134, 6)"
23198,2020-02-05,Russia,0,0,2,"rgb(229, 134, 6)"
23199,2020-02-06,Russia,0,0,2,"rgb(229, 134, 6)"
23200,2020-02-07,Russia,0,0,2,"rgb(229, 134, 6)"
23201,2020-02-08,Russia,0,0,2,"rgb(229, 134, 6)"
23202,2020-02-09,Russia,0,0,2,"rgb(229, 134, 6)"
23203,2020-02-10,Russia,0,0,2,"rgb(229, 134, 6)"
23204,2020-02-11,Russia,0,0,2,"rgb(229, 134, 6)"
23205,2020-02-12,Russia,0,0,2,"rgb(229, 134, 6)"
23206,2020-02-13,Russia,0,0,2,"rgb(229, 134, 6)"
23207,2020-02-14,Russia,0,0,2,"rgb(229, 134, 6)"
23208,2020-02-15,Russia,0,0,2,"rgb(229, 134, 6)"
23209,2020-02-16,Russia,0,0,2,"rgb(229, 134, 6)"
23210,2020-02-17,Russia,0,0,2,"rgb(229, 134, 6)"
23211,2020-02-18,Russia,0,0,2,"rgb(229, 134, 6)"
23212,2020-02-19,Russia,0,0,2,"rgb(229, 134, 6)"
23213,2020-02-20,Russia,0,0,2,"rgb(229, 134, 6)"
23214,2020-02-21,Russia,0,0,2,"rgb(229, 134, 6)"
23215,2020-02-22,Russia,0,0,2,"rgb(229, 134, 6)"
23216,2020-02-23,Russia,0,0,2,"rgb(229, 134, 6)"
23217,2020-02-24,Russia,0,0,2,"rgb(229, 134, 6)"
23218,2020-02-25,Russia,0,0,2,"rgb(229, 134, 6)"
23219,2020-02-26,Russia,0,0,2,"rgb(229, 134, 6)"
23220,2020-02-27,Russia,0,0,2,"rgb(229, 134, 6)"
23221,2020-02-28,Russia,0,0,2,"rgb(229, 134, 6)"
23222,2020-02-29,Russia,0,0,2,"rgb(229, 134, 6)"
23223,2020-03-01,Russia,0,0,2,"rgb(229, 134, 6)"
23224,2020-03-02,Russia,0,0,2,"rgb(229, 134, 6)"
23225,2020-03-03,Russia,0,1,3,"rgb(229, 134, 6)"
23226,2020-03-04,Russia,0,1,4,"rgb(229, 134, 6)"
23227,2020-03-05,Russia,0,0,4,"rgb(229, 134, 6)"
23228,2020-03-06,Russia,0,0,4,"rgb(229, 134, 6)"
23229,2020-03-07,Russia,0,6,10,"rgb(229, 134, 6)"
23230,2020-03-08,Russia,0,0,10,"rgb(229, 134, 6)"
23231,2020-03-09,Russia,0,0,10,"rgb(229, 134, 6)"
23232,2020-03-10,Russia,0,0,10,"rgb(229, 134, 6)"
23233,2020-03-11,Russia,0,0,10,"rgb(229, 134, 6)"
23234,2020-03-12,Russia,0,15,25,"rgb(229, 134, 6)"
23235,2020-03-13,Russia,0,5,30,"rgb(229, 134, 6)"
23236,2020-03-14,Russia,0,15,45,"rgb(229, 134, 6)"
23237,2020-03-15,Russia,0,14,59,"rgb(229, 134, 6)"
23238,2020-03-16,Russia,0,4,63,"rgb(229, 134, 6)"
23239,2020-03-17,Russia,0,30,93,"rgb(229, 134, 6)"
23240,2020-03-18,Russia,0,21,114,"rgb(229, 134, 6)"
23241,2020-03-19,Russia,0,33,147,"rgb(229, 134, 6)"
23242,2020-03-20,Russia,0,52,199,"rgb(229, 134, 6)"
23243,2020-03-21,Russia,0,54,253,"rgb(229, 134, 6)"
23244,2020-03-22,Russia,0,53,306,"rgb(229, 134, 6)"
23245,2020-03-23,Russia,0,132,438,"rgb(229, 134, 6)"
23246,2020-03-24,Russia,0,0,438,"rgb(229, 134, 6)"
23247,2020-03-25,Russia,0,57,495,"rgb(229, 134, 6)"
23248,2020-03-26,Russia,0,163,658,"rgb(229, 134, 6)"
23249,2020-03-27,Russia,2,182,840,"rgb(229, 134, 6)"
23250,2020-03-28,Russia,2,196,1036,"rgb(229, 134, 6)"
23251,2020-03-29,Russia,1,228,1264,"rgb(229, 134, 6)"
23252,2020-03-30,Russia,3,270,1534,"rgb(229, 134, 6)"
23253,2020-03-31,Russia,2,302,1836,"rgb(229, 134, 6)"
23254,2020-04-01,Russia,7,501,2337,"rgb(229, 134, 6)"
23255,2020-04-02,Russia,7,440,2777,"rgb(229, 134, 6)"
23256,2020-04-03,Russia,6,771,3548,"rgb(229, 134, 6)"
23257,2020-04-04,Russia,4,601,4149,"rgb(229, 134, 6)"
23258,2020-04-05,Russia,9,582,4731,"rgb(229, 134, 6)"
23259,2020-04-06,Russia,2,658,5389,"rgb(229, 134, 6)"
23260,2020-04-07,Russia,2,954,6343,"rgb(229, 134, 6)"
23261,2020-04-08,Russia,11,1154,7497,"rgb(229, 134, 6)"
23262,2020-04-09,Russia,5,1175,8672,"rgb(229, 134, 6)"
23263,2020-04-10,Russia,13,1459,10131,"rgb(229, 134, 6)"
23264,2020-04-11,Russia,18,1786,11917,"rgb(229, 134, 6)"
23265,2020-04-12,Russia,12,1667,13584,"rgb(229, 134, 6)"
23266,2020-04-13,Russia,24,2186,15770,"rgb(229, 134, 6)"
23267,2020-04-14,Russia,18,2558,18328,"rgb(229, 134, 6)"
23268,2020-04-15,Russia,22,2774,21102,"rgb(229, 134, 6)"
23269,2020-04-16,Russia,28,3388,24490,"rgb(229, 134, 6)"
23270,2020-04-17,Russia,34,3448,27938,"rgb(229, 134, 6)"
23271,2020-04-18,Russia,41,4070,32008,"rgb(229, 134, 6)"
23272,2020-04-19,Russia,40,4785,36793,"rgb(229, 134, 6)"
23273,2020-04-20,Russia,48,6060,42853,"rgb(229, 134, 6)"
23274,2020-04-21,Russia,44,4268,47121,"rgb(229, 134, 6)"
23275,2020-04-22,Russia,51,5642,52763,"rgb(229, 134, 6)"
23276,2020-04-23,Russia,57,5236,57999,"rgb(229, 134, 6)"
23277,2020-04-24,Russia,42,4774,62773,"rgb(229, 134, 6)"
23278,2020-04-25,Russia,60,5849,68622,"rgb(229, 134, 6)"
23279,2020-04-26,Russia,66,5966,74588,"rgb(229, 134, 6)"
23280,2020-04-27,Russia,66,6361,80949,"rgb(229, 134, 6)"
23281,2020-04-28,Russia,48,6198,87147,"rgb(229, 134, 6)"
23282,2020-04-29,Russia,72,6411,93558,"rgb(229, 134, 6)"
23283,2020-04-30,Russia,105,5841,99399,"rgb(229, 134, 6)"
23284,2020-05-01,Russia,101,7099,106498,"rgb(229, 134, 6)"
23285,2020-05-02,Russia,96,7933,114431,"rgb(229, 134, 6)"
23286,2020-05-03,Russia,53,9623,124054,"rgb(229, 134, 6)"
23287,2020-05-04,Russia,58,10633,134687,"rgb(229, 134, 6)"
23288,2020-05-05,Russia,76,10581,145268,"rgb(229, 134, 6)"
23289,2020-05-06,Russia,95,10102,155370,"rgb(229, 134, 6)"
23290,2020-05-07,Russia,86,10559,165929,"rgb(229, 134, 6)"
23291,2020-05-08,Russia,88,11231,177160,"rgb(229, 134, 6)"
23292,2020-05-09,Russia,98,10699,187859,"rgb(229, 134, 6)"
23293,2020-05-10,Russia,104,10817,198676,"rgb(229, 134, 6)"
23294,2020-05-11,Russia,88,11012,209688,"rgb(229, 134, 6)"
23295,2020-05-12,Russia,94,11656,221344,"rgb(229, 134, 6)"
23296,2020-05-13,Russia,107,10899,232243,"rgb(229, 134, 6)"
23297,2020-05-14,Russia,96,10028,242271,"rgb(229, 134, 6)"
23298,2020-05-15,Russia,93,9974,252245,"rgb(229, 134, 6)"
23299,2020-05-16,Russia,113,10598,262843,"rgb(229, 134, 6)"
23300,2020-05-17,Russia,119,9200,272043,"rgb(229, 134, 6)"
23301,2020-05-18,Russia,94,9709,281752,"rgb(229, 134, 6)"
23302,2020-05-19,Russia,91,8926,290678,"rgb(229, 134, 6)"
23303,2020-05-20,Russia,115,9263,299941,"rgb(229, 134, 6)"
23304,2020-05-21,Russia,135,8764,308705,"rgb(229, 134, 6)"
23305,2020-05-22,Russia,127,8849,317554,"rgb(229, 134, 6)"
23306,2020-05-23,Russia,150,8894,326448,"rgb(229, 134, 6)"
23307,2020-05-24,Russia,139,9434,335882,"rgb(229, 134, 6)"
23308,2020-05-25,Russia,153,8599,344481,"rgb(229, 134, 6)"
23309,2020-05-26,Russia,92,8946,353427,"rgb(229, 134, 6)"
23310,2020-05-27,Russia,174,8915,362342,"rgb(229, 134, 6)"
23311,2020-05-28,Russia,161,8338,370680,"rgb(229, 134, 6)"
23312,2020-05-29,Russia,174,8371,379051,"rgb(229, 134, 6)"
23313,2020-05-30,Russia,232,8572,387623,"rgb(229, 134, 6)"
23314,2020-05-31,Russia,181,8952,396575,"rgb(229, 134, 6)"
23315,2020-06-01,Russia,138,9268,405843,"rgb(229, 134, 6)"
23316,2020-06-02,Russia,162,9035,414878,"rgb(229, 134, 6)"
23317,2020-06-03,Russia,182,8863,423741,"rgb(229, 134, 6)"
23318,2020-06-04,Russia,178,8536,432277,"rgb(229, 134, 6)"
23319,2020-06-05,Russia,169,8831,441108,"rgb(229, 134, 6)"
23320,2020-06-06,Russia,144,8726,449834,"rgb(229, 134, 6)"
23321,2020-06-07,Russia,197,8855,458689,"rgb(229, 134, 6)"
23322,2020-06-08,Russia,134,8984,467673,"rgb(229, 134, 6)"
23323,2020-06-09,Russia,112,8985,476658,"rgb(229, 134, 6)"
23324,2020-06-10,Russia,170,8595,485253,"rgb(229, 134, 6)"
23325,2020-06-11,Russia,217,8404,493657,"rgb(229, 134, 6)"
23326,2020-06-12,Russia,174,8779,502436,"rgb(229, 134, 6)"
23327,2020-06-13,Russia,183,8987,511423,"rgb(229, 134, 6)"
23328,2020-06-14,Russia,114,8706,520129,"rgb(229, 134, 6)"
23329,2020-06-15,Russia,119,8835,528964,"rgb(229, 134, 6)"
23330,2020-06-16,Russia,143,8246,537210,"rgb(229, 134, 6)"
23331,2020-06-17,Russia,193,8248,545458,"rgb(229, 134, 6)"
23332,2020-06-18,Russia,194,7843,553301,"rgb(229, 134, 6)"
23333,2020-06-19,Russia,312,7790,561091,"rgb(229, 134, 6)"
23334,2020-06-20,Russia,182,7972,569063,"rgb(229, 134, 6)"
23335,2020-06-21,Russia,30,7889,576952,"rgb(229, 134, 6)"
23336,2020-06-22,Russia,109,7728,584680,"rgb(229, 134, 6)"
23337,2020-06-23,Russia,95,7600,592280,"rgb(229, 134, 6)"
23338,2020-06-24,Russia,153,7425,599705,"rgb(229, 134, 6)"
23339,2020-06-25,Russia,154,7176,606881,"rgb(229, 134, 6)"
23340,2020-06-26,Russia,92,7113,613994,"rgb(229, 134, 6)"
23341,2020-06-27,Russia,176,6800,620794,"rgb(229, 134, 6)"
23342,2020-06-28,Russia,188,6852,627646,"rgb(229, 134, 6)"
23343,2020-06-29,Russia,104,6791,634437,"rgb(229, 134, 6)"
23344,2020-06-30,Russia,93,6719,641156,"rgb(229, 134, 6)"
23345,2020-07-01,Russia,154,6693,647849,"rgb(229, 134, 6)"
23346,2020-07-02,Russia,216,6556,654405,"rgb(229, 134, 6)"
23347,2020-07-03,Russia,147,6760,661165,"rgb(229, 134, 6)"
23348,2020-07-04,Russia,176,6718,667883,"rgb(229, 134, 6)"
23349,2020-07-05,Russia,168,6632,674515,"rgb(229, 134, 6)"
23350,2020-07-06,Russia,134,6736,681251,"rgb(229, 134, 6)"
23351,2020-07-07,Russia,135,6611,687862,"rgb(229, 134, 6)"
23352,2020-07-08,Russia,198,6368,694230,"rgb(229, 134, 6)"
23353,2020-07-09,Russia,173,6562,700792,"rgb(229, 134, 6)"
23354,2020-07-10,Russia,176,6509,707301,"rgb(229, 134, 6)"
23355,2020-07-11,Russia,174,6635,713936,"rgb(229, 134, 6)"
23356,2020-07-12,Russia,188,6611,720547,"rgb(229, 134, 6)"
23357,2020-07-13,Russia,130,6615,727162,"rgb(229, 134, 6)"
23358,2020-03-15,Rwanda,0,1,1,"rgb(93, 105, 177)"
23359,2020-03-16,Rwanda,0,4,5,"rgb(93, 105, 177)"
23360,2020-03-17,Rwanda,0,0,5,"rgb(93, 105, 177)"
23361,2020-03-18,Rwanda,0,2,7,"rgb(93, 105, 177)"
23362,2020-03-19,Rwanda,0,4,11,"rgb(93, 105, 177)"
23363,2020-03-20,Rwanda,0,0,11,"rgb(93, 105, 177)"
23364,2020-03-21,Rwanda,0,6,17,"rgb(93, 105, 177)"
23365,2020-03-22,Rwanda,0,0,17,"rgb(93, 105, 177)"
23366,2020-03-23,Rwanda,0,2,19,"rgb(93, 105, 177)"
23367,2020-03-24,Rwanda,0,17,36,"rgb(93, 105, 177)"
23368,2020-03-25,Rwanda,0,4,40,"rgb(93, 105, 177)"
23369,2020-03-26,Rwanda,0,1,41,"rgb(93, 105, 177)"
23370,2020-03-27,Rwanda,0,9,50,"rgb(93, 105, 177)"
23371,2020-03-28,Rwanda,0,4,54,"rgb(93, 105, 177)"
23372,2020-03-29,Rwanda,0,6,60,"rgb(93, 105, 177)"
23373,2020-03-30,Rwanda,0,10,70,"rgb(93, 105, 177)"
23374,2020-03-31,Rwanda,0,0,70,"rgb(93, 105, 177)"
23375,2020-04-01,Rwanda,0,5,75,"rgb(93, 105, 177)"
23376,2020-04-02,Rwanda,0,7,82,"rgb(93, 105, 177)"
23377,2020-04-03,Rwanda,0,0,82,"rgb(93, 105, 177)"
23378,2020-04-04,Rwanda,0,7,89,"rgb(93, 105, 177)"
23379,2020-04-05,Rwanda,0,13,102,"rgb(93, 105, 177)"
23380,2020-04-06,Rwanda,0,2,104,"rgb(93, 105, 177)"
23381,2020-04-07,Rwanda,0,1,105,"rgb(93, 105, 177)"
23382,2020-04-08,Rwanda,0,0,105,"rgb(93, 105, 177)"
23383,2020-04-09,Rwanda,0,5,110,"rgb(93, 105, 177)"
23384,2020-04-10,Rwanda,0,3,113,"rgb(93, 105, 177)"
23385,2020-04-11,Rwanda,0,5,118,"rgb(93, 105, 177)"
23386,2020-04-12,Rwanda,0,2,120,"rgb(93, 105, 177)"
23387,2020-04-13,Rwanda,0,6,126,"rgb(93, 105, 177)"
23388,2020-04-14,Rwanda,0,1,127,"rgb(93, 105, 177)"
23389,2020-04-15,Rwanda,0,7,134,"rgb(93, 105, 177)"
23390,2020-04-16,Rwanda,0,2,136,"rgb(93, 105, 177)"
23391,2020-04-17,Rwanda,0,2,138,"rgb(93, 105, 177)"
23392,2020-04-18,Rwanda,0,5,143,"rgb(93, 105, 177)"
23393,2020-04-19,Rwanda,0,1,144,"rgb(93, 105, 177)"
23394,2020-04-20,Rwanda,0,3,147,"rgb(93, 105, 177)"
23395,2020-04-21,Rwanda,0,0,147,"rgb(93, 105, 177)"
23396,2020-04-22,Rwanda,0,3,150,"rgb(93, 105, 177)"
23397,2020-04-23,Rwanda,0,3,153,"rgb(93, 105, 177)"
23398,2020-04-24,Rwanda,0,1,154,"rgb(93, 105, 177)"
23399,2020-04-25,Rwanda,0,22,176,"rgb(93, 105, 177)"
23400,2020-04-26,Rwanda,0,7,183,"rgb(93, 105, 177)"
23401,2020-04-27,Rwanda,0,8,191,"rgb(93, 105, 177)"
23402,2020-04-28,Rwanda,0,16,207,"rgb(93, 105, 177)"
23403,2020-04-29,Rwanda,0,5,212,"rgb(93, 105, 177)"
23404,2020-04-30,Rwanda,0,13,225,"rgb(93, 105, 177)"
23405,2020-05-01,Rwanda,0,18,243,"rgb(93, 105, 177)"
23406,2020-05-02,Rwanda,0,6,249,"rgb(93, 105, 177)"
23407,2020-05-03,Rwanda,0,6,255,"rgb(93, 105, 177)"
23408,2020-05-04,Rwanda,0,4,259,"rgb(93, 105, 177)"
23409,2020-05-05,Rwanda,0,2,261,"rgb(93, 105, 177)"
23410,2020-05-06,Rwanda,0,0,261,"rgb(93, 105, 177)"
23411,2020-05-07,Rwanda,0,7,268,"rgb(93, 105, 177)"
23412,2020-05-08,Rwanda,0,3,271,"rgb(93, 105, 177)"
23413,2020-05-09,Rwanda,0,2,273,"rgb(93, 105, 177)"
23414,2020-05-10,Rwanda,0,7,280,"rgb(93, 105, 177)"
23415,2020-05-11,Rwanda,0,4,284,"rgb(93, 105, 177)"
23416,2020-05-12,Rwanda,0,1,285,"rgb(93, 105, 177)"
23417,2020-05-13,Rwanda,0,1,286,"rgb(93, 105, 177)"
23418,2020-05-14,Rwanda,0,1,287,"rgb(93, 105, 177)"
23419,2020-05-15,Rwanda,0,0,287,"rgb(93, 105, 177)"
23420,2020-05-16,Rwanda,0,0,287,"rgb(93, 105, 177)"
23421,2020-05-17,Rwanda,0,2,289,"rgb(93, 105, 177)"
23422,2020-05-18,Rwanda,0,3,292,"rgb(93, 105, 177)"
23423,2020-05-19,Rwanda,0,5,297,"rgb(93, 105, 177)"
23424,2020-05-20,Rwanda,0,11,308,"rgb(93, 105, 177)"
23425,2020-05-21,Rwanda,0,6,314,"rgb(93, 105, 177)"
23426,2020-05-22,Rwanda,0,6,320,"rgb(93, 105, 177)"
23427,2020-05-23,Rwanda,0,1,321,"rgb(93, 105, 177)"
23428,2020-05-24,Rwanda,0,4,325,"rgb(93, 105, 177)"
23429,2020-05-25,Rwanda,0,2,327,"rgb(93, 105, 177)"
23430,2020-05-26,Rwanda,0,9,336,"rgb(93, 105, 177)"
23431,2020-05-27,Rwanda,0,3,339,"rgb(93, 105, 177)"
23432,2020-05-28,Rwanda,0,7,346,"rgb(93, 105, 177)"
23433,2020-05-29,Rwanda,0,3,349,"rgb(93, 105, 177)"
23434,2020-05-30,Rwanda,0,6,355,"rgb(93, 105, 177)"
23435,2020-05-31,Rwanda,1,4,359,"rgb(93, 105, 177)"
23436,2020-06-01,Rwanda,0,11,370,"rgb(93, 105, 177)"
23437,2020-06-02,Rwanda,0,7,377,"rgb(93, 105, 177)"
23438,2020-06-03,Rwanda,1,7,384,"rgb(93, 105, 177)"
23439,2020-06-04,Rwanda,0,13,397,"rgb(93, 105, 177)"
23440,2020-06-05,Rwanda,0,13,410,"rgb(93, 105, 177)"
23441,2020-06-06,Rwanda,0,10,420,"rgb(93, 105, 177)"
23442,2020-06-07,Rwanda,0,11,431,"rgb(93, 105, 177)"
23443,2020-06-08,Rwanda,0,8,439,"rgb(93, 105, 177)"
23444,2020-06-09,Rwanda,0,12,451,"rgb(93, 105, 177)"
23445,2020-06-10,Rwanda,0,12,463,"rgb(93, 105, 177)"
23446,2020-06-11,Rwanda,0,13,476,"rgb(93, 105, 177)"
23447,2020-06-12,Rwanda,0,18,494,"rgb(93, 105, 177)"
23448,2020-06-13,Rwanda,0,16,510,"rgb(93, 105, 177)"
23449,2020-06-14,Rwanda,0,31,541,"rgb(93, 105, 177)"
23450,2020-06-15,Rwanda,0,41,582,"rgb(93, 105, 177)"
23451,2020-06-16,Rwanda,0,30,612,"rgb(93, 105, 177)"
23452,2020-06-17,Rwanda,0,24,636,"rgb(93, 105, 177)"
23453,2020-06-18,Rwanda,0,3,639,"rgb(93, 105, 177)"
23454,2020-06-19,Rwanda,0,7,646,"rgb(93, 105, 177)"
23455,2020-06-20,Rwanda,0,15,661,"rgb(93, 105, 177)"
23456,2020-06-21,Rwanda,0,41,702,"rgb(93, 105, 177)"
23457,2020-06-22,Rwanda,0,26,728,"rgb(93, 105, 177)"
23458,2020-06-23,Rwanda,0,59,787,"rgb(93, 105, 177)"
23459,2020-06-24,Rwanda,0,11,798,"rgb(93, 105, 177)"
23460,2020-06-25,Rwanda,0,32,830,"rgb(93, 105, 177)"
23461,2020-06-26,Rwanda,0,20,850,"rgb(93, 105, 177)"
23462,2020-06-27,Rwanda,0,8,858,"rgb(93, 105, 177)"
23463,2020-06-28,Rwanda,0,20,878,"rgb(93, 105, 177)"
23464,2020-06-29,Rwanda,0,22,900,"rgb(93, 105, 177)"
23465,2020-06-30,Rwanda,0,101,1001,"rgb(93, 105, 177)"
23466,2020-07-01,Rwanda,0,24,1025,"rgb(93, 105, 177)"
23467,2020-07-02,Rwanda,1,17,1042,"rgb(93, 105, 177)"
23468,2020-07-03,Rwanda,0,21,1063,"rgb(93, 105, 177)"
23469,2020-07-04,Rwanda,0,18,1081,"rgb(93, 105, 177)"
23470,2020-07-05,Rwanda,0,11,1092,"rgb(93, 105, 177)"
23471,2020-07-06,Rwanda,0,13,1105,"rgb(93, 105, 177)"
23472,2020-07-07,Rwanda,0,8,1113,"rgb(93, 105, 177)"
23473,2020-07-08,Rwanda,0,59,1172,"rgb(93, 105, 177)"
23474,2020-07-09,Rwanda,0,22,1194,"rgb(93, 105, 177)"
23475,2020-07-10,Rwanda,0,16,1210,"rgb(93, 105, 177)"
23476,2020-07-11,Rwanda,0,42,1252,"rgb(93, 105, 177)"
23477,2020-07-12,Rwanda,1,47,1299,"rgb(93, 105, 177)"
23478,2020-07-13,Rwanda,0,38,1337,"rgb(93, 105, 177)"
23479,2020-03-03,Saudi Arabia,0,1,1,"rgb(82, 188, 163)"
23480,2020-03-06,Saudi Arabia,0,4,5,"rgb(82, 188, 163)"
23481,2020-03-08,Saudi Arabia,0,2,7,"rgb(82, 188, 163)"
23482,2020-03-09,Saudi Arabia,0,4,11,"rgb(82, 188, 163)"
23483,2020-03-10,Saudi Arabia,0,4,15,"rgb(82, 188, 163)"
23484,2020-03-11,Saudi Arabia,0,5,20,"rgb(82, 188, 163)"
23485,2020-03-12,Saudi Arabia,0,25,45,"rgb(82, 188, 163)"
23486,2020-03-13,Saudi Arabia,0,17,62,"rgb(82, 188, 163)"
23487,2020-03-14,Saudi Arabia,0,24,86,"rgb(82, 188, 163)"
23488,2020-03-15,Saudi Arabia,0,0,86,"rgb(82, 188, 163)"
23489,2020-03-16,Saudi Arabia,0,32,118,"rgb(82, 188, 163)"
23490,2020-03-17,Saudi Arabia,0,15,133,"rgb(82, 188, 163)"
23491,2020-03-18,Saudi Arabia,0,0,133,"rgb(82, 188, 163)"
23492,2020-03-19,Saudi Arabia,0,38,171,"rgb(82, 188, 163)"
23493,2020-03-20,Saudi Arabia,0,67,238,"rgb(82, 188, 163)"
23494,2020-03-21,Saudi Arabia,0,36,274,"rgb(82, 188, 163)"
23495,2020-03-22,Saudi Arabia,0,118,392,"rgb(82, 188, 163)"
23496,2020-03-23,Saudi Arabia,0,119,511,"rgb(82, 188, 163)"
23497,2020-03-24,Saudi Arabia,0,51,562,"rgb(82, 188, 163)"
23498,2020-03-25,Saudi Arabia,1,205,767,"rgb(82, 188, 163)"
23499,2020-03-26,Saudi Arabia,1,133,900,"rgb(82, 188, 163)"
23500,2020-03-27,Saudi Arabia,1,112,1012,"rgb(82, 188, 163)"
23501,2020-03-28,Saudi Arabia,0,92,1104,"rgb(82, 188, 163)"
23502,2020-03-29,Saudi Arabia,1,99,1203,"rgb(82, 188, 163)"
23503,2020-03-30,Saudi Arabia,4,26,1229,"rgb(82, 188, 163)"
23504,2020-03-31,Saudi Arabia,0,224,1453,"rgb(82, 188, 163)"
23505,2020-04-01,Saudi Arabia,2,110,1563,"rgb(82, 188, 163)"
23506,2020-04-02,Saudi Arabia,6,157,1720,"rgb(82, 188, 163)"
23507,2020-04-03,Saudi Arabia,5,165,1885,"rgb(82, 188, 163)"
23508,2020-04-04,Saudi Arabia,0,0,1885,"rgb(82, 188, 163)"
23509,2020-04-05,Saudi Arabia,8,294,2179,"rgb(82, 188, 163)"
23510,2020-04-06,Saudi Arabia,5,206,2385,"rgb(82, 188, 163)"
23511,2020-04-07,Saudi Arabia,4,138,2523,"rgb(82, 188, 163)"
23512,2020-04-08,Saudi Arabia,3,272,2795,"rgb(82, 188, 163)"
23513,2020-04-09,Saudi Arabia,0,137,2932,"rgb(82, 188, 163)"
23514,2020-04-10,Saudi Arabia,3,355,3287,"rgb(82, 188, 163)"
23515,2020-04-11,Saudi Arabia,3,364,3651,"rgb(82, 188, 163)"
23516,2020-04-12,Saudi Arabia,5,382,4033,"rgb(82, 188, 163)"
23517,2020-04-13,Saudi Arabia,7,429,4462,"rgb(82, 188, 163)"
23518,2020-04-14,Saudi Arabia,6,472,4934,"rgb(82, 188, 163)"
23519,2020-04-15,Saudi Arabia,8,435,5369,"rgb(82, 188, 163)"
23520,2020-04-16,Saudi Arabia,6,493,5862,"rgb(82, 188, 163)"
23521,2020-04-17,Saudi Arabia,4,518,6380,"rgb(82, 188, 163)"
23522,2020-04-18,Saudi Arabia,4,762,7142,"rgb(82, 188, 163)"
23523,2020-04-19,Saudi Arabia,5,1132,8274,"rgb(82, 188, 163)"
23524,2020-04-20,Saudi Arabia,5,1088,9362,"rgb(82, 188, 163)"
23525,2020-04-21,Saudi Arabia,6,1122,10484,"rgb(82, 188, 163)"
23526,2020-04-22,Saudi Arabia,6,1147,11631,"rgb(82, 188, 163)"
23527,2020-04-23,Saudi Arabia,5,1141,12772,"rgb(82, 188, 163)"
23528,2020-04-24,Saudi Arabia,7,1158,13930,"rgb(82, 188, 163)"
23529,2020-04-25,Saudi Arabia,6,1172,15102,"rgb(82, 188, 163)"
23530,2020-04-26,Saudi Arabia,9,1197,16299,"rgb(82, 188, 163)"
23531,2020-04-27,Saudi Arabia,3,1223,17522,"rgb(82, 188, 163)"
23532,2020-04-28,Saudi Arabia,5,1289,18811,"rgb(82, 188, 163)"
23533,2020-04-29,Saudi Arabia,8,1266,20077,"rgb(82, 188, 163)"
23534,2020-04-30,Saudi Arabia,5,1325,21402,"rgb(82, 188, 163)"
23535,2020-05-01,Saudi Arabia,5,1351,22753,"rgb(82, 188, 163)"
23536,2020-05-02,Saudi Arabia,7,1344,24097,"rgb(82, 188, 163)"
23537,2020-05-03,Saudi Arabia,7,1362,25459,"rgb(82, 188, 163)"
23538,2020-05-04,Saudi Arabia,8,1552,27011,"rgb(82, 188, 163)"
23539,2020-05-05,Saudi Arabia,7,1645,28656,"rgb(82, 188, 163)"
23540,2020-05-06,Saudi Arabia,9,1595,30251,"rgb(82, 188, 163)"
23541,2020-05-07,Saudi Arabia,9,1687,31938,"rgb(82, 188, 163)"
23542,2020-05-08,Saudi Arabia,10,1793,33731,"rgb(82, 188, 163)"
23543,2020-05-09,Saudi Arabia,10,1701,35432,"rgb(82, 188, 163)"
23544,2020-05-10,Saudi Arabia,10,1704,37136,"rgb(82, 188, 163)"
23545,2020-05-11,Saudi Arabia,7,1912,39048,"rgb(82, 188, 163)"
23546,2020-05-12,Saudi Arabia,9,1966,41014,"rgb(82, 188, 163)"
23547,2020-05-13,Saudi Arabia,9,1911,42925,"rgb(82, 188, 163)"
23548,2020-05-14,Saudi Arabia,9,1905,44830,"rgb(82, 188, 163)"
23549,2020-05-15,Saudi Arabia,10,2039,46869,"rgb(82, 188, 163)"
23550,2020-05-16,Saudi Arabia,9,2307,49176,"rgb(82, 188, 163)"
23551,2020-05-17,Saudi Arabia,10,2840,52016,"rgb(82, 188, 163)"
23552,2020-05-18,Saudi Arabia,10,2736,54752,"rgb(82, 188, 163)"
23553,2020-05-19,Saudi Arabia,8,2593,57345,"rgb(82, 188, 163)"
23554,2020-05-20,Saudi Arabia,9,2509,59854,"rgb(82, 188, 163)"
23555,2020-05-21,Saudi Arabia,10,2691,62545,"rgb(82, 188, 163)"
23556,2020-05-22,Saudi Arabia,12,2532,65077,"rgb(82, 188, 163)"
23557,2020-05-23,Saudi Arabia,13,2642,67719,"rgb(82, 188, 163)"
23558,2020-05-24,Saudi Arabia,15,2442,70161,"rgb(82, 188, 163)"
23559,2020-05-25,Saudi Arabia,11,2399,72560,"rgb(82, 188, 163)"
23560,2020-05-26,Saudi Arabia,9,2235,74795,"rgb(82, 188, 163)"
23561,2020-05-27,Saudi Arabia,12,1931,76726,"rgb(82, 188, 163)"
23562,2020-05-28,Saudi Arabia,14,1815,78541,"rgb(82, 188, 163)"
23563,2020-05-29,Saudi Arabia,16,1644,80185,"rgb(82, 188, 163)"
23564,2020-05-30,Saudi Arabia,17,1581,81766,"rgb(82, 188, 163)"
23565,2020-05-31,Saudi Arabia,22,1618,83384,"rgb(82, 188, 163)"
23566,2020-06-01,Saudi Arabia,23,1877,85261,"rgb(82, 188, 163)"
23567,2020-06-02,Saudi Arabia,22,1881,87142,"rgb(82, 188, 163)"
23568,2020-06-03,Saudi Arabia,24,1869,89011,"rgb(82, 188, 163)"
23569,2020-06-04,Saudi Arabia,30,2171,91182,"rgb(82, 188, 163)"
23570,2020-06-05,Saudi Arabia,32,1975,93157,"rgb(82, 188, 163)"
23571,2020-06-06,Saudi Arabia,31,2591,95748,"rgb(82, 188, 163)"
23572,2020-06-07,Saudi Arabia,34,3121,98869,"rgb(82, 188, 163)"
23573,2020-06-08,Saudi Arabia,36,3045,101914,"rgb(82, 188, 163)"
23574,2020-06-09,Saudi Arabia,34,3369,105283,"rgb(82, 188, 163)"
23575,2020-06-10,Saudi Arabia,37,3288,108571,"rgb(82, 188, 163)"
23576,2020-06-11,Saudi Arabia,36,3717,112288,"rgb(82, 188, 163)"
23577,2020-06-12,Saudi Arabia,38,3733,116021,"rgb(82, 188, 163)"
23578,2020-06-13,Saudi Arabia,36,3921,119942,"rgb(82, 188, 163)"
23579,2020-06-14,Saudi Arabia,39,3366,123308,"rgb(82, 188, 163)"
23580,2020-06-15,Saudi Arabia,40,4233,127541,"rgb(82, 188, 163)"
23581,2020-06-16,Saudi Arabia,39,4507,132048,"rgb(82, 188, 163)"
23582,2020-06-17,Saudi Arabia,41,4267,136315,"rgb(82, 188, 163)"
23583,2020-06-18,Saudi Arabia,39,4919,141234,"rgb(82, 188, 163)"
23584,2020-06-19,Saudi Arabia,48,4757,145991,"rgb(82, 188, 163)"
23585,2020-06-20,Saudi Arabia,45,4301,150292,"rgb(82, 188, 163)"
23586,2020-06-21,Saudi Arabia,46,3941,154233,"rgb(82, 188, 163)"
23587,2020-06-22,Saudi Arabia,37,3379,157612,"rgb(82, 188, 163)"
23588,2020-06-23,Saudi Arabia,40,3393,161005,"rgb(82, 188, 163)"
23589,2020-06-24,Saudi Arabia,39,3139,164144,"rgb(82, 188, 163)"
23590,2020-06-25,Saudi Arabia,41,3123,167267,"rgb(82, 188, 163)"
23591,2020-06-26,Saudi Arabia,41,3372,170639,"rgb(82, 188, 163)"
23592,2020-06-27,Saudi Arabia,46,3938,174577,"rgb(82, 188, 163)"
23593,2020-06-28,Saudi Arabia,37,3927,178504,"rgb(82, 188, 163)"
23594,2020-06-29,Saudi Arabia,40,3989,182493,"rgb(82, 188, 163)"
23595,2020-06-30,Saudi Arabia,48,3943,186436,"rgb(82, 188, 163)"
23596,2020-07-01,Saudi Arabia,50,4387,190823,"rgb(82, 188, 163)"
23597,2020-07-02,Saudi Arabia,49,3402,194225,"rgb(82, 188, 163)"
23598,2020-07-03,Saudi Arabia,54,3383,197608,"rgb(82, 188, 163)"
23599,2020-07-04,Saudi Arabia,50,4193,201801,"rgb(82, 188, 163)"
23600,2020-07-05,Saudi Arabia,56,4128,205929,"rgb(82, 188, 163)"
23601,2020-07-06,Saudi Arabia,58,3580,209509,"rgb(82, 188, 163)"
23602,2020-07-07,Saudi Arabia,52,4207,213716,"rgb(82, 188, 163)"
23603,2020-07-08,Saudi Arabia,49,3392,217108,"rgb(82, 188, 163)"
23604,2020-07-09,Saudi Arabia,42,3036,220144,"rgb(82, 188, 163)"
23605,2020-07-10,Saudi Arabia,41,3183,223327,"rgb(82, 188, 163)"
23606,2020-07-11,Saudi Arabia,51,3159,226486,"rgb(82, 188, 163)"
23607,2020-07-12,Saudi Arabia,30,2994,229480,"rgb(82, 188, 163)"
23608,2020-07-13,Saudi Arabia,42,2779,232259,"rgb(82, 188, 163)"
23609,2020-03-15,Seychelles,0,2,2,"rgb(153, 201, 69)"
23610,2020-03-16,Seychelles,0,1,3,"rgb(153, 201, 69)"
23611,2020-03-17,Seychelles,0,1,4,"rgb(153, 201, 69)"
23612,2020-03-18,Seychelles,0,0,4,"rgb(153, 201, 69)"
23613,2020-03-19,Seychelles,0,2,6,"rgb(153, 201, 69)"
23614,2020-03-20,Seychelles,0,0,6,"rgb(153, 201, 69)"
23615,2020-03-21,Seychelles,0,1,7,"rgb(153, 201, 69)"
23616,2020-03-22,Seychelles,0,0,7,"rgb(153, 201, 69)"
23617,2020-03-23,Seychelles,0,0,7,"rgb(153, 201, 69)"
23618,2020-03-24,Seychelles,0,0,7,"rgb(153, 201, 69)"
23619,2020-03-25,Seychelles,0,0,7,"rgb(153, 201, 69)"
23620,2020-03-26,Seychelles,0,0,7,"rgb(153, 201, 69)"
23621,2020-03-27,Seychelles,0,0,7,"rgb(153, 201, 69)"
23622,2020-03-28,Seychelles,0,0,7,"rgb(153, 201, 69)"
23623,2020-03-29,Seychelles,0,0,7,"rgb(153, 201, 69)"
23624,2020-03-30,Seychelles,0,1,8,"rgb(153, 201, 69)"
23625,2020-03-31,Seychelles,0,2,10,"rgb(153, 201, 69)"
23626,2020-04-01,Seychelles,0,0,10,"rgb(153, 201, 69)"
23627,2020-04-02,Seychelles,0,0,10,"rgb(153, 201, 69)"
23628,2020-04-03,Seychelles,0,0,10,"rgb(153, 201, 69)"
23629,2020-04-04,Seychelles,0,0,10,"rgb(153, 201, 69)"
23630,2020-04-05,Seychelles,0,0,10,"rgb(153, 201, 69)"
23631,2020-04-06,Seychelles,0,0,10,"rgb(153, 201, 69)"
23632,2020-04-07,Seychelles,0,0,10,"rgb(153, 201, 69)"
23633,2020-04-08,Seychelles,0,0,10,"rgb(153, 201, 69)"
23634,2020-04-09,Seychelles,0,0,10,"rgb(153, 201, 69)"
23635,2020-04-10,Seychelles,0,0,10,"rgb(153, 201, 69)"
23636,2020-04-11,Seychelles,0,0,10,"rgb(153, 201, 69)"
23637,2020-04-12,Seychelles,0,0,10,"rgb(153, 201, 69)"
23638,2020-04-13,Seychelles,0,0,10,"rgb(153, 201, 69)"
23639,2020-04-14,Seychelles,0,0,10,"rgb(153, 201, 69)"
23640,2020-04-15,Seychelles,0,1,11,"rgb(153, 201, 69)"
23641,2020-04-16,Seychelles,0,0,11,"rgb(153, 201, 69)"
23642,2020-04-17,Seychelles,0,0,11,"rgb(153, 201, 69)"
23643,2020-04-18,Seychelles,0,0,11,"rgb(153, 201, 69)"
23644,2020-04-19,Seychelles,0,0,11,"rgb(153, 201, 69)"
23645,2020-04-20,Seychelles,0,0,11,"rgb(153, 201, 69)"
23646,2020-04-21,Seychelles,0,0,11,"rgb(153, 201, 69)"
23647,2020-04-22,Seychelles,0,0,11,"rgb(153, 201, 69)"
23648,2020-04-23,Seychelles,0,0,11,"rgb(153, 201, 69)"
23649,2020-04-24,Seychelles,0,0,11,"rgb(153, 201, 69)"
23650,2020-04-25,Seychelles,0,0,11,"rgb(153, 201, 69)"
23651,2020-04-26,Seychelles,0,0,11,"rgb(153, 201, 69)"
23652,2020-04-27,Seychelles,0,0,11,"rgb(153, 201, 69)"
23653,2020-04-28,Seychelles,0,0,11,"rgb(153, 201, 69)"
23654,2020-04-29,Seychelles,0,0,11,"rgb(153, 201, 69)"
23655,2020-04-30,Seychelles,0,0,11,"rgb(153, 201, 69)"
23656,2020-05-01,Seychelles,0,0,11,"rgb(153, 201, 69)"
23657,2020-05-02,Seychelles,0,0,11,"rgb(153, 201, 69)"
23658,2020-05-03,Seychelles,0,0,11,"rgb(153, 201, 69)"
23659,2020-05-04,Seychelles,0,0,11,"rgb(153, 201, 69)"
23660,2020-05-05,Seychelles,0,0,11,"rgb(153, 201, 69)"
23661,2020-05-06,Seychelles,0,0,11,"rgb(153, 201, 69)"
23662,2020-05-07,Seychelles,0,0,11,"rgb(153, 201, 69)"
23663,2020-05-08,Seychelles,0,0,11,"rgb(153, 201, 69)"
23664,2020-05-09,Seychelles,0,0,11,"rgb(153, 201, 69)"
23665,2020-05-10,Seychelles,0,0,11,"rgb(153, 201, 69)"
23666,2020-05-11,Seychelles,0,0,11,"rgb(153, 201, 69)"
23667,2020-05-12,Seychelles,0,0,11,"rgb(153, 201, 69)"
23668,2020-05-13,Seychelles,0,0,11,"rgb(153, 201, 69)"
23669,2020-05-14,Seychelles,0,0,11,"rgb(153, 201, 69)"
23670,2020-05-15,Seychelles,0,0,11,"rgb(153, 201, 69)"
23671,2020-05-16,Seychelles,0,0,11,"rgb(153, 201, 69)"
23672,2020-05-17,Seychelles,0,0,11,"rgb(153, 201, 69)"
23673,2020-05-18,Seychelles,0,0,11,"rgb(153, 201, 69)"
23674,2020-05-19,Seychelles,0,0,11,"rgb(153, 201, 69)"
23675,2020-05-20,Seychelles,0,0,11,"rgb(153, 201, 69)"
23676,2020-05-21,Seychelles,0,0,11,"rgb(153, 201, 69)"
23677,2020-05-22,Seychelles,0,0,11,"rgb(153, 201, 69)"
23678,2020-05-23,Seychelles,0,0,11,"rgb(153, 201, 69)"
23679,2020-05-24,Seychelles,0,0,11,"rgb(153, 201, 69)"
23680,2020-05-25,Seychelles,0,0,11,"rgb(153, 201, 69)"
23681,2020-05-26,Seychelles,0,0,11,"rgb(153, 201, 69)"
23682,2020-05-27,Seychelles,0,0,11,"rgb(153, 201, 69)"
23683,2020-05-28,Seychelles,0,0,11,"rgb(153, 201, 69)"
23684,2020-05-29,Seychelles,0,0,11,"rgb(153, 201, 69)"
23685,2020-05-30,Seychelles,0,0,11,"rgb(153, 201, 69)"
23686,2020-05-31,Seychelles,0,0,11,"rgb(153, 201, 69)"
23687,2020-06-01,Seychelles,0,0,11,"rgb(153, 201, 69)"
23688,2020-06-02,Seychelles,0,0,11,"rgb(153, 201, 69)"
23689,2020-06-03,Seychelles,0,0,11,"rgb(153, 201, 69)"
23690,2020-06-04,Seychelles,0,0,11,"rgb(153, 201, 69)"
23691,2020-06-05,Seychelles,0,0,11,"rgb(153, 201, 69)"
23692,2020-06-06,Seychelles,0,0,11,"rgb(153, 201, 69)"
23693,2020-06-07,Seychelles,0,0,11,"rgb(153, 201, 69)"
23694,2020-06-08,Seychelles,0,0,11,"rgb(153, 201, 69)"
23695,2020-06-09,Seychelles,0,0,11,"rgb(153, 201, 69)"
23696,2020-06-10,Seychelles,0,0,11,"rgb(153, 201, 69)"
23697,2020-06-11,Seychelles,0,0,11,"rgb(153, 201, 69)"
23698,2020-06-12,Seychelles,0,0,11,"rgb(153, 201, 69)"
23699,2020-06-13,Seychelles,0,0,11,"rgb(153, 201, 69)"
23700,2020-06-14,Seychelles,0,0,11,"rgb(153, 201, 69)"
23701,2020-06-15,Seychelles,0,0,11,"rgb(153, 201, 69)"
23702,2020-06-16,Seychelles,0,0,11,"rgb(153, 201, 69)"
23703,2020-06-17,Seychelles,0,0,11,"rgb(153, 201, 69)"
23704,2020-06-18,Seychelles,0,0,11,"rgb(153, 201, 69)"
23705,2020-06-19,Seychelles,0,0,11,"rgb(153, 201, 69)"
23706,2020-06-20,Seychelles,0,0,11,"rgb(153, 201, 69)"
23707,2020-06-21,Seychelles,0,0,11,"rgb(153, 201, 69)"
23708,2020-06-22,Seychelles,0,0,11,"rgb(153, 201, 69)"
23709,2020-06-23,Seychelles,0,0,11,"rgb(153, 201, 69)"
23710,2020-06-24,Seychelles,0,0,11,"rgb(153, 201, 69)"
23711,2020-06-25,Seychelles,0,0,11,"rgb(153, 201, 69)"
23712,2020-06-26,Seychelles,0,0,11,"rgb(153, 201, 69)"
23713,2020-06-27,Seychelles,0,0,11,"rgb(153, 201, 69)"
23714,2020-06-28,Seychelles,0,0,11,"rgb(153, 201, 69)"
23715,2020-06-29,Seychelles,0,0,11,"rgb(153, 201, 69)"
23716,2020-06-30,Seychelles,0,0,11,"rgb(153, 201, 69)"
23717,2020-07-01,Seychelles,0,0,11,"rgb(153, 201, 69)"
23718,2020-07-02,Seychelles,0,0,11,"rgb(153, 201, 69)"
23719,2020-07-03,Seychelles,0,0,11,"rgb(153, 201, 69)"
23720,2020-07-04,Seychelles,0,0,11,"rgb(153, 201, 69)"
23721,2020-07-05,Seychelles,0,0,11,"rgb(153, 201, 69)"
23722,2020-07-06,Seychelles,0,0,11,"rgb(153, 201, 69)"
23723,2020-07-07,Seychelles,0,70,81,"rgb(153, 201, 69)"
23724,2020-07-08,Seychelles,0,0,81,"rgb(153, 201, 69)"
23725,2020-07-09,Seychelles,0,10,91,"rgb(153, 201, 69)"
23726,2020-07-10,Seychelles,0,3,94,"rgb(153, 201, 69)"
23727,2020-07-11,Seychelles,0,6,100,"rgb(153, 201, 69)"
23728,2020-07-12,Seychelles,0,0,100,"rgb(153, 201, 69)"
23729,2020-07-13,Seychelles,0,0,100,"rgb(153, 201, 69)"
23730,2020-03-14,Sudan,0,1,1,"rgb(204, 97, 176)"
23731,2020-03-15,Sudan,1,0,1,"rgb(204, 97, 176)"
23732,2020-03-16,Sudan,0,0,1,"rgb(204, 97, 176)"
23733,2020-03-17,Sudan,0,0,1,"rgb(204, 97, 176)"
23734,2020-03-18,Sudan,0,0,1,"rgb(204, 97, 176)"
23735,2020-03-19,Sudan,0,1,2,"rgb(204, 97, 176)"
23736,2020-03-20,Sudan,0,0,2,"rgb(204, 97, 176)"
23737,2020-03-21,Sudan,0,0,2,"rgb(204, 97, 176)"
23738,2020-03-22,Sudan,0,0,2,"rgb(204, 97, 176)"
23739,2020-03-23,Sudan,0,0,2,"rgb(204, 97, 176)"
23740,2020-03-24,Sudan,0,0,2,"rgb(204, 97, 176)"
23741,2020-03-25,Sudan,0,1,3,"rgb(204, 97, 176)"
23742,2020-03-26,Sudan,0,0,3,"rgb(204, 97, 176)"
23743,2020-03-27,Sudan,0,0,3,"rgb(204, 97, 176)"
23744,2020-03-28,Sudan,0,0,3,"rgb(204, 97, 176)"
23745,2020-03-29,Sudan,0,2,5,"rgb(204, 97, 176)"
23746,2020-03-30,Sudan,0,0,5,"rgb(204, 97, 176)"
23747,2020-03-31,Sudan,1,1,6,"rgb(204, 97, 176)"
23748,2020-04-01,Sudan,0,1,7,"rgb(204, 97, 176)"
23749,2020-04-02,Sudan,0,0,7,"rgb(204, 97, 176)"
23750,2020-04-03,Sudan,0,0,7,"rgb(204, 97, 176)"
23751,2020-04-04,Sudan,0,0,7,"rgb(204, 97, 176)"
23752,2020-04-05,Sudan,0,3,10,"rgb(204, 97, 176)"
23753,2020-04-06,Sudan,0,2,12,"rgb(204, 97, 176)"
23754,2020-04-07,Sudan,0,0,12,"rgb(204, 97, 176)"
23755,2020-04-08,Sudan,0,2,14,"rgb(204, 97, 176)"
23756,2020-04-09,Sudan,0,0,14,"rgb(204, 97, 176)"
23757,2020-04-10,Sudan,0,0,14,"rgb(204, 97, 176)"
23758,2020-04-11,Sudan,0,1,15,"rgb(204, 97, 176)"
23759,2020-04-12,Sudan,0,4,19,"rgb(204, 97, 176)"
23760,2020-04-13,Sudan,0,0,19,"rgb(204, 97, 176)"
23761,2020-04-14,Sudan,2,10,29,"rgb(204, 97, 176)"
23762,2020-04-15,Sudan,1,3,32,"rgb(204, 97, 176)"
23763,2020-04-16,Sudan,0,0,32,"rgb(204, 97, 176)"
23764,2020-04-17,Sudan,0,0,32,"rgb(204, 97, 176)"
23765,2020-04-18,Sudan,0,0,32,"rgb(204, 97, 176)"
23766,2020-04-19,Sudan,5,34,66,"rgb(204, 97, 176)"
23767,2020-04-20,Sudan,0,0,66,"rgb(204, 97, 176)"
23768,2020-04-21,Sudan,2,26,92,"rgb(204, 97, 176)"
23769,2020-04-22,Sudan,0,15,107,"rgb(204, 97, 176)"
23770,2020-04-23,Sudan,1,33,140,"rgb(204, 97, 176)"
23771,2020-04-24,Sudan,0,22,162,"rgb(204, 97, 176)"
23772,2020-04-25,Sudan,3,12,174,"rgb(204, 97, 176)"
23773,2020-04-26,Sudan,1,39,213,"rgb(204, 97, 176)"
23774,2020-04-27,Sudan,4,24,237,"rgb(204, 97, 176)"
23775,2020-04-28,Sudan,1,38,275,"rgb(204, 97, 176)"
23776,2020-04-29,Sudan,3,43,318,"rgb(204, 97, 176)"
23777,2020-04-30,Sudan,3,57,375,"rgb(204, 97, 176)"
23778,2020-05-01,Sudan,3,67,442,"rgb(204, 97, 176)"
23779,2020-05-02,Sudan,0,0,442,"rgb(204, 97, 176)"
23780,2020-05-03,Sudan,10,150,592,"rgb(204, 97, 176)"
23781,2020-05-04,Sudan,0,86,678,"rgb(204, 97, 176)"
23782,2020-05-05,Sudan,0,0,678,"rgb(204, 97, 176)"
23783,2020-05-06,Sudan,4,100,778,"rgb(204, 97, 176)"
23784,2020-05-07,Sudan,4,74,852,"rgb(204, 97, 176)"
23785,2020-05-08,Sudan,3,78,930,"rgb(204, 97, 176)"
23786,2020-05-09,Sudan,7,181,1111,"rgb(204, 97, 176)"
23787,2020-05-10,Sudan,5,53,1164,"rgb(204, 97, 176)"
23788,2020-05-11,Sudan,6,199,1363,"rgb(204, 97, 176)"
23789,2020-05-12,Sudan,4,163,1526,"rgb(204, 97, 176)"
23790,2020-05-13,Sudan,6,135,1661,"rgb(204, 97, 176)"
23791,2020-05-14,Sudan,10,157,1818,"rgb(204, 97, 176)"
23792,2020-05-15,Sudan,1,146,1964,"rgb(204, 97, 176)"
23793,2020-05-16,Sudan,0,0,1964,"rgb(204, 97, 176)"
23794,2020-05-17,Sudan,0,0,1964,"rgb(204, 97, 176)"
23795,2020-05-18,Sudan,6,325,2289,"rgb(204, 97, 176)"
23796,2020-05-19,Sudan,8,302,2591,"rgb(204, 97, 176)"
23797,2020-05-20,Sudan,0,0,2591,"rgb(204, 97, 176)"
23798,2020-05-21,Sudan,6,137,2728,"rgb(204, 97, 176)"
23799,2020-05-22,Sudan,10,410,3138,"rgb(204, 97, 176)"
23800,2020-05-23,Sudan,16,240,3378,"rgb(204, 97, 176)"
23801,2020-05-24,Sudan,9,250,3628,"rgb(204, 97, 176)"
23802,2020-05-25,Sudan,0,6,3634,"rgb(204, 97, 176)"
23803,2020-05-26,Sudan,19,192,3826,"rgb(204, 97, 176)"
23804,2020-05-27,Sudan,5,150,3976,"rgb(204, 97, 176)"
23805,2020-05-28,Sudan,14,170,4146,"rgb(204, 97, 176)"
23806,2020-05-29,Sudan,11,200,4346,"rgb(204, 97, 176)"
23807,2020-05-30,Sudan,38,175,4521,"rgb(204, 97, 176)"
23808,2020-05-31,Sudan,29,279,4800,"rgb(204, 97, 176)"
23809,2020-06-01,Sudan,24,226,5026,"rgb(204, 97, 176)"
23810,2020-06-02,Sudan,12,147,5173,"rgb(204, 97, 176)"
23811,2020-06-03,Sudan,9,137,5310,"rgb(204, 97, 176)"
23812,2020-06-04,Sudan,0,0,5310,"rgb(204, 97, 176)"
23813,2020-06-05,Sudan,7,189,5499,"rgb(204, 97, 176)"
23814,2020-06-06,Sudan,19,215,5714,"rgb(204, 97, 176)"
23815,2020-06-07,Sudan,14,151,5865,"rgb(204, 97, 176)"
23816,2020-06-08,Sudan,12,218,6083,"rgb(204, 97, 176)"
23817,2020-06-09,Sudan,13,159,6242,"rgb(204, 97, 176)"
23818,2020-06-10,Sudan,0,0,6242,"rgb(204, 97, 176)"
23819,2020-06-11,Sudan,17,185,6427,"rgb(204, 97, 176)"
23820,2020-06-12,Sudan,24,303,6730,"rgb(204, 97, 176)"
23821,2020-06-13,Sudan,20,149,6879,"rgb(204, 97, 176)"
23822,2020-06-14,Sudan,0,0,6879,"rgb(204, 97, 176)"
23823,2020-06-15,Sudan,26,341,7220,"rgb(204, 97, 176)"
23824,2020-06-16,Sudan,0,0,7220,"rgb(204, 97, 176)"
23825,2020-06-17,Sudan,18,520,7740,"rgb(204, 97, 176)"
23826,2020-06-18,Sudan,10,280,8020,"rgb(204, 97, 176)"
23827,2020-06-19,Sudan,0,0,8020,"rgb(204, 97, 176)"
23828,2020-06-20,Sudan,19,296,8316,"rgb(204, 97, 176)"
23829,2020-06-21,Sudan,15,264,8580,"rgb(204, 97, 176)"
23830,2020-06-22,Sudan,0,0,8580,"rgb(204, 97, 176)"
23831,2020-06-23,Sudan,12,118,8698,"rgb(204, 97, 176)"
23832,2020-06-24,Sudan,15,191,8889,"rgb(204, 97, 176)"
23833,2020-06-25,Sudan,0,0,8889,"rgb(204, 97, 176)"
23834,2020-06-26,Sudan,8,95,8984,"rgb(204, 97, 176)"
23835,2020-06-27,Sudan,16,273,9257,"rgb(204, 97, 176)"
23836,2020-06-28,Sudan,0,1,9258,"rgb(204, 97, 176)"
23837,2020-06-29,Sudan,0,0,9258,"rgb(204, 97, 176)"
23838,2020-06-30,Sudan,0,0,9258,"rgb(204, 97, 176)"
23839,2020-07-01,Sudan,0,0,9258,"rgb(204, 97, 176)"
23840,2020-07-02,Sudan,30,315,9573,"rgb(204, 97, 176)"
23841,2020-07-03,Sudan,0,0,9573,"rgb(204, 97, 176)"
23842,2020-07-04,Sudan,2,90,9663,"rgb(204, 97, 176)"
23843,2020-07-05,Sudan,0,0,9663,"rgb(204, 97, 176)"
23844,2020-07-06,Sudan,4,104,9767,"rgb(204, 97, 176)"
23845,2020-07-07,Sudan,0,0,9767,"rgb(204, 97, 176)"
23846,2020-07-08,Sudan,14,230,9997,"rgb(204, 97, 176)"
23847,2020-07-09,Sudan,14,87,10084,"rgb(204, 97, 176)"
23848,2020-07-10,Sudan,5,74,10158,"rgb(204, 97, 176)"
23849,2020-07-11,Sudan,8,46,10204,"rgb(204, 97, 176)"
23850,2020-07-12,Sudan,1,46,10250,"rgb(204, 97, 176)"
23851,2020-07-13,Sudan,0,0,10250,"rgb(204, 97, 176)"
23852,2019-12-31,Sweden,0,0,0,"rgb(36, 121, 108)"
23853,2020-01-01,Sweden,0,0,0,"rgb(36, 121, 108)"
23854,2020-01-02,Sweden,0,0,0,"rgb(36, 121, 108)"
23855,2020-01-03,Sweden,0,0,0,"rgb(36, 121, 108)"
23856,2020-01-04,Sweden,0,0,0,"rgb(36, 121, 108)"
23857,2020-01-05,Sweden,0,0,0,"rgb(36, 121, 108)"
23858,2020-01-06,Sweden,0,0,0,"rgb(36, 121, 108)"
23859,2020-01-07,Sweden,0,0,0,"rgb(36, 121, 108)"
23860,2020-01-08,Sweden,0,0,0,"rgb(36, 121, 108)"
23861,2020-01-09,Sweden,0,0,0,"rgb(36, 121, 108)"
23862,2020-01-10,Sweden,0,0,0,"rgb(36, 121, 108)"
23863,2020-01-11,Sweden,0,0,0,"rgb(36, 121, 108)"
23864,2020-01-12,Sweden,0,0,0,"rgb(36, 121, 108)"
23865,2020-01-13,Sweden,0,0,0,"rgb(36, 121, 108)"
23866,2020-01-14,Sweden,0,0,0,"rgb(36, 121, 108)"
23867,2020-01-15,Sweden,0,0,0,"rgb(36, 121, 108)"
23868,2020-01-16,Sweden,0,0,0,"rgb(36, 121, 108)"
23869,2020-01-17,Sweden,0,0,0,"rgb(36, 121, 108)"
23870,2020-01-18,Sweden,0,0,0,"rgb(36, 121, 108)"
23871,2020-01-19,Sweden,0,0,0,"rgb(36, 121, 108)"
23872,2020-01-20,Sweden,0,0,0,"rgb(36, 121, 108)"
23873,2020-01-21,Sweden,0,0,0,"rgb(36, 121, 108)"
23874,2020-01-22,Sweden,0,0,0,"rgb(36, 121, 108)"
23875,2020-01-23,Sweden,0,0,0,"rgb(36, 121, 108)"
23876,2020-01-24,Sweden,0,0,0,"rgb(36, 121, 108)"
23877,2020-01-25,Sweden,0,0,0,"rgb(36, 121, 108)"
23878,2020-01-26,Sweden,0,0,0,"rgb(36, 121, 108)"
23879,2020-01-27,Sweden,0,0,0,"rgb(36, 121, 108)"
23880,2020-01-28,Sweden,0,0,0,"rgb(36, 121, 108)"
23881,2020-01-29,Sweden,0,0,0,"rgb(36, 121, 108)"
23882,2020-01-30,Sweden,0,0,0,"rgb(36, 121, 108)"
23883,2020-01-31,Sweden,0,0,0,"rgb(36, 121, 108)"
23884,2020-02-01,Sweden,0,1,1,"rgb(36, 121, 108)"
23885,2020-02-02,Sweden,0,0,1,"rgb(36, 121, 108)"
23886,2020-02-03,Sweden,0,0,1,"rgb(36, 121, 108)"
23887,2020-02-04,Sweden,0,0,1,"rgb(36, 121, 108)"
23888,2020-02-05,Sweden,0,0,1,"rgb(36, 121, 108)"
23889,2020-02-06,Sweden,0,0,1,"rgb(36, 121, 108)"
23890,2020-02-07,Sweden,0,0,1,"rgb(36, 121, 108)"
23891,2020-02-08,Sweden,0,0,1,"rgb(36, 121, 108)"
23892,2020-02-09,Sweden,0,0,1,"rgb(36, 121, 108)"
23893,2020-02-10,Sweden,0,0,1,"rgb(36, 121, 108)"
23894,2020-02-11,Sweden,0,0,1,"rgb(36, 121, 108)"
23895,2020-02-12,Sweden,0,0,1,"rgb(36, 121, 108)"
23896,2020-02-13,Sweden,0,0,1,"rgb(36, 121, 108)"
23897,2020-02-14,Sweden,0,0,1,"rgb(36, 121, 108)"
23898,2020-02-15,Sweden,0,0,1,"rgb(36, 121, 108)"
23899,2020-02-16,Sweden,0,0,1,"rgb(36, 121, 108)"
23900,2020-02-17,Sweden,0,0,1,"rgb(36, 121, 108)"
23901,2020-02-18,Sweden,0,0,1,"rgb(36, 121, 108)"
23902,2020-02-19,Sweden,0,0,1,"rgb(36, 121, 108)"
23903,2020-02-20,Sweden,0,0,1,"rgb(36, 121, 108)"
23904,2020-02-21,Sweden,0,0,1,"rgb(36, 121, 108)"
23905,2020-02-22,Sweden,0,0,1,"rgb(36, 121, 108)"
23906,2020-02-23,Sweden,0,0,1,"rgb(36, 121, 108)"
23907,2020-02-24,Sweden,0,0,1,"rgb(36, 121, 108)"
23908,2020-02-25,Sweden,0,0,1,"rgb(36, 121, 108)"
23909,2020-02-26,Sweden,0,0,1,"rgb(36, 121, 108)"
23910,2020-02-27,Sweden,0,1,2,"rgb(36, 121, 108)"
23911,2020-02-28,Sweden,0,5,7,"rgb(36, 121, 108)"
23912,2020-02-29,Sweden,0,5,12,"rgb(36, 121, 108)"
23913,2020-03-01,Sweden,0,1,13,"rgb(36, 121, 108)"
23914,2020-03-02,Sweden,0,1,14,"rgb(36, 121, 108)"
23915,2020-03-03,Sweden,0,1,15,"rgb(36, 121, 108)"
23916,2020-03-04,Sweden,0,9,24,"rgb(36, 121, 108)"
23917,2020-03-05,Sweden,0,11,35,"rgb(36, 121, 108)"
23918,2020-03-06,Sweden,0,26,61,"rgb(36, 121, 108)"
23919,2020-03-07,Sweden,0,76,137,"rgb(36, 121, 108)"
23920,2020-03-08,Sweden,0,24,161,"rgb(36, 121, 108)"
23921,2020-03-09,Sweden,0,42,203,"rgb(36, 121, 108)"
23922,2020-03-10,Sweden,0,45,248,"rgb(36, 121, 108)"
23923,2020-03-11,Sweden,0,78,326,"rgb(36, 121, 108)"
23924,2020-03-12,Sweden,1,136,462,"rgb(36, 121, 108)"
23925,2020-03-13,Sweden,0,158,620,"rgb(36, 121, 108)"
23926,2020-03-14,Sweden,0,155,775,"rgb(36, 121, 108)"
23927,2020-03-15,Sweden,0,149,924,"rgb(36, 121, 108)"
23928,2020-03-16,Sweden,2,108,1032,"rgb(36, 121, 108)"
23929,2020-03-17,Sweden,4,89,1121,"rgb(36, 121, 108)"
23930,2020-03-18,Sweden,1,46,1167,"rgb(36, 121, 108)"
23931,2020-03-19,Sweden,2,134,1301,"rgb(36, 121, 108)"
23932,2020-03-20,Sweden,0,122,1423,"rgb(36, 121, 108)"
23933,2020-03-21,Sweden,6,200,1623,"rgb(36, 121, 108)"
23934,2020-03-22,Sweden,4,123,1746,"rgb(36, 121, 108)"
23935,2020-03-23,Sweden,1,160,1906,"rgb(36, 121, 108)"
23936,2020-03-24,Sweden,4,110,2016,"rgb(36, 121, 108)"
23937,2020-03-25,Sweden,11,256,2272,"rgb(36, 121, 108)"
23938,2020-03-26,Sweden,6,238,2510,"rgb(36, 121, 108)"
23939,2020-03-27,Sweden,24,296,2806,"rgb(36, 121, 108)"
23940,2020-03-28,Sweden,26,240,3046,"rgb(36, 121, 108)"
23941,2020-03-29,Sweden,10,401,3447,"rgb(36, 121, 108)"
23942,2020-03-30,Sweden,8,253,3700,"rgb(36, 121, 108)"
23943,2020-03-31,Sweden,36,328,4028,"rgb(36, 121, 108)"
23944,2020-04-01,Sweden,34,407,4435,"rgb(36, 121, 108)"
23945,2020-04-02,Sweden,59,512,4947,"rgb(36, 121, 108)"
23946,2020-04-03,Sweden,43,519,5466,"rgb(36, 121, 108)"
23947,2020-04-04,Sweden,51,612,6078,"rgb(36, 121, 108)"
23948,2020-04-05,Sweden,40,365,6443,"rgb(36, 121, 108)"
23949,2020-04-06,Sweden,28,387,6830,"rgb(36, 121, 108)"
23950,2020-04-07,Sweden,76,376,7206,"rgb(36, 121, 108)"
23951,2020-04-08,Sweden,114,487,7693,"rgb(36, 121, 108)"
23952,2020-04-09,Sweden,96,726,8419,"rgb(36, 121, 108)"
23953,2020-04-10,Sweden,106,722,9141,"rgb(36, 121, 108)"
23954,2020-04-11,Sweden,77,544,9685,"rgb(36, 121, 108)"
23955,2020-04-12,Sweden,17,466,10151,"rgb(36, 121, 108)"
23956,2020-04-13,Sweden,12,332,10483,"rgb(36, 121, 108)"
23957,2020-04-14,Sweden,20,465,10948,"rgb(36, 121, 108)"
23958,2020-04-15,Sweden,114,497,11445,"rgb(36, 121, 108)"
23959,2020-04-16,Sweden,170,482,11927,"rgb(36, 121, 108)"
23960,2020-04-17,Sweden,130,613,12540,"rgb(36, 121, 108)"
23961,2020-04-18,Sweden,67,676,13216,"rgb(36, 121, 108)"
23962,2020-04-19,Sweden,111,606,13822,"rgb(36, 121, 108)"
23963,2020-04-20,Sweden,29,563,14385,"rgb(36, 121, 108)"
23964,2020-04-21,Sweden,40,392,14777,"rgb(36, 121, 108)"
23965,2020-04-22,Sweden,185,545,15322,"rgb(36, 121, 108)"
23966,2020-04-23,Sweden,172,682,16004,"rgb(36, 121, 108)"
23967,2020-04-24,Sweden,84,751,16755,"rgb(36, 121, 108)"
23968,2020-04-25,Sweden,131,812,17567,"rgb(36, 121, 108)"
23969,2020-04-26,Sweden,40,610,18177,"rgb(36, 121, 108)"
23970,2020-04-27,Sweden,2,463,18640,"rgb(36, 121, 108)"
23971,2020-04-28,Sweden,80,286,18926,"rgb(36, 121, 108)"
23972,2020-04-29,Sweden,81,695,19621,"rgb(36, 121, 108)"
23973,2020-04-30,Sweden,107,681,20302,"rgb(36, 121, 108)"
23974,2020-05-01,Sweden,124,790,21092,"rgb(36, 121, 108)"
23975,2020-05-02,Sweden,67,428,21520,"rgb(36, 121, 108)"
23976,2020-05-03,Sweden,16,562,22082,"rgb(36, 121, 108)"
23977,2020-05-04,Sweden,10,235,22317,"rgb(36, 121, 108)"
23978,2020-05-05,Sweden,90,404,22721,"rgb(36, 121, 108)"
23979,2020-05-06,Sweden,85,495,23216,"rgb(36, 121, 108)"
23980,2020-05-07,Sweden,87,702,23918,"rgb(36, 121, 108)"
23981,2020-05-08,Sweden,99,705,24623,"rgb(36, 121, 108)"
23982,2020-05-09,Sweden,135,642,25265,"rgb(36, 121, 108)"
23983,2020-05-10,Sweden,45,656,25921,"rgb(36, 121, 108)"
23984,2020-05-11,Sweden,5,401,26322,"rgb(36, 121, 108)"
23985,2020-05-12,Sweden,31,348,26670,"rgb(36, 121, 108)"
23986,2020-05-13,Sweden,57,602,27272,"rgb(36, 121, 108)"
23987,2020-05-14,Sweden,147,637,27909,"rgb(36, 121, 108)"
23988,2020-05-15,Sweden,69,673,28582,"rgb(36, 121, 108)"
23989,2020-05-16,Sweden,117,625,29207,"rgb(36, 121, 108)"
23990,2020-05-17,Sweden,28,470,29677,"rgb(36, 121, 108)"
23991,2020-05-18,Sweden,5,466,30143,"rgb(36, 121, 108)"
23992,2020-05-19,Sweden,19,234,30377,"rgb(36, 121, 108)"
23993,2020-05-20,Sweden,45,422,30799,"rgb(36, 121, 108)"
23994,2020-05-21,Sweden,88,724,31523,"rgb(36, 121, 108)"
23995,2020-05-22,Sweden,40,649,32172,"rgb(36, 121, 108)"
23996,2020-05-23,Sweden,54,637,32809,"rgb(36, 121, 108)"
23997,2020-05-24,Sweden,67,379,33188,"rgb(36, 121, 108)"
23998,2020-05-25,Sweden,6,271,33459,"rgb(36, 121, 108)"
23999,2020-05-26,Sweden,31,384,33843,"rgb(36, 121, 108)"
24000,2020-05-27,Sweden,96,597,34440,"rgb(36, 121, 108)"
24001,2020-05-28,Sweden,95,648,35088,"rgb(36, 121, 108)"
24002,2020-05-29,Sweden,46,639,35727,"rgb(36, 121, 108)"
24003,2020-05-30,Sweden,84,749,36476,"rgb(36, 121, 108)"
24004,2020-05-31,Sweden,45,637,37113,"rgb(36, 121, 108)"
24005,2020-06-01,Sweden,0,429,37542,"rgb(36, 121, 108)"
24006,2020-06-02,Sweden,8,272,37814,"rgb(36, 121, 108)"
24007,2020-06-03,Sweden,65,775,38589,"rgb(36, 121, 108)"
24008,2020-06-04,Sweden,74,2214,40803,"rgb(36, 121, 108)"
24009,2020-06-05,Sweden,20,1080,41883,"rgb(36, 121, 108)"
24010,2020-06-06,Sweden,77,1056,42939,"rgb(36, 121, 108)"
24011,2020-06-07,Sweden,17,948,43887,"rgb(36, 121, 108)"
24012,2020-06-08,Sweden,3,843,44730,"rgb(36, 121, 108)"
24013,2020-06-09,Sweden,35,403,45133,"rgb(36, 121, 108)"
24014,2020-06-10,Sweden,23,791,45924,"rgb(36, 121, 108)"
24015,2020-06-11,Sweden,78,890,46814,"rgb(36, 121, 108)"
24016,2020-06-12,Sweden,19,1474,48288,"rgb(36, 121, 108)"
24017,2020-06-13,Sweden,40,1396,49684,"rgb(36, 121, 108)"
24018,2020-06-14,Sweden,20,1247,50931,"rgb(36, 121, 108)"
24019,2020-06-15,Sweden,0,683,51614,"rgb(36, 121, 108)"
24020,2020-06-16,Sweden,17,769,52383,"rgb(36, 121, 108)"
24021,2020-06-17,Sweden,48,940,53323,"rgb(36, 121, 108)"
24022,2020-06-18,Sweden,102,1239,54562,"rgb(36, 121, 108)"
24023,2020-06-19,Sweden,12,1481,56043,"rgb(36, 121, 108)"
24024,2020-06-20,Sweden,0,0,56043,"rgb(36, 121, 108)"
24025,2020-06-21,Sweden,0,0,56043,"rgb(36, 121, 108)"
24026,2020-06-22,Sweden,0,0,56043,"rgb(36, 121, 108)"
24027,2020-06-23,Sweden,69,2889,58932,"rgb(36, 121, 108)"
24028,2020-06-24,Sweden,39,1905,60837,"rgb(36, 121, 108)"
24029,2020-06-25,Sweden,48,1487,62324,"rgb(36, 121, 108)"
24030,2020-06-26,Sweden,21,1566,63890,"rgb(36, 121, 108)"
24031,2020-06-27,Sweden,50,1247,65137,"rgb(36, 121, 108)"
24032,2020-06-28,Sweden,0,0,65137,"rgb(36, 121, 108)"
24033,2020-06-29,Sweden,0,0,65137,"rgb(36, 121, 108)"
24034,2020-06-30,Sweden,30,2530,67667,"rgb(36, 121, 108)"
24035,2020-07-01,Sweden,23,784,68451,"rgb(36, 121, 108)"
24036,2020-07-02,Sweden,37,1241,69692,"rgb(36, 121, 108)"
24037,2020-07-03,Sweden,41,947,70639,"rgb(36, 121, 108)"
24038,2020-07-04,Sweden,9,780,71419,"rgb(36, 121, 108)"
24039,2020-07-05,Sweden,0,0,71419,"rgb(36, 121, 108)"
24040,2020-07-06,Sweden,0,0,71419,"rgb(36, 121, 108)"
24041,2020-07-07,Sweden,13,1642,73061,"rgb(36, 121, 108)"
24042,2020-07-08,Sweden,14,283,73344,"rgb(36, 121, 108)"
24043,2020-07-09,Sweden,35,514,73858,"rgb(36, 121, 108)"
24044,2020-07-10,Sweden,18,475,74333,"rgb(36, 121, 108)"
24045,2020-07-11,Sweden,26,565,74898,"rgb(36, 121, 108)"
24046,2020-07-12,Sweden,0,0,74898,"rgb(36, 121, 108)"
24047,2020-07-13,Sweden,0,0,74898,"rgb(36, 121, 108)"
24048,2019-12-31,Singapore,0,0,0,"rgb(218, 165, 27)"
24049,2020-01-01,Singapore,0,0,0,"rgb(218, 165, 27)"
24050,2020-01-02,Singapore,0,0,0,"rgb(218, 165, 27)"
24051,2020-01-03,Singapore,0,0,0,"rgb(218, 165, 27)"
24052,2020-01-04,Singapore,0,0,0,"rgb(218, 165, 27)"
24053,2020-01-05,Singapore,0,0,0,"rgb(218, 165, 27)"
24054,2020-01-06,Singapore,0,0,0,"rgb(218, 165, 27)"
24055,2020-01-07,Singapore,0,0,0,"rgb(218, 165, 27)"
24056,2020-01-08,Singapore,0,0,0,"rgb(218, 165, 27)"
24057,2020-01-09,Singapore,0,0,0,"rgb(218, 165, 27)"
24058,2020-01-10,Singapore,0,0,0,"rgb(218, 165, 27)"
24059,2020-01-11,Singapore,0,0,0,"rgb(218, 165, 27)"
24060,2020-01-12,Singapore,0,0,0,"rgb(218, 165, 27)"
24061,2020-01-13,Singapore,0,0,0,"rgb(218, 165, 27)"
24062,2020-01-14,Singapore,0,0,0,"rgb(218, 165, 27)"
24063,2020-01-15,Singapore,0,0,0,"rgb(218, 165, 27)"
24064,2020-01-16,Singapore,0,0,0,"rgb(218, 165, 27)"
24065,2020-01-17,Singapore,0,0,0,"rgb(218, 165, 27)"
24066,2020-01-18,Singapore,0,0,0,"rgb(218, 165, 27)"
24067,2020-01-19,Singapore,0,0,0,"rgb(218, 165, 27)"
24068,2020-01-20,Singapore,0,0,0,"rgb(218, 165, 27)"
24069,2020-01-21,Singapore,0,0,0,"rgb(218, 165, 27)"
24070,2020-01-22,Singapore,0,0,0,"rgb(218, 165, 27)"
24071,2020-01-23,Singapore,0,0,0,"rgb(218, 165, 27)"
24072,2020-01-24,Singapore,0,3,3,"rgb(218, 165, 27)"
24073,2020-01-25,Singapore,0,0,3,"rgb(218, 165, 27)"
24074,2020-01-26,Singapore,0,1,4,"rgb(218, 165, 27)"
24075,2020-01-27,Singapore,0,0,4,"rgb(218, 165, 27)"
24076,2020-01-28,Singapore,0,1,5,"rgb(218, 165, 27)"
24077,2020-01-29,Singapore,0,2,7,"rgb(218, 165, 27)"
24078,2020-01-30,Singapore,0,3,10,"rgb(218, 165, 27)"
24079,2020-01-31,Singapore,0,3,13,"rgb(218, 165, 27)"
24080,2020-02-01,Singapore,0,3,16,"rgb(218, 165, 27)"
24081,2020-02-02,Singapore,0,2,18,"rgb(218, 165, 27)"
24082,2020-02-03,Singapore,0,0,18,"rgb(218, 165, 27)"
24083,2020-02-04,Singapore,0,0,18,"rgb(218, 165, 27)"
24084,2020-02-05,Singapore,0,6,24,"rgb(218, 165, 27)"
24085,2020-02-06,Singapore,0,4,28,"rgb(218, 165, 27)"
24086,2020-02-07,Singapore,0,2,30,"rgb(218, 165, 27)"
24087,2020-02-08,Singapore,0,3,33,"rgb(218, 165, 27)"
24088,2020-02-09,Singapore,0,7,40,"rgb(218, 165, 27)"
24089,2020-02-10,Singapore,0,3,43,"rgb(218, 165, 27)"
24090,2020-02-11,Singapore,0,2,45,"rgb(218, 165, 27)"
24091,2020-02-12,Singapore,0,2,47,"rgb(218, 165, 27)"
24092,2020-02-13,Singapore,0,3,50,"rgb(218, 165, 27)"
24093,2020-02-14,Singapore,0,8,58,"rgb(218, 165, 27)"
24094,2020-02-15,Singapore,0,9,67,"rgb(218, 165, 27)"
24095,2020-02-16,Singapore,0,5,72,"rgb(218, 165, 27)"
24096,2020-02-17,Singapore,0,3,75,"rgb(218, 165, 27)"
24097,2020-02-18,Singapore,0,2,77,"rgb(218, 165, 27)"
24098,2020-02-19,Singapore,0,4,81,"rgb(218, 165, 27)"
24099,2020-02-20,Singapore,0,3,84,"rgb(218, 165, 27)"
24100,2020-02-21,Singapore,0,1,85,"rgb(218, 165, 27)"
24101,2020-02-22,Singapore,0,1,86,"rgb(218, 165, 27)"
24102,2020-02-23,Singapore,0,3,89,"rgb(218, 165, 27)"
24103,2020-02-24,Singapore,0,0,89,"rgb(218, 165, 27)"
24104,2020-02-25,Singapore,0,1,90,"rgb(218, 165, 27)"
24105,2020-02-26,Singapore,0,1,91,"rgb(218, 165, 27)"
24106,2020-02-27,Singapore,0,2,93,"rgb(218, 165, 27)"
24107,2020-02-28,Singapore,0,3,96,"rgb(218, 165, 27)"
24108,2020-02-29,Singapore,0,2,98,"rgb(218, 165, 27)"
24109,2020-03-01,Singapore,0,4,102,"rgb(218, 165, 27)"
24110,2020-03-02,Singapore,0,4,106,"rgb(218, 165, 27)"
24111,2020-03-03,Singapore,0,2,108,"rgb(218, 165, 27)"
24112,2020-03-04,Singapore,0,2,110,"rgb(218, 165, 27)"
24113,2020-03-05,Singapore,0,2,112,"rgb(218, 165, 27)"
24114,2020-03-06,Singapore,0,5,117,"rgb(218, 165, 27)"
24115,2020-03-07,Singapore,0,13,130,"rgb(218, 165, 27)"
24116,2020-03-08,Singapore,0,8,138,"rgb(218, 165, 27)"
24117,2020-03-09,Singapore,0,12,150,"rgb(218, 165, 27)"
24118,2020-03-10,Singapore,0,10,160,"rgb(218, 165, 27)"
24119,2020-03-11,Singapore,0,6,166,"rgb(218, 165, 27)"
24120,2020-03-12,Singapore,0,12,178,"rgb(218, 165, 27)"
24121,2020-03-13,Singapore,0,9,187,"rgb(218, 165, 27)"
24122,2020-03-14,Singapore,0,13,200,"rgb(218, 165, 27)"
24123,2020-03-15,Singapore,0,14,214,"rgb(218, 165, 27)"
24124,2020-03-16,Singapore,0,12,226,"rgb(218, 165, 27)"
24125,2020-03-17,Singapore,0,17,243,"rgb(218, 165, 27)"
24126,2020-03-18,Singapore,0,23,266,"rgb(218, 165, 27)"
24127,2020-03-19,Singapore,0,47,313,"rgb(218, 165, 27)"
24128,2020-03-20,Singapore,0,32,345,"rgb(218, 165, 27)"
24129,2020-03-21,Singapore,0,40,385,"rgb(218, 165, 27)"
24130,2020-03-22,Singapore,2,47,432,"rgb(218, 165, 27)"
24131,2020-03-23,Singapore,0,23,455,"rgb(218, 165, 27)"
24132,2020-03-24,Singapore,0,54,509,"rgb(218, 165, 27)"
24133,2020-03-25,Singapore,0,49,558,"rgb(218, 165, 27)"
24134,2020-03-26,Singapore,0,10,568,"rgb(218, 165, 27)"
24135,2020-03-27,Singapore,0,26,594,"rgb(218, 165, 27)"
24136,2020-03-28,Singapore,0,138,732,"rgb(218, 165, 27)"
24137,2020-03-29,Singapore,1,71,803,"rgb(218, 165, 27)"
24138,2020-03-30,Singapore,0,41,844,"rgb(218, 165, 27)"
24139,2020-03-31,Singapore,0,0,844,"rgb(218, 165, 27)"
24140,2020-04-01,Singapore,0,35,879,"rgb(218, 165, 27)"
24141,2020-04-02,Singapore,1,121,1000,"rgb(218, 165, 27)"
24142,2020-04-03,Singapore,1,49,1049,"rgb(218, 165, 27)"
24143,2020-04-04,Singapore,0,65,1114,"rgb(218, 165, 27)"
24144,2020-04-05,Singapore,1,75,1189,"rgb(218, 165, 27)"
24145,2020-04-06,Singapore,0,120,1309,"rgb(218, 165, 27)"
24146,2020-04-07,Singapore,0,66,1375,"rgb(218, 165, 27)"
24147,2020-04-08,Singapore,0,106,1481,"rgb(218, 165, 27)"
24148,2020-04-09,Singapore,0,142,1623,"rgb(218, 165, 27)"
24149,2020-04-10,Singapore,0,286,1909,"rgb(218, 165, 27)"
24150,2020-04-11,Singapore,0,0,1909,"rgb(218, 165, 27)"
24151,2020-04-12,Singapore,2,390,2299,"rgb(218, 165, 27)"
24152,2020-04-13,Singapore,0,233,2532,"rgb(218, 165, 27)"
24153,2020-04-14,Singapore,1,386,2918,"rgb(218, 165, 27)"
24154,2020-04-15,Singapore,1,334,3252,"rgb(218, 165, 27)"
24155,2020-04-16,Singapore,0,447,3699,"rgb(218, 165, 27)"
24156,2020-04-17,Singapore,0,728,4427,"rgb(218, 165, 27)"
24157,2020-04-18,Singapore,1,623,5050,"rgb(218, 165, 27)"
24158,2020-04-19,Singapore,0,942,5992,"rgb(218, 165, 27)"
24159,2020-04-20,Singapore,0,596,6588,"rgb(218, 165, 27)"
24160,2020-04-21,Singapore,0,1426,8014,"rgb(218, 165, 27)"
24161,2020-04-22,Singapore,0,1111,9125,"rgb(218, 165, 27)"
24162,2020-04-23,Singapore,1,1016,10141,"rgb(218, 165, 27)"
24163,2020-04-24,Singapore,0,1037,11178,"rgb(218, 165, 27)"
24164,2020-04-25,Singapore,0,897,12075,"rgb(218, 165, 27)"
24165,2020-04-26,Singapore,0,618,12693,"rgb(218, 165, 27)"
24166,2020-04-27,Singapore,0,931,13624,"rgb(218, 165, 27)"
24167,2020-04-28,Singapore,2,799,14423,"rgb(218, 165, 27)"
24168,2020-04-29,Singapore,0,528,14951,"rgb(218, 165, 27)"
24169,2020-04-30,Singapore,0,690,15641,"rgb(218, 165, 27)"
24170,2020-05-01,Singapore,1,528,16169,"rgb(218, 165, 27)"
24171,2020-05-02,Singapore,1,932,17101,"rgb(218, 165, 27)"
24172,2020-05-03,Singapore,1,447,17548,"rgb(218, 165, 27)"
24173,2020-05-04,Singapore,1,657,18205,"rgb(218, 165, 27)"
24174,2020-05-05,Singapore,0,573,18778,"rgb(218, 165, 27)"
24175,2020-05-06,Singapore,0,632,19410,"rgb(218, 165, 27)"
24176,2020-05-07,Singapore,2,788,20198,"rgb(218, 165, 27)"
24177,2020-05-08,Singapore,0,741,20939,"rgb(218, 165, 27)"
24178,2020-05-09,Singapore,0,768,21707,"rgb(218, 165, 27)"
24179,2020-05-10,Singapore,0,753,22460,"rgb(218, 165, 27)"
24180,2020-05-11,Singapore,0,876,23336,"rgb(218, 165, 27)"
24181,2020-05-12,Singapore,1,451,23787,"rgb(218, 165, 27)"
24182,2020-05-13,Singapore,0,884,24671,"rgb(218, 165, 27)"
24183,2020-05-14,Singapore,0,675,25346,"rgb(218, 165, 27)"
24184,2020-05-15,Singapore,0,752,26098,"rgb(218, 165, 27)"
24185,2020-05-16,Singapore,0,793,26891,"rgb(218, 165, 27)"
24186,2020-05-17,Singapore,1,465,27356,"rgb(218, 165, 27)"
24187,2020-05-18,Singapore,0,682,28038,"rgb(218, 165, 27)"
24188,2020-05-19,Singapore,0,305,28343,"rgb(218, 165, 27)"
24189,2020-05-20,Singapore,0,451,28794,"rgb(218, 165, 27)"
24190,2020-05-21,Singapore,0,570,29364,"rgb(218, 165, 27)"
24191,2020-05-22,Singapore,1,448,29812,"rgb(218, 165, 27)"
24192,2020-05-23,Singapore,0,614,30426,"rgb(218, 165, 27)"
24193,2020-05-24,Singapore,0,642,31068,"rgb(218, 165, 27)"
24194,2020-05-25,Singapore,0,548,31616,"rgb(218, 165, 27)"
24195,2020-05-26,Singapore,0,344,31960,"rgb(218, 165, 27)"
24196,2020-05-27,Singapore,0,383,32343,"rgb(218, 165, 27)"
24197,2020-05-28,Singapore,0,533,32876,"rgb(218, 165, 27)"
24198,2020-05-29,Singapore,0,373,33249,"rgb(218, 165, 27)"
24199,2020-05-30,Singapore,0,611,33860,"rgb(218, 165, 27)"
24200,2020-05-31,Singapore,0,506,34366,"rgb(218, 165, 27)"
24201,2020-06-01,Singapore,0,518,34884,"rgb(218, 165, 27)"
24202,2020-06-02,Singapore,1,408,35292,"rgb(218, 165, 27)"
24203,2020-06-03,Singapore,0,544,35836,"rgb(218, 165, 27)"
24204,2020-06-04,Singapore,0,569,36405,"rgb(218, 165, 27)"
24205,2020-06-05,Singapore,0,517,36922,"rgb(218, 165, 27)"
24206,2020-06-06,Singapore,0,261,37183,"rgb(218, 165, 27)"
24207,2020-06-07,Singapore,1,344,37527,"rgb(218, 165, 27)"
24208,2020-06-08,Singapore,0,383,37910,"rgb(218, 165, 27)"
24209,2020-06-09,Singapore,0,386,38296,"rgb(218, 165, 27)"
24210,2020-06-10,Singapore,0,218,38514,"rgb(218, 165, 27)"
24211,2020-06-11,Singapore,0,451,38965,"rgb(218, 165, 27)"
24212,2020-06-12,Singapore,0,422,39387,"rgb(218, 165, 27)"
24213,2020-06-13,Singapore,0,463,39850,"rgb(218, 165, 27)"
24214,2020-06-14,Singapore,1,347,40197,"rgb(218, 165, 27)"
24215,2020-06-15,Singapore,0,407,40604,"rgb(218, 165, 27)"
24216,2020-06-16,Singapore,0,214,40818,"rgb(218, 165, 27)"
24217,2020-06-17,Singapore,0,151,40969,"rgb(218, 165, 27)"
24218,2020-06-18,Singapore,0,247,41216,"rgb(218, 165, 27)"
24219,2020-06-19,Singapore,0,257,41473,"rgb(218, 165, 27)"
24220,2020-06-20,Singapore,0,142,41615,"rgb(218, 165, 27)"
24221,2020-06-21,Singapore,0,218,41833,"rgb(218, 165, 27)"
24222,2020-06-22,Singapore,0,262,42095,"rgb(218, 165, 27)"
24223,2020-06-23,Singapore,0,218,42313,"rgb(218, 165, 27)"
24224,2020-06-24,Singapore,0,119,42432,"rgb(218, 165, 27)"
24225,2020-06-25,Singapore,0,191,42623,"rgb(218, 165, 27)"
24226,2020-06-26,Singapore,0,113,42736,"rgb(218, 165, 27)"
24227,2020-06-27,Singapore,0,219,42955,"rgb(218, 165, 27)"
24228,2020-06-28,Singapore,0,291,43246,"rgb(218, 165, 27)"
24229,2020-06-29,Singapore,0,213,43459,"rgb(218, 165, 27)"
24230,2020-06-30,Singapore,0,202,43661,"rgb(218, 165, 27)"
24231,2020-07-01,Singapore,0,246,43907,"rgb(218, 165, 27)"
24232,2020-07-02,Singapore,0,215,44122,"rgb(218, 165, 27)"
24233,2020-07-03,Singapore,0,188,44310,"rgb(218, 165, 27)"
24234,2020-07-04,Singapore,0,169,44479,"rgb(218, 165, 27)"
24235,2020-07-05,Singapore,0,185,44664,"rgb(218, 165, 27)"
24236,2020-07-06,Singapore,0,0,44664,"rgb(218, 165, 27)"
24237,2020-07-07,Singapore,0,319,44983,"rgb(218, 165, 27)"
24238,2020-07-08,Singapore,0,157,45140,"rgb(218, 165, 27)"
24239,2020-07-09,Singapore,0,158,45298,"rgb(218, 165, 27)"
24240,2020-07-10,Singapore,0,124,45422,"rgb(218, 165, 27)"
24241,2020-07-11,Singapore,0,191,45613,"rgb(218, 165, 27)"
24242,2020-07-12,Singapore,0,170,45783,"rgb(218, 165, 27)"
24243,2020-07-13,Singapore,0,178,45961,"rgb(218, 165, 27)"
24244,2020-03-05,Slovenia,0,1,1,"rgb(47, 138, 196)"
24245,2020-03-06,Slovenia,0,5,6,"rgb(47, 138, 196)"
24246,2020-03-07,Slovenia,0,3,9,"rgb(47, 138, 196)"
24247,2020-03-08,Slovenia,0,3,12,"rgb(47, 138, 196)"
24248,2020-03-09,Slovenia,0,4,16,"rgb(47, 138, 196)"
24249,2020-03-11,Slovenia,0,15,31,"rgb(47, 138, 196)"
24250,2020-03-12,Slovenia,0,26,57,"rgb(47, 138, 196)"
24251,2020-03-13,Slovenia,0,39,96,"rgb(47, 138, 196)"
24252,2020-03-14,Slovenia,0,45,141,"rgb(47, 138, 196)"
24253,2020-03-15,Slovenia,0,40,181,"rgb(47, 138, 196)"
24254,2020-03-16,Slovenia,0,38,219,"rgb(47, 138, 196)"
24255,2020-03-17,Slovenia,0,34,253,"rgb(47, 138, 196)"
24256,2020-03-18,Slovenia,1,22,275,"rgb(47, 138, 196)"
24257,2020-03-19,Slovenia,0,11,286,"rgb(47, 138, 196)"
24258,2020-03-20,Slovenia,0,33,319,"rgb(47, 138, 196)"
24259,2020-03-21,Slovenia,0,22,341,"rgb(47, 138, 196)"
24260,2020-03-22,Slovenia,0,42,383,"rgb(47, 138, 196)"
24261,2020-03-23,Slovenia,0,31,414,"rgb(47, 138, 196)"
24262,2020-03-24,Slovenia,0,28,442,"rgb(47, 138, 196)"
24263,2020-03-25,Slovenia,2,38,480,"rgb(47, 138, 196)"
24264,2020-03-26,Slovenia,1,48,528,"rgb(47, 138, 196)"
24265,2020-03-27,Slovenia,1,49,577,"rgb(47, 138, 196)"
24266,2020-03-28,Slovenia,4,55,632,"rgb(47, 138, 196)"
24267,2020-03-29,Slovenia,0,59,691,"rgb(47, 138, 196)"
24268,2020-03-30,Slovenia,2,39,730,"rgb(47, 138, 196)"
24269,2020-03-31,Slovenia,0,33,763,"rgb(47, 138, 196)"
24270,2020-04-01,Slovenia,2,51,814,"rgb(47, 138, 196)"
24271,2020-04-02,Slovenia,2,27,841,"rgb(47, 138, 196)"
24272,2020-04-03,Slovenia,1,56,897,"rgb(47, 138, 196)"
24273,2020-04-04,Slovenia,4,37,934,"rgb(47, 138, 196)"
24274,2020-04-05,Slovenia,2,43,977,"rgb(47, 138, 196)"
24275,2020-04-06,Slovenia,6,20,997,"rgb(47, 138, 196)"
24276,2020-04-07,Slovenia,2,24,1021,"rgb(47, 138, 196)"
24277,2020-04-08,Slovenia,6,34,1055,"rgb(47, 138, 196)"
24278,2020-04-09,Slovenia,4,36,1091,"rgb(47, 138, 196)"
24279,2020-04-10,Slovenia,3,33,1124,"rgb(47, 138, 196)"
24280,2020-04-11,Slovenia,2,36,1160,"rgb(47, 138, 196)"
24281,2020-04-12,Slovenia,5,28,1188,"rgb(47, 138, 196)"
24282,2020-04-13,Slovenia,3,17,1205,"rgb(47, 138, 196)"
24283,2020-04-14,Slovenia,2,7,1212,"rgb(47, 138, 196)"
24284,2020-04-15,Slovenia,1,8,1220,"rgb(47, 138, 196)"
24285,2020-04-16,Slovenia,5,28,1248,"rgb(47, 138, 196)"
24286,2020-04-17,Slovenia,0,20,1268,"rgb(47, 138, 196)"
24287,2020-04-18,Slovenia,5,36,1304,"rgb(47, 138, 196)"
24288,2020-04-19,Slovenia,4,13,1317,"rgb(47, 138, 196)"
24289,2020-04-20,Slovenia,4,13,1330,"rgb(47, 138, 196)"
24290,2020-04-21,Slovenia,0,5,1335,"rgb(47, 138, 196)"
24291,2020-04-22,Slovenia,3,5,1340,"rgb(47, 138, 196)"
24292,2020-04-23,Slovenia,2,13,1353,"rgb(47, 138, 196)"
24293,2020-04-24,Slovenia,0,13,1366,"rgb(47, 138, 196)"
24294,2020-04-25,Slovenia,1,7,1373,"rgb(47, 138, 196)"
24295,2020-04-26,Slovenia,1,15,1388,"rgb(47, 138, 196)"
24296,2020-04-27,Slovenia,1,19,1407,"rgb(47, 138, 196)"
24297,2020-04-28,Slovenia,1,0,1407,"rgb(47, 138, 196)"
24298,2020-04-29,Slovenia,3,1,1408,"rgb(47, 138, 196)"
24299,2020-04-30,Slovenia,3,10,1418,"rgb(47, 138, 196)"
24300,2020-05-01,Slovenia,2,11,1429,"rgb(47, 138, 196)"
24301,2020-05-02,Slovenia,2,5,1434,"rgb(47, 138, 196)"
24302,2020-05-03,Slovenia,1,5,1439,"rgb(47, 138, 196)"
24303,2020-05-04,Slovenia,2,0,1439,"rgb(47, 138, 196)"
24304,2020-05-05,Slovenia,1,6,1445,"rgb(47, 138, 196)"
24305,2020-05-06,Slovenia,1,3,1448,"rgb(47, 138, 196)"
24306,2020-05-07,Slovenia,1,1,1449,"rgb(47, 138, 196)"
24307,2020-05-08,Slovenia,0,1,1450,"rgb(47, 138, 196)"
24308,2020-05-09,Slovenia,1,4,1454,"rgb(47, 138, 196)"
24309,2020-05-10,Slovenia,1,3,1457,"rgb(47, 138, 196)"
24310,2020-05-11,Slovenia,1,3,1460,"rgb(47, 138, 196)"
24311,2020-05-12,Slovenia,0,1,1461,"rgb(47, 138, 196)"
24312,2020-05-13,Slovenia,0,2,1463,"rgb(47, 138, 196)"
24313,2020-05-14,Slovenia,1,1,1464,"rgb(47, 138, 196)"
24314,2020-05-15,Slovenia,0,1,1465,"rgb(47, 138, 196)"
24315,2020-05-16,Slovenia,0,0,1465,"rgb(47, 138, 196)"
24316,2020-05-17,Slovenia,0,1,1466,"rgb(47, 138, 196)"
24317,2020-05-18,Slovenia,1,0,1466,"rgb(47, 138, 196)"
24318,2020-05-19,Slovenia,0,1,1467,"rgb(47, 138, 196)"
24319,2020-05-20,Slovenia,0,1,1468,"rgb(47, 138, 196)"
24320,2020-05-21,Slovenia,2,0,1468,"rgb(47, 138, 196)"
24321,2020-05-22,Slovenia,0,0,1468,"rgb(47, 138, 196)"
24322,2020-05-23,Slovenia,0,0,1468,"rgb(47, 138, 196)"
24323,2020-05-24,Slovenia,0,0,1468,"rgb(47, 138, 196)"
24324,2020-05-25,Slovenia,0,1,1469,"rgb(47, 138, 196)"
24325,2020-05-26,Slovenia,0,0,1469,"rgb(47, 138, 196)"
24326,2020-05-27,Slovenia,0,0,1469,"rgb(47, 138, 196)"
24327,2020-05-28,Slovenia,1,2,1471,"rgb(47, 138, 196)"
24328,2020-05-29,Slovenia,1,2,1473,"rgb(47, 138, 196)"
24329,2020-05-30,Slovenia,0,0,1473,"rgb(47, 138, 196)"
24330,2020-05-31,Slovenia,0,0,1473,"rgb(47, 138, 196)"
24331,2020-06-01,Slovenia,0,0,1473,"rgb(47, 138, 196)"
24332,2020-06-02,Slovenia,0,2,1475,"rgb(47, 138, 196)"
24333,2020-06-03,Slovenia,0,0,1475,"rgb(47, 138, 196)"
24334,2020-06-04,Slovenia,0,2,1477,"rgb(47, 138, 196)"
24335,2020-06-05,Slovenia,0,2,1479,"rgb(47, 138, 196)"
24336,2020-06-06,Slovenia,0,5,1484,"rgb(47, 138, 196)"
24337,2020-06-07,Slovenia,0,1,1485,"rgb(47, 138, 196)"
24338,2020-06-08,Slovenia,0,0,1485,"rgb(47, 138, 196)"
24339,2020-06-09,Slovenia,0,0,1485,"rgb(47, 138, 196)"
24340,2020-06-10,Slovenia,0,1,1486,"rgb(47, 138, 196)"
24341,2020-06-11,Slovenia,1,2,1488,"rgb(47, 138, 196)"
24342,2020-06-12,Slovenia,0,0,1488,"rgb(47, 138, 196)"
24343,2020-06-13,Slovenia,0,2,1490,"rgb(47, 138, 196)"
24344,2020-06-14,Slovenia,0,2,1492,"rgb(47, 138, 196)"
24345,2020-06-15,Slovenia,0,3,1495,"rgb(47, 138, 196)"
24346,2020-06-16,Slovenia,0,1,1496,"rgb(47, 138, 196)"
24347,2020-06-17,Slovenia,0,3,1499,"rgb(47, 138, 196)"
24348,2020-06-18,Slovenia,0,4,1503,"rgb(47, 138, 196)"
24349,2020-06-19,Slovenia,0,8,1511,"rgb(47, 138, 196)"
24350,2020-06-20,Slovenia,0,2,1513,"rgb(47, 138, 196)"
24351,2020-06-21,Slovenia,0,6,1519,"rgb(47, 138, 196)"
24352,2020-06-22,Slovenia,0,1,1520,"rgb(47, 138, 196)"
24353,2020-06-23,Slovenia,0,1,1521,"rgb(47, 138, 196)"
24354,2020-06-24,Slovenia,2,13,1534,"rgb(47, 138, 196)"
24355,2020-06-25,Slovenia,0,7,1541,"rgb(47, 138, 196)"
24356,2020-06-26,Slovenia,0,6,1547,"rgb(47, 138, 196)"
24357,2020-06-27,Slovenia,0,11,1558,"rgb(47, 138, 196)"
24358,2020-06-28,Slovenia,0,14,1572,"rgb(47, 138, 196)"
24359,2020-06-29,Slovenia,0,9,1581,"rgb(47, 138, 196)"
24360,2020-06-30,Slovenia,0,4,1585,"rgb(47, 138, 196)"
24361,2020-07-01,Slovenia,0,15,1600,"rgb(47, 138, 196)"
24362,2020-07-02,Slovenia,0,13,1613,"rgb(47, 138, 196)"
24363,2020-07-03,Slovenia,0,20,1633,"rgb(47, 138, 196)"
24364,2020-07-04,Slovenia,0,16,1649,"rgb(47, 138, 196)"
24365,2020-07-05,Slovenia,0,30,1679,"rgb(47, 138, 196)"
24366,2020-07-06,Slovenia,0,21,1700,"rgb(47, 138, 196)"
24367,2020-07-07,Slovenia,0,16,1716,"rgb(47, 138, 196)"
24368,2020-07-08,Slovenia,0,23,1739,"rgb(47, 138, 196)"
24369,2020-07-09,Slovenia,0,24,1763,"rgb(47, 138, 196)"
24370,2020-07-10,Slovenia,0,13,1776,"rgb(47, 138, 196)"
24371,2020-07-11,Slovenia,0,17,1793,"rgb(47, 138, 196)"
24372,2020-07-12,Slovenia,0,34,1827,"rgb(47, 138, 196)"
24373,2020-07-13,Slovenia,0,14,1841,"rgb(47, 138, 196)"
24374,2020-03-07,Slovakia,0,1,1,"rgb(118, 78, 159)"
24375,2020-03-08,Slovakia,0,2,3,"rgb(118, 78, 159)"
24376,2020-03-09,Slovakia,0,2,5,"rgb(118, 78, 159)"
24377,2020-03-11,Slovakia,0,2,7,"rgb(118, 78, 159)"
24378,2020-03-12,Slovakia,0,3,10,"rgb(118, 78, 159)"
24379,2020-03-13,Slovakia,0,11,21,"rgb(118, 78, 159)"
24380,2020-03-14,Slovakia,0,9,30,"rgb(118, 78, 159)"
24381,2020-03-15,Slovakia,0,14,44,"rgb(118, 78, 159)"
24382,2020-03-16,Slovakia,0,17,61,"rgb(118, 78, 159)"
24383,2020-03-17,Slovakia,0,23,84,"rgb(118, 78, 159)"
24384,2020-03-18,Slovakia,0,13,97,"rgb(118, 78, 159)"
24385,2020-03-19,Slovakia,0,10,107,"rgb(118, 78, 159)"
24386,2020-03-20,Slovakia,0,16,123,"rgb(118, 78, 159)"
24387,2020-03-21,Slovakia,0,14,137,"rgb(118, 78, 159)"
24388,2020-03-22,Slovakia,0,41,178,"rgb(118, 78, 159)"
24389,2020-03-23,Slovakia,0,7,185,"rgb(118, 78, 159)"
24390,2020-03-24,Slovakia,0,6,191,"rgb(118, 78, 159)"
24391,2020-03-25,Slovakia,0,13,204,"rgb(118, 78, 159)"
24392,2020-03-26,Slovakia,0,12,216,"rgb(118, 78, 159)"
24393,2020-03-27,Slovakia,0,10,226,"rgb(118, 78, 159)"
24394,2020-03-28,Slovakia,0,69,295,"rgb(118, 78, 159)"
24395,2020-03-29,Slovakia,0,0,295,"rgb(118, 78, 159)"
24396,2020-03-30,Slovakia,0,41,336,"rgb(118, 78, 159)"
24397,2020-03-31,Slovakia,0,0,336,"rgb(118, 78, 159)"
24398,2020-04-01,Slovakia,0,27,363,"rgb(118, 78, 159)"
24399,2020-04-02,Slovakia,0,37,400,"rgb(118, 78, 159)"
24400,2020-04-03,Slovakia,0,26,426,"rgb(118, 78, 159)"
24401,2020-04-04,Slovakia,0,24,450,"rgb(118, 78, 159)"
24402,2020-04-05,Slovakia,0,21,471,"rgb(118, 78, 159)"
24403,2020-04-06,Slovakia,0,14,485,"rgb(118, 78, 159)"
24404,2020-04-07,Slovakia,2,49,534,"rgb(118, 78, 159)"
24405,2020-04-08,Slovakia,0,47,581,"rgb(118, 78, 159)"
24406,2020-04-09,Slovakia,0,101,682,"rgb(118, 78, 159)"
24407,2020-04-10,Slovakia,0,19,701,"rgb(118, 78, 159)"
24408,2020-04-11,Slovakia,0,14,715,"rgb(118, 78, 159)"
24409,2020-04-12,Slovakia,0,13,728,"rgb(118, 78, 159)"
24410,2020-04-13,Slovakia,0,14,742,"rgb(118, 78, 159)"
24411,2020-04-14,Slovakia,0,27,769,"rgb(118, 78, 159)"
24412,2020-04-15,Slovakia,0,66,835,"rgb(118, 78, 159)"
24413,2020-04-16,Slovakia,4,28,863,"rgb(118, 78, 159)"
24414,2020-04-17,Slovakia,2,114,977,"rgb(118, 78, 159)"
24415,2020-04-18,Slovakia,1,72,1049,"rgb(118, 78, 159)"
24416,2020-04-19,Slovakia,2,40,1089,"rgb(118, 78, 159)"
24417,2020-04-20,Slovakia,1,72,1161,"rgb(118, 78, 159)"
24418,2020-04-21,Slovakia,1,12,1173,"rgb(118, 78, 159)"
24419,2020-04-22,Slovakia,1,26,1199,"rgb(118, 78, 159)"
24420,2020-04-23,Slovakia,0,45,1244,"rgb(118, 78, 159)"
24421,2020-04-24,Slovakia,1,81,1325,"rgb(118, 78, 159)"
24422,2020-04-25,Slovakia,2,35,1360,"rgb(118, 78, 159)"
24423,2020-04-26,Slovakia,0,13,1373,"rgb(118, 78, 159)"
24424,2020-04-27,Slovakia,1,6,1379,"rgb(118, 78, 159)"
24425,2020-04-28,Slovakia,0,2,1381,"rgb(118, 78, 159)"
24426,2020-04-29,Slovakia,2,3,1384,"rgb(118, 78, 159)"
24427,2020-04-30,Slovakia,2,7,1391,"rgb(118, 78, 159)"
24428,2020-05-01,Slovakia,1,5,1396,"rgb(118, 78, 159)"
24429,2020-05-02,Slovakia,0,7,1403,"rgb(118, 78, 159)"
24430,2020-05-03,Slovakia,1,4,1407,"rgb(118, 78, 159)"
24431,2020-05-04,Slovakia,0,1,1408,"rgb(118, 78, 159)"
24432,2020-05-05,Slovakia,1,5,1413,"rgb(118, 78, 159)"
24433,2020-05-06,Slovakia,0,8,1421,"rgb(118, 78, 159)"
24434,2020-05-07,Slovakia,0,8,1429,"rgb(118, 78, 159)"
24435,2020-05-08,Slovakia,1,16,1445,"rgb(118, 78, 159)"
24436,2020-05-09,Slovakia,0,10,1455,"rgb(118, 78, 159)"
24437,2020-05-10,Slovakia,0,0,1455,"rgb(118, 78, 159)"
24438,2020-05-11,Slovakia,0,2,1457,"rgb(118, 78, 159)"
24439,2020-05-12,Slovakia,0,0,1457,"rgb(118, 78, 159)"
24440,2020-05-13,Slovakia,1,8,1465,"rgb(118, 78, 159)"
24441,2020-05-14,Slovakia,0,4,1469,"rgb(118, 78, 159)"
24442,2020-05-15,Slovakia,0,8,1477,"rgb(118, 78, 159)"
24443,2020-05-16,Slovakia,0,3,1480,"rgb(118, 78, 159)"
24444,2020-05-17,Slovakia,1,13,1493,"rgb(118, 78, 159)"
24445,2020-05-18,Slovakia,0,1,1494,"rgb(118, 78, 159)"
24446,2020-05-19,Slovakia,0,1,1495,"rgb(118, 78, 159)"
24447,2020-05-20,Slovakia,0,0,1495,"rgb(118, 78, 159)"
24448,2020-05-21,Slovakia,0,1,1496,"rgb(118, 78, 159)"
24449,2020-05-22,Slovakia,0,6,1502,"rgb(118, 78, 159)"
24450,2020-05-23,Slovakia,0,1,1503,"rgb(118, 78, 159)"
24451,2020-05-24,Slovakia,0,1,1504,"rgb(118, 78, 159)"
24452,2020-05-25,Slovakia,0,5,1509,"rgb(118, 78, 159)"
24453,2020-05-26,Slovakia,0,2,1511,"rgb(118, 78, 159)"
24454,2020-05-27,Slovakia,0,2,1513,"rgb(118, 78, 159)"
24455,2020-05-28,Slovakia,0,2,1515,"rgb(118, 78, 159)"
24456,2020-05-29,Slovakia,0,5,1520,"rgb(118, 78, 159)"
24457,2020-05-30,Slovakia,0,0,1520,"rgb(118, 78, 159)"
24458,2020-05-31,Slovakia,0,1,1521,"rgb(118, 78, 159)"
24459,2020-06-01,Slovakia,0,1,1522,"rgb(118, 78, 159)"
24460,2020-06-02,Slovakia,0,0,1522,"rgb(118, 78, 159)"
24461,2020-06-03,Slovakia,0,0,1522,"rgb(118, 78, 159)"
24462,2020-06-04,Slovakia,0,3,1525,"rgb(118, 78, 159)"
24463,2020-06-05,Slovakia,0,1,1526,"rgb(118, 78, 159)"
24464,2020-06-06,Slovakia,0,0,1526,"rgb(118, 78, 159)"
24465,2020-06-07,Slovakia,0,2,1528,"rgb(118, 78, 159)"
24466,2020-06-08,Slovakia,0,0,1528,"rgb(118, 78, 159)"
24467,2020-06-09,Slovakia,0,2,1530,"rgb(118, 78, 159)"
24468,2020-06-10,Slovakia,0,1,1531,"rgb(118, 78, 159)"
24469,2020-06-11,Slovakia,0,2,1533,"rgb(118, 78, 159)"
24470,2020-06-12,Slovakia,0,8,1541,"rgb(118, 78, 159)"
24471,2020-06-13,Slovakia,0,1,1542,"rgb(118, 78, 159)"
24472,2020-06-14,Slovakia,0,3,1545,"rgb(118, 78, 159)"
24473,2020-06-15,Slovakia,0,3,1548,"rgb(118, 78, 159)"
24474,2020-06-16,Slovakia,0,4,1552,"rgb(118, 78, 159)"
24475,2020-06-17,Slovakia,0,0,1552,"rgb(118, 78, 159)"
24476,2020-06-18,Slovakia,0,9,1561,"rgb(118, 78, 159)"
24477,2020-06-19,Slovakia,0,1,1562,"rgb(118, 78, 159)"
24478,2020-06-20,Slovakia,0,14,1576,"rgb(118, 78, 159)"
24479,2020-06-21,Slovakia,0,10,1586,"rgb(118, 78, 159)"
24480,2020-06-22,Slovakia,0,1,1587,"rgb(118, 78, 159)"
24481,2020-06-23,Slovakia,0,1,1588,"rgb(118, 78, 159)"
24482,2020-06-24,Slovakia,0,1,1589,"rgb(118, 78, 159)"
24483,2020-06-25,Slovakia,0,18,1607,"rgb(118, 78, 159)"
24484,2020-06-26,Slovakia,0,23,1630,"rgb(118, 78, 159)"
24485,2020-06-27,Slovakia,0,13,1643,"rgb(118, 78, 159)"
24486,2020-06-28,Slovakia,0,14,1657,"rgb(118, 78, 159)"
24487,2020-06-29,Slovakia,0,7,1664,"rgb(118, 78, 159)"
24488,2020-06-30,Slovakia,0,1,1665,"rgb(118, 78, 159)"
24489,2020-07-01,Slovakia,0,2,1667,"rgb(118, 78, 159)"
24490,2020-07-02,Slovakia,0,20,1687,"rgb(118, 78, 159)"
24491,2020-07-03,Slovakia,0,13,1700,"rgb(118, 78, 159)"
24492,2020-07-04,Slovakia,0,20,1720,"rgb(118, 78, 159)"
24493,2020-07-05,Slovakia,0,29,1749,"rgb(118, 78, 159)"
24494,2020-07-06,Slovakia,0,15,1764,"rgb(118, 78, 159)"
24495,2020-07-07,Slovakia,0,1,1765,"rgb(118, 78, 159)"
24496,2020-07-08,Slovakia,0,2,1767,"rgb(118, 78, 159)"
24497,2020-07-09,Slovakia,0,31,1798,"rgb(118, 78, 159)"
24498,2020-07-10,Slovakia,0,53,1851,"rgb(118, 78, 159)"
24499,2020-07-11,Slovakia,0,19,1870,"rgb(118, 78, 159)"
24500,2020-07-12,Slovakia,0,23,1893,"rgb(118, 78, 159)"
24501,2020-07-13,Slovakia,0,8,1901,"rgb(118, 78, 159)"
24502,2020-04-01,Sierra Leone,0,1,1,"rgb(237, 100, 90)"
24503,2020-04-02,Sierra Leone,0,0,1,"rgb(237, 100, 90)"
24504,2020-04-03,Sierra Leone,0,1,2,"rgb(237, 100, 90)"
24505,2020-04-04,Sierra Leone,0,0,2,"rgb(237, 100, 90)"
24506,2020-04-05,Sierra Leone,0,2,4,"rgb(237, 100, 90)"
24507,2020-04-06,Sierra Leone,0,2,6,"rgb(237, 100, 90)"
24508,2020-04-07,Sierra Leone,0,0,6,"rgb(237, 100, 90)"
24509,2020-04-08,Sierra Leone,0,0,6,"rgb(237, 100, 90)"
24510,2020-04-09,Sierra Leone,0,1,7,"rgb(237, 100, 90)"
24511,2020-04-10,Sierra Leone,0,0,7,"rgb(237, 100, 90)"
24512,2020-04-11,Sierra Leone,0,1,8,"rgb(237, 100, 90)"
24513,2020-04-12,Sierra Leone,0,2,10,"rgb(237, 100, 90)"
24514,2020-04-13,Sierra Leone,0,0,10,"rgb(237, 100, 90)"
24515,2020-04-14,Sierra Leone,0,1,11,"rgb(237, 100, 90)"
24516,2020-04-15,Sierra Leone,0,0,11,"rgb(237, 100, 90)"
24517,2020-04-16,Sierra Leone,0,2,13,"rgb(237, 100, 90)"
24518,2020-04-17,Sierra Leone,0,2,15,"rgb(237, 100, 90)"
24519,2020-04-18,Sierra Leone,0,11,26,"rgb(237, 100, 90)"
24520,2020-04-19,Sierra Leone,0,4,30,"rgb(237, 100, 90)"
24521,2020-04-20,Sierra Leone,0,5,35,"rgb(237, 100, 90)"
24522,2020-04-21,Sierra Leone,0,8,43,"rgb(237, 100, 90)"
24523,2020-04-22,Sierra Leone,0,7,50,"rgb(237, 100, 90)"
24524,2020-04-23,Sierra Leone,0,11,61,"rgb(237, 100, 90)"
24525,2020-04-24,Sierra Leone,1,3,64,"rgb(237, 100, 90)"
24526,2020-04-25,Sierra Leone,2,18,82,"rgb(237, 100, 90)"
24527,2020-04-26,Sierra Leone,0,0,82,"rgb(237, 100, 90)"
24528,2020-04-27,Sierra Leone,1,11,93,"rgb(237, 100, 90)"
24529,2020-04-28,Sierra Leone,0,6,99,"rgb(237, 100, 90)"
24530,2020-04-29,Sierra Leone,0,5,104,"rgb(237, 100, 90)"
24531,2020-04-30,Sierra Leone,0,12,116,"rgb(237, 100, 90)"
24532,2020-05-01,Sierra Leone,3,8,124,"rgb(237, 100, 90)"
24533,2020-05-02,Sierra Leone,0,12,136,"rgb(237, 100, 90)"
24534,2020-05-03,Sierra Leone,1,19,155,"rgb(237, 100, 90)"
24535,2020-05-04,Sierra Leone,0,2,157,"rgb(237, 100, 90)"
24536,2020-05-05,Sierra Leone,1,21,178,"rgb(237, 100, 90)"
24537,2020-05-06,Sierra Leone,2,21,199,"rgb(237, 100, 90)"
24538,2020-05-07,Sierra Leone,3,26,225,"rgb(237, 100, 90)"
24539,2020-05-08,Sierra Leone,2,6,231,"rgb(237, 100, 90)"
24540,2020-05-09,Sierra Leone,1,26,257,"rgb(237, 100, 90)"
24541,2020-05-10,Sierra Leone,1,34,291,"rgb(237, 100, 90)"
24542,2020-05-11,Sierra Leone,0,16,307,"rgb(237, 100, 90)"
24543,2020-05-12,Sierra Leone,1,31,338,"rgb(237, 100, 90)"
24544,2020-05-13,Sierra Leone,1,0,338,"rgb(237, 100, 90)"
24545,2020-05-14,Sierra Leone,1,49,387,"rgb(237, 100, 90)"
24546,2020-05-15,Sierra Leone,5,21,408,"rgb(237, 100, 90)"
24547,2020-05-16,Sierra Leone,1,39,447,"rgb(237, 100, 90)"
24548,2020-05-17,Sierra Leone,2,15,462,"rgb(237, 100, 90)"
24549,2020-05-18,Sierra Leone,3,43,505,"rgb(237, 100, 90)"
24550,2020-05-19,Sierra Leone,1,14,519,"rgb(237, 100, 90)"
24551,2020-05-20,Sierra Leone,0,15,534,"rgb(237, 100, 90)"
24552,2020-05-21,Sierra Leone,1,36,570,"rgb(237, 100, 90)"
24553,2020-05-22,Sierra Leone,1,15,585,"rgb(237, 100, 90)"
24554,2020-05-23,Sierra Leone,3,21,606,"rgb(237, 100, 90)"
24555,2020-05-24,Sierra Leone,1,15,621,"rgb(237, 100, 90)"
24556,2020-05-25,Sierra Leone,1,86,707,"rgb(237, 100, 90)"
24557,2020-05-26,Sierra Leone,2,28,735,"rgb(237, 100, 90)"
24558,2020-05-27,Sierra Leone,2,19,754,"rgb(237, 100, 90)"
24559,2020-05-28,Sierra Leone,1,28,782,"rgb(237, 100, 90)"
24560,2020-05-29,Sierra Leone,0,30,812,"rgb(237, 100, 90)"
24561,2020-05-30,Sierra Leone,0,17,829,"rgb(237, 100, 90)"
24562,2020-05-31,Sierra Leone,1,23,852,"rgb(237, 100, 90)"
24563,2020-06-01,Sierra Leone,0,9,861,"rgb(237, 100, 90)"
24564,2020-06-02,Sierra Leone,0,0,861,"rgb(237, 100, 90)"
24565,2020-06-03,Sierra Leone,0,35,896,"rgb(237, 100, 90)"
24566,2020-06-04,Sierra Leone,1,13,909,"rgb(237, 100, 90)"
24567,2020-06-05,Sierra Leone,0,5,914,"rgb(237, 100, 90)"
24568,2020-06-06,Sierra Leone,0,15,929,"rgb(237, 100, 90)"
24569,2020-06-07,Sierra Leone,1,17,946,"rgb(237, 100, 90)"
24570,2020-06-08,Sierra Leone,0,23,969,"rgb(237, 100, 90)"
24571,2020-06-09,Sierra Leone,1,32,1001,"rgb(237, 100, 90)"
24572,2020-06-10,Sierra Leone,1,24,1025,"rgb(237, 100, 90)"
24573,2020-06-11,Sierra Leone,0,37,1062,"rgb(237, 100, 90)"
24574,2020-06-12,Sierra Leone,0,23,1085,"rgb(237, 100, 90)"
24575,2020-06-13,Sierra Leone,1,18,1103,"rgb(237, 100, 90)"
24576,2020-06-14,Sierra Leone,0,29,1132,"rgb(237, 100, 90)"
24577,2020-06-15,Sierra Leone,0,37,1169,"rgb(237, 100, 90)"
24578,2020-06-16,Sierra Leone,0,7,1176,"rgb(237, 100, 90)"
24579,2020-06-17,Sierra Leone,0,49,1225,"rgb(237, 100, 90)"
24580,2020-06-18,Sierra Leone,0,24,1249,"rgb(237, 100, 90)"
24581,2020-06-19,Sierra Leone,0,23,1272,"rgb(237, 100, 90)"
24582,2020-06-20,Sierra Leone,2,26,1298,"rgb(237, 100, 90)"
24583,2020-06-21,Sierra Leone,0,11,1309,"rgb(237, 100, 90)"
24584,2020-06-22,Sierra Leone,2,18,1327,"rgb(237, 100, 90)"
24585,2020-06-23,Sierra Leone,0,13,1340,"rgb(237, 100, 90)"
24586,2020-06-24,Sierra Leone,0,7,1347,"rgb(237, 100, 90)"
24587,2020-06-25,Sierra Leone,1,7,1354,"rgb(237, 100, 90)"
24588,2020-06-26,Sierra Leone,0,27,1381,"rgb(237, 100, 90)"
24589,2020-06-27,Sierra Leone,3,13,1394,"rgb(237, 100, 90)"
24590,2020-06-28,Sierra Leone,0,16,1410,"rgb(237, 100, 90)"
24591,2020-06-29,Sierra Leone,1,17,1427,"rgb(237, 100, 90)"
24592,2020-06-30,Sierra Leone,0,23,1450,"rgb(237, 100, 90)"
24593,2020-07-01,Sierra Leone,0,12,1462,"rgb(237, 100, 90)"
24594,2020-07-02,Sierra Leone,0,36,1498,"rgb(237, 100, 90)"
24595,2020-07-03,Sierra Leone,0,20,1518,"rgb(237, 100, 90)"
24596,2020-07-04,Sierra Leone,2,6,1524,"rgb(237, 100, 90)"
24597,2020-07-05,Sierra Leone,0,9,1533,"rgb(237, 100, 90)"
24598,2020-07-06,Sierra Leone,0,9,1542,"rgb(237, 100, 90)"
24599,2020-07-07,Sierra Leone,0,0,1542,"rgb(237, 100, 90)"
24600,2020-07-08,Sierra Leone,1,30,1572,"rgb(237, 100, 90)"
24601,2020-07-09,Sierra Leone,0,12,1584,"rgb(237, 100, 90)"
24602,2020-07-10,Sierra Leone,0,14,1598,"rgb(237, 100, 90)"
24603,2020-07-11,Sierra Leone,0,15,1613,"rgb(237, 100, 90)"
24604,2020-07-12,Sierra Leone,0,5,1618,"rgb(237, 100, 90)"
24605,2020-07-13,Sierra Leone,0,17,1635,"rgb(237, 100, 90)"
24606,2019-12-31,San Marino,0,0,0,"rgb(165, 170, 153)"
24607,2020-01-01,San Marino,0,0,0,"rgb(165, 170, 153)"
24608,2020-01-02,San Marino,0,0,0,"rgb(165, 170, 153)"
24609,2020-01-03,San Marino,0,0,0,"rgb(165, 170, 153)"
24610,2020-01-04,San Marino,0,0,0,"rgb(165, 170, 153)"
24611,2020-01-05,San Marino,0,0,0,"rgb(165, 170, 153)"
24612,2020-01-06,San Marino,0,0,0,"rgb(165, 170, 153)"
24613,2020-01-07,San Marino,0,0,0,"rgb(165, 170, 153)"
24614,2020-01-08,San Marino,0,0,0,"rgb(165, 170, 153)"
24615,2020-01-09,San Marino,0,0,0,"rgb(165, 170, 153)"
24616,2020-01-10,San Marino,0,0,0,"rgb(165, 170, 153)"
24617,2020-01-11,San Marino,0,0,0,"rgb(165, 170, 153)"
24618,2020-01-12,San Marino,0,0,0,"rgb(165, 170, 153)"
24619,2020-01-13,San Marino,0,0,0,"rgb(165, 170, 153)"
24620,2020-01-14,San Marino,0,0,0,"rgb(165, 170, 153)"
24621,2020-01-15,San Marino,0,0,0,"rgb(165, 170, 153)"
24622,2020-01-16,San Marino,0,0,0,"rgb(165, 170, 153)"
24623,2020-01-17,San Marino,0,0,0,"rgb(165, 170, 153)"
24624,2020-01-18,San Marino,0,0,0,"rgb(165, 170, 153)"
24625,2020-01-19,San Marino,0,0,0,"rgb(165, 170, 153)"
24626,2020-01-20,San Marino,0,0,0,"rgb(165, 170, 153)"
24627,2020-01-21,San Marino,0,0,0,"rgb(165, 170, 153)"
24628,2020-01-22,San Marino,0,0,0,"rgb(165, 170, 153)"
24629,2020-01-23,San Marino,0,0,0,"rgb(165, 170, 153)"
24630,2020-01-24,San Marino,0,0,0,"rgb(165, 170, 153)"
24631,2020-01-25,San Marino,0,0,0,"rgb(165, 170, 153)"
24632,2020-01-26,San Marino,0,0,0,"rgb(165, 170, 153)"
24633,2020-01-27,San Marino,0,0,0,"rgb(165, 170, 153)"
24634,2020-01-28,San Marino,0,0,0,"rgb(165, 170, 153)"
24635,2020-01-29,San Marino,0,0,0,"rgb(165, 170, 153)"
24636,2020-01-30,San Marino,0,0,0,"rgb(165, 170, 153)"
24637,2020-01-31,San Marino,0,0,0,"rgb(165, 170, 153)"
24638,2020-02-01,San Marino,0,0,0,"rgb(165, 170, 153)"
24639,2020-02-02,San Marino,0,0,0,"rgb(165, 170, 153)"
24640,2020-02-03,San Marino,0,0,0,"rgb(165, 170, 153)"
24641,2020-02-04,San Marino,0,0,0,"rgb(165, 170, 153)"
24642,2020-02-05,San Marino,0,0,0,"rgb(165, 170, 153)"
24643,2020-02-06,San Marino,0,0,0,"rgb(165, 170, 153)"
24644,2020-02-07,San Marino,0,0,0,"rgb(165, 170, 153)"
24645,2020-02-08,San Marino,0,0,0,"rgb(165, 170, 153)"
24646,2020-02-09,San Marino,0,0,0,"rgb(165, 170, 153)"
24647,2020-02-10,San Marino,0,0,0,"rgb(165, 170, 153)"
24648,2020-02-11,San Marino,0,0,0,"rgb(165, 170, 153)"
24649,2020-02-12,San Marino,0,0,0,"rgb(165, 170, 153)"
24650,2020-02-13,San Marino,0,0,0,"rgb(165, 170, 153)"
24651,2020-02-14,San Marino,0,0,0,"rgb(165, 170, 153)"
24652,2020-02-15,San Marino,0,0,0,"rgb(165, 170, 153)"
24653,2020-02-16,San Marino,0,0,0,"rgb(165, 170, 153)"
24654,2020-02-17,San Marino,0,0,0,"rgb(165, 170, 153)"
24655,2020-02-18,San Marino,0,0,0,"rgb(165, 170, 153)"
24656,2020-02-19,San Marino,0,0,0,"rgb(165, 170, 153)"
24657,2020-02-20,San Marino,0,0,0,"rgb(165, 170, 153)"
24658,2020-02-21,San Marino,0,0,0,"rgb(165, 170, 153)"
24659,2020-02-22,San Marino,0,0,0,"rgb(165, 170, 153)"
24660,2020-02-23,San Marino,0,0,0,"rgb(165, 170, 153)"
24661,2020-02-24,San Marino,0,0,0,"rgb(165, 170, 153)"
24662,2020-02-25,San Marino,0,0,0,"rgb(165, 170, 153)"
24663,2020-02-26,San Marino,0,0,0,"rgb(165, 170, 153)"
24664,2020-02-27,San Marino,0,0,0,"rgb(165, 170, 153)"
24665,2020-02-28,San Marino,0,1,1,"rgb(165, 170, 153)"
24666,2020-02-29,San Marino,0,0,1,"rgb(165, 170, 153)"
24667,2020-03-01,San Marino,0,0,1,"rgb(165, 170, 153)"
24668,2020-03-02,San Marino,1,7,8,"rgb(165, 170, 153)"
24669,2020-03-04,San Marino,0,2,10,"rgb(165, 170, 153)"
24670,2020-03-05,San Marino,0,5,15,"rgb(165, 170, 153)"
24671,2020-03-06,San Marino,0,7,22,"rgb(165, 170, 153)"
24672,2020-03-07,San Marino,0,1,23,"rgb(165, 170, 153)"
24673,2020-03-08,San Marino,0,3,26,"rgb(165, 170, 153)"
24674,2020-03-09,San Marino,0,11,37,"rgb(165, 170, 153)"
24675,2020-03-10,San Marino,1,12,49,"rgb(165, 170, 153)"
24676,2020-03-11,San Marino,0,13,62,"rgb(165, 170, 153)"
24677,2020-03-12,San Marino,1,4,66,"rgb(165, 170, 153)"
24678,2020-03-13,San Marino,2,1,67,"rgb(165, 170, 153)"
24679,2020-03-14,San Marino,0,6,73,"rgb(165, 170, 153)"
24680,2020-03-15,San Marino,0,19,92,"rgb(165, 170, 153)"
24681,2020-03-16,San Marino,2,6,98,"rgb(165, 170, 153)"
24682,2020-03-17,San Marino,2,4,102,"rgb(165, 170, 153)"
24683,2020-03-18,San Marino,2,2,104,"rgb(165, 170, 153)"
24684,2020-03-19,San Marino,3,5,109,"rgb(165, 170, 153)"
24685,2020-03-20,San Marino,0,17,126,"rgb(165, 170, 153)"
24686,2020-03-21,San Marino,0,25,151,"rgb(165, 170, 153)"
24687,2020-03-22,San Marino,6,0,151,"rgb(165, 170, 153)"
24688,2020-03-23,San Marino,0,0,151,"rgb(165, 170, 153)"
24689,2020-03-24,San Marino,0,36,187,"rgb(165, 170, 153)"
24690,2020-03-25,San Marino,1,0,187,"rgb(165, 170, 153)"
24691,2020-03-26,San Marino,0,21,208,"rgb(165, 170, 153)"
24692,2020-03-27,San Marino,0,10,218,"rgb(165, 170, 153)"
24693,2020-03-28,San Marino,0,5,223,"rgb(165, 170, 153)"
24694,2020-03-29,San Marino,1,1,224,"rgb(165, 170, 153)"
24695,2020-03-30,San Marino,2,5,229,"rgb(165, 170, 153)"
24696,2020-03-31,San Marino,1,0,229,"rgb(165, 170, 153)"
24697,2020-04-01,San Marino,1,1,230,"rgb(165, 170, 153)"
24698,2020-04-02,San Marino,0,6,236,"rgb(165, 170, 153)"
24699,2020-04-03,San Marino,4,9,245,"rgb(165, 170, 153)"
24700,2020-04-04,San Marino,2,6,251,"rgb(165, 170, 153)"
24701,2020-04-05,San Marino,0,8,259,"rgb(165, 170, 153)"
24702,2020-04-06,San Marino,0,7,266,"rgb(165, 170, 153)"
24703,2020-04-07,San Marino,0,11,277,"rgb(165, 170, 153)"
24704,2020-04-08,San Marino,2,2,279,"rgb(165, 170, 153)"
24705,2020-04-09,San Marino,0,29,308,"rgb(165, 170, 153)"
24706,2020-04-10,San Marino,0,25,333,"rgb(165, 170, 153)"
24707,2020-04-11,San Marino,0,11,344,"rgb(165, 170, 153)"
24708,2020-04-12,San Marino,1,12,356,"rgb(165, 170, 153)"
24709,2020-04-13,San Marino,0,0,356,"rgb(165, 170, 153)"
24710,2020-04-14,San Marino,1,0,356,"rgb(165, 170, 153)"
24711,2020-04-15,San Marino,0,16,372,"rgb(165, 170, 153)"
24712,2020-04-16,San Marino,0,20,392,"rgb(165, 170, 153)"
24713,2020-04-17,San Marino,2,34,426,"rgb(165, 170, 153)"
24714,2020-04-18,San Marino,1,9,435,"rgb(165, 170, 153)"
24715,2020-04-19,San Marino,0,20,455,"rgb(165, 170, 153)"
24716,2020-04-20,San Marino,0,6,461,"rgb(165, 170, 153)"
24717,2020-04-21,San Marino,0,1,462,"rgb(165, 170, 153)"
24718,2020-04-22,San Marino,1,14,476,"rgb(165, 170, 153)"
24719,2020-04-23,San Marino,0,12,488,"rgb(165, 170, 153)"
24720,2020-04-24,San Marino,0,13,501,"rgb(165, 170, 153)"
24721,2020-04-25,San Marino,0,12,513,"rgb(165, 170, 153)"
24722,2020-04-26,San Marino,0,0,513,"rgb(165, 170, 153)"
24723,2020-04-27,San Marino,1,25,538,"rgb(165, 170, 153)"
24724,2020-04-28,San Marino,0,0,538,"rgb(165, 170, 153)"
24725,2020-04-29,San Marino,0,15,553,"rgb(165, 170, 153)"
24726,2020-04-30,San Marino,0,10,563,"rgb(165, 170, 153)"
24727,2020-05-01,San Marino,0,6,569,"rgb(165, 170, 153)"
24728,2020-05-02,San Marino,0,11,580,"rgb(165, 170, 153)"
24729,2020-05-03,San Marino,0,0,580,"rgb(165, 170, 153)"
24730,2020-05-04,San Marino,0,2,582,"rgb(165, 170, 153)"
24731,2020-05-05,San Marino,0,0,582,"rgb(165, 170, 153)"
24732,2020-05-06,San Marino,0,7,589,"rgb(165, 170, 153)"
24733,2020-05-07,San Marino,0,19,608,"rgb(165, 170, 153)"
24734,2020-05-08,San Marino,0,14,622,"rgb(165, 170, 153)"
24735,2020-05-09,San Marino,0,1,623,"rgb(165, 170, 153)"
24736,2020-05-10,San Marino,0,14,637,"rgb(165, 170, 153)"
24737,2020-05-11,San Marino,0,-9,628,"rgb(165, 170, 153)"
24738,2020-05-12,San Marino,0,0,628,"rgb(165, 170, 153)"
24739,2020-05-13,San Marino,0,10,638,"rgb(165, 170, 153)"
24740,2020-05-14,San Marino,0,5,643,"rgb(165, 170, 153)"
24741,2020-05-15,San Marino,0,5,648,"rgb(165, 170, 153)"
24742,2020-05-16,San Marino,0,4,652,"rgb(165, 170, 153)"
24743,2020-05-17,San Marino,0,1,653,"rgb(165, 170, 153)"
24744,2020-05-18,San Marino,0,1,654,"rgb(165, 170, 153)"
24745,2020-05-19,San Marino,0,0,654,"rgb(165, 170, 153)"
24746,2020-05-20,San Marino,0,1,655,"rgb(165, 170, 153)"
24747,2020-05-21,San Marino,0,1,656,"rgb(165, 170, 153)"
24748,2020-05-22,San Marino,0,2,658,"rgb(165, 170, 153)"
24749,2020-05-23,San Marino,0,3,661,"rgb(165, 170, 153)"
24750,2020-05-24,San Marino,1,4,665,"rgb(165, 170, 153)"
24751,2020-05-25,San Marino,0,0,665,"rgb(165, 170, 153)"
24752,2020-05-26,San Marino,0,1,666,"rgb(165, 170, 153)"
24753,2020-05-27,San Marino,0,0,666,"rgb(165, 170, 153)"
24754,2020-05-28,San Marino,0,1,667,"rgb(165, 170, 153)"
24755,2020-05-29,San Marino,0,3,670,"rgb(165, 170, 153)"
24756,2020-05-30,San Marino,0,1,671,"rgb(165, 170, 153)"
24757,2020-05-31,San Marino,0,0,671,"rgb(165, 170, 153)"
24758,2020-06-01,San Marino,0,0,671,"rgb(165, 170, 153)"
24759,2020-06-02,San Marino,0,16,687,"rgb(165, 170, 153)"
24760,2020-06-03,San Marino,0,0,687,"rgb(165, 170, 153)"
24761,2020-06-04,San Marino,0,0,687,"rgb(165, 170, 153)"
24762,2020-06-05,San Marino,0,0,687,"rgb(165, 170, 153)"
24763,2020-06-06,San Marino,0,0,687,"rgb(165, 170, 153)"
24764,2020-06-07,San Marino,0,0,687,"rgb(165, 170, 153)"
24765,2020-06-08,San Marino,0,0,687,"rgb(165, 170, 153)"
24766,2020-06-09,San Marino,0,0,687,"rgb(165, 170, 153)"
24767,2020-06-10,San Marino,0,1,688,"rgb(165, 170, 153)"
24768,2020-06-11,San Marino,0,3,691,"rgb(165, 170, 153)"
24769,2020-06-12,San Marino,0,0,691,"rgb(165, 170, 153)"
24770,2020-06-13,San Marino,0,3,694,"rgb(165, 170, 153)"
24771,2020-06-14,San Marino,0,0,694,"rgb(165, 170, 153)"
24772,2020-06-15,San Marino,0,0,694,"rgb(165, 170, 153)"
24773,2020-06-16,San Marino,0,0,694,"rgb(165, 170, 153)"
24774,2020-06-17,San Marino,0,0,694,"rgb(165, 170, 153)"
24775,2020-06-18,San Marino,0,2,696,"rgb(165, 170, 153)"
24776,2020-06-19,San Marino,0,0,696,"rgb(165, 170, 153)"
24777,2020-06-20,San Marino,0,0,696,"rgb(165, 170, 153)"
24778,2020-06-21,San Marino,0,0,696,"rgb(165, 170, 153)"
24779,2020-06-22,San Marino,0,0,696,"rgb(165, 170, 153)"
24780,2020-06-23,San Marino,0,2,698,"rgb(165, 170, 153)"
24781,2020-06-24,San Marino,0,0,698,"rgb(165, 170, 153)"
24782,2020-06-25,San Marino,0,0,698,"rgb(165, 170, 153)"
24783,2020-06-26,San Marino,0,0,698,"rgb(165, 170, 153)"
24784,2020-06-27,San Marino,0,0,698,"rgb(165, 170, 153)"
24785,2020-06-28,San Marino,0,0,698,"rgb(165, 170, 153)"
24786,2020-06-29,San Marino,0,0,698,"rgb(165, 170, 153)"
24787,2020-06-30,San Marino,0,0,698,"rgb(165, 170, 153)"
24788,2020-07-01,San Marino,0,0,698,"rgb(165, 170, 153)"
24789,2020-07-02,San Marino,0,0,698,"rgb(165, 170, 153)"
24790,2020-07-03,San Marino,0,0,698,"rgb(165, 170, 153)"
24791,2020-07-04,San Marino,0,15,713,"rgb(165, 170, 153)"
24792,2020-07-05,San Marino,0,0,713,"rgb(165, 170, 153)"
24793,2020-07-06,San Marino,0,0,713,"rgb(165, 170, 153)"
24794,2020-07-07,San Marino,0,0,713,"rgb(165, 170, 153)"
24795,2020-07-08,San Marino,0,0,713,"rgb(165, 170, 153)"
24796,2020-07-09,San Marino,0,0,713,"rgb(165, 170, 153)"
24797,2020-07-10,San Marino,0,1,714,"rgb(165, 170, 153)"
24798,2020-07-11,San Marino,0,0,714,"rgb(165, 170, 153)"
24799,2020-07-12,San Marino,0,0,714,"rgb(165, 170, 153)"
24800,2020-07-13,San Marino,0,0,714,"rgb(165, 170, 153)"
24801,2020-03-03,Senegal,0,1,1,"rgb(27,158,119)"
24802,2020-03-05,Senegal,0,2,3,"rgb(27,158,119)"
24803,2020-03-06,Senegal,0,1,4,"rgb(27,158,119)"
24804,2020-03-13,Senegal,0,2,6,"rgb(27,158,119)"
24805,2020-03-14,Senegal,0,13,19,"rgb(27,158,119)"
24806,2020-03-15,Senegal,0,2,21,"rgb(27,158,119)"
24807,2020-03-16,Senegal,0,5,26,"rgb(27,158,119)"
24808,2020-03-17,Senegal,0,1,27,"rgb(27,158,119)"
24809,2020-03-18,Senegal,0,4,31,"rgb(27,158,119)"
24810,2020-03-19,Senegal,0,5,36,"rgb(27,158,119)"
24811,2020-03-20,Senegal,0,0,36,"rgb(27,158,119)"
24812,2020-03-21,Senegal,0,11,47,"rgb(27,158,119)"
24813,2020-03-22,Senegal,0,9,56,"rgb(27,158,119)"
24814,2020-03-23,Senegal,0,11,67,"rgb(27,158,119)"
24815,2020-03-24,Senegal,0,12,79,"rgb(27,158,119)"
24816,2020-03-25,Senegal,0,7,86,"rgb(27,158,119)"
24817,2020-03-26,Senegal,0,13,99,"rgb(27,158,119)"
24818,2020-03-27,Senegal,0,6,105,"rgb(27,158,119)"
24819,2020-03-28,Senegal,0,14,119,"rgb(27,158,119)"
24820,2020-03-29,Senegal,0,11,130,"rgb(27,158,119)"
24821,2020-03-30,Senegal,0,12,142,"rgb(27,158,119)"
24822,2020-03-31,Senegal,0,20,162,"rgb(27,158,119)"
24823,2020-04-01,Senegal,0,13,175,"rgb(27,158,119)"
24824,2020-04-02,Senegal,1,15,190,"rgb(27,158,119)"
24825,2020-04-03,Senegal,0,5,195,"rgb(27,158,119)"
24826,2020-04-04,Senegal,0,12,207,"rgb(27,158,119)"
24827,2020-04-05,Senegal,1,12,219,"rgb(27,158,119)"
24828,2020-04-06,Senegal,0,3,222,"rgb(27,158,119)"
24829,2020-04-07,Senegal,0,4,226,"rgb(27,158,119)"
24830,2020-04-08,Senegal,0,11,237,"rgb(27,158,119)"
24831,2020-04-09,Senegal,0,7,244,"rgb(27,158,119)"
24832,2020-04-10,Senegal,0,6,250,"rgb(27,158,119)"
24833,2020-04-11,Senegal,0,15,265,"rgb(27,158,119)"
24834,2020-04-12,Senegal,0,13,278,"rgb(27,158,119)"
24835,2020-04-13,Senegal,0,2,280,"rgb(27,158,119)"
24836,2020-04-14,Senegal,0,11,291,"rgb(27,158,119)"
24837,2020-04-15,Senegal,0,8,299,"rgb(27,158,119)"
24838,2020-04-16,Senegal,0,15,314,"rgb(27,158,119)"
24839,2020-04-17,Senegal,0,21,335,"rgb(27,158,119)"
24840,2020-04-18,Senegal,1,7,342,"rgb(27,158,119)"
24841,2020-04-19,Senegal,0,8,350,"rgb(27,158,119)"
24842,2020-04-20,Senegal,1,17,367,"rgb(27,158,119)"
24843,2020-04-21,Senegal,1,10,377,"rgb(27,158,119)"
24844,2020-04-22,Senegal,0,35,412,"rgb(27,158,119)"
24845,2020-04-23,Senegal,1,30,442,"rgb(27,158,119)"
24846,2020-04-24,Senegal,0,37,479,"rgb(27,158,119)"
24847,2020-04-25,Senegal,1,66,545,"rgb(27,158,119)"
24848,2020-04-26,Senegal,0,69,614,"rgb(27,158,119)"
24849,2020-04-27,Senegal,2,57,671,"rgb(27,158,119)"
24850,2020-04-28,Senegal,0,64,735,"rgb(27,158,119)"
24851,2020-04-29,Senegal,0,88,823,"rgb(27,158,119)"
24852,2020-04-30,Senegal,0,59,882,"rgb(27,158,119)"
24853,2020-05-01,Senegal,0,51,933,"rgb(27,158,119)"
24854,2020-05-02,Senegal,0,91,1024,"rgb(27,158,119)"
24855,2020-05-03,Senegal,0,91,1115,"rgb(27,158,119)"
24856,2020-05-04,Senegal,0,67,1182,"rgb(27,158,119)"
24857,2020-05-05,Senegal,1,89,1271,"rgb(27,158,119)"
24858,2020-05-06,Senegal,1,58,1329,"rgb(27,158,119)"
24859,2020-05-07,Senegal,1,104,1433,"rgb(27,158,119)"
24860,2020-05-08,Senegal,1,59,1492,"rgb(27,158,119)"
24861,2020-05-09,Senegal,1,59,1551,"rgb(27,158,119)"
24862,2020-05-10,Senegal,3,83,1634,"rgb(27,158,119)"
24863,2020-05-11,Senegal,2,75,1709,"rgb(27,158,119)"
24864,2020-05-12,Senegal,0,177,1886,"rgb(27,158,119)"
24865,2020-05-13,Senegal,0,109,1995,"rgb(27,158,119)"
24866,2020-05-14,Senegal,3,110,2105,"rgb(27,158,119)"
24867,2020-05-15,Senegal,1,84,2189,"rgb(27,158,119)"
24868,2020-05-16,Senegal,2,121,2310,"rgb(27,158,119)"
24869,2020-05-17,Senegal,0,119,2429,"rgb(27,158,119)"
24870,2020-05-18,Senegal,1,51,2480,"rgb(27,158,119)"
24871,2020-05-19,Senegal,0,64,2544,"rgb(27,158,119)"
24872,2020-05-20,Senegal,4,73,2617,"rgb(27,158,119)"
24873,2020-05-21,Senegal,0,97,2714,"rgb(27,158,119)"
24874,2020-05-22,Senegal,3,98,2812,"rgb(27,158,119)"
24875,2020-05-23,Senegal,0,97,2909,"rgb(27,158,119)"
24876,2020-05-24,Senegal,2,67,2976,"rgb(27,158,119)"
24877,2020-05-25,Senegal,0,71,3047,"rgb(27,158,119)"
24878,2020-05-26,Senegal,1,83,3130,"rgb(27,158,119)"
24879,2020-05-27,Senegal,1,31,3161,"rgb(27,158,119)"
24880,2020-05-28,Senegal,2,92,3253,"rgb(27,158,119)"
24881,2020-05-29,Senegal,2,95,3348,"rgb(27,158,119)"
24882,2020-05-30,Senegal,0,81,3429,"rgb(27,158,119)"
24883,2020-05-31,Senegal,1,106,3535,"rgb(27,158,119)"
24884,2020-06-01,Senegal,0,110,3645,"rgb(27,158,119)"
24885,2020-06-02,Senegal,0,94,3739,"rgb(27,158,119)"
24886,2020-06-03,Senegal,1,97,3836,"rgb(27,158,119)"
24887,2020-06-04,Senegal,2,96,3932,"rgb(27,158,119)"
24888,2020-06-05,Senegal,0,89,4021,"rgb(27,158,119)"
24889,2020-06-06,Senegal,0,134,4155,"rgb(27,158,119)"
24890,2020-06-07,Senegal,2,94,4249,"rgb(27,158,119)"
24891,2020-06-08,Senegal,2,79,4328,"rgb(27,158,119)"
24892,2020-06-09,Senegal,3,99,4427,"rgb(27,158,119)"
24893,2020-06-10,Senegal,0,89,4516,"rgb(27,158,119)"
24894,2020-06-11,Senegal,2,124,4640,"rgb(27,158,119)"
24895,2020-06-12,Senegal,2,119,4759,"rgb(27,158,119)"
24896,2020-06-13,Senegal,0,92,4851,"rgb(27,158,119)"
24897,2020-06-14,Senegal,4,145,4996,"rgb(27,158,119)"
24898,2020-06-15,Senegal,0,94,5090,"rgb(27,158,119)"
24899,2020-06-16,Senegal,4,83,5173,"rgb(27,158,119)"
24900,2020-06-17,Senegal,6,74,5247,"rgb(27,158,119)"
24901,2020-06-18,Senegal,3,122,5369,"rgb(27,158,119)"
24902,2020-06-19,Senegal,3,106,5475,"rgb(27,158,119)"
24903,2020-06-20,Senegal,3,164,5639,"rgb(27,158,119)"
24904,2020-06-21,Senegal,3,99,5738,"rgb(27,158,119)"
24905,2020-06-22,Senegal,2,150,5888,"rgb(27,158,119)"
24906,2020-06-23,Senegal,2,82,5970,"rgb(27,158,119)"
24907,2020-06-24,Senegal,3,64,6034,"rgb(27,158,119)"
24908,2020-06-25,Senegal,4,95,6129,"rgb(27,158,119)"
24909,2020-06-26,Senegal,1,104,6233,"rgb(27,158,119)"
24910,2020-06-27,Senegal,4,121,6354,"rgb(27,158,119)"
24911,2020-06-28,Senegal,4,105,6459,"rgb(27,158,119)"
24912,2020-06-29,Senegal,3,127,6586,"rgb(27,158,119)"
24913,2020-06-30,Senegal,3,112,6698,"rgb(27,158,119)"
24914,2020-07-01,Senegal,4,95,6793,"rgb(27,158,119)"
24915,2020-07-02,Senegal,4,132,6925,"rgb(27,158,119)"
24916,2020-07-03,Senegal,5,129,7054,"rgb(27,158,119)"
24917,2020-07-04,Senegal,4,110,7164,"rgb(27,158,119)"
24918,2020-07-05,Senegal,4,108,7272,"rgb(27,158,119)"
24919,2020-07-06,Senegal,4,128,7400,"rgb(27,158,119)"
24920,2020-07-07,Senegal,3,78,7478,"rgb(27,158,119)"
24921,2020-07-08,Senegal,1,69,7547,"rgb(27,158,119)"
24922,2020-07-09,Senegal,4,110,7657,"rgb(27,158,119)"
24923,2020-07-10,Senegal,2,127,7784,"rgb(27,158,119)"
24924,2020-07-11,Senegal,2,98,7882,"rgb(27,158,119)"
24925,2020-07-12,Senegal,0,132,8014,"rgb(27,158,119)"
24926,2020-07-13,Senegal,3,121,8135,"rgb(27,158,119)"
24927,2020-03-17,Somalia,0,1,1,"rgb(217,95,2)"
24928,2020-03-18,Somalia,0,0,1,"rgb(217,95,2)"
24929,2020-03-19,Somalia,0,0,1,"rgb(217,95,2)"
24930,2020-03-20,Somalia,0,0,1,"rgb(217,95,2)"
24931,2020-03-21,Somalia,0,0,1,"rgb(217,95,2)"
24932,2020-03-22,Somalia,0,0,1,"rgb(217,95,2)"
24933,2020-03-23,Somalia,0,0,1,"rgb(217,95,2)"
24934,2020-03-24,Somalia,0,0,1,"rgb(217,95,2)"
24935,2020-03-25,Somalia,0,0,1,"rgb(217,95,2)"
24936,2020-03-26,Somalia,0,0,1,"rgb(217,95,2)"
24937,2020-03-27,Somalia,0,1,2,"rgb(217,95,2)"
24938,2020-03-28,Somalia,0,1,3,"rgb(217,95,2)"
24939,2020-03-29,Somalia,0,0,3,"rgb(217,95,2)"
24940,2020-03-30,Somalia,0,0,3,"rgb(217,95,2)"
24941,2020-03-31,Somalia,0,0,3,"rgb(217,95,2)"
24942,2020-04-01,Somalia,0,0,3,"rgb(217,95,2)"
24943,2020-04-02,Somalia,0,2,5,"rgb(217,95,2)"
24944,2020-04-03,Somalia,0,0,5,"rgb(217,95,2)"
24945,2020-04-04,Somalia,0,0,5,"rgb(217,95,2)"
24946,2020-04-05,Somalia,0,2,7,"rgb(217,95,2)"
24947,2020-04-06,Somalia,0,0,7,"rgb(217,95,2)"
24948,2020-04-07,Somalia,0,0,7,"rgb(217,95,2)"
24949,2020-04-08,Somalia,0,1,8,"rgb(217,95,2)"
24950,2020-04-09,Somalia,0,0,8,"rgb(217,95,2)"
24951,2020-04-10,Somalia,1,4,12,"rgb(217,95,2)"
24952,2020-04-11,Somalia,0,9,21,"rgb(217,95,2)"
24953,2020-04-12,Somalia,0,0,21,"rgb(217,95,2)"
24954,2020-04-13,Somalia,1,4,25,"rgb(217,95,2)"
24955,2020-04-14,Somalia,0,0,25,"rgb(217,95,2)"
24956,2020-04-15,Somalia,0,35,60,"rgb(217,95,2)"
24957,2020-04-16,Somalia,3,20,80,"rgb(217,95,2)"
24958,2020-04-17,Somalia,0,0,80,"rgb(217,95,2)"
24959,2020-04-18,Somalia,0,36,116,"rgb(217,95,2)"
24960,2020-04-19,Somalia,2,19,135,"rgb(217,95,2)"
24961,2020-04-20,Somalia,0,29,164,"rgb(217,95,2)"
24962,2020-04-21,Somalia,1,73,237,"rgb(217,95,2)"
24963,2020-04-22,Somalia,0,49,286,"rgb(217,95,2)"
24964,2020-04-23,Somalia,6,0,286,"rgb(217,95,2)"
24965,2020-04-24,Somalia,0,42,328,"rgb(217,95,2)"
24966,2020-04-25,Somalia,2,0,328,"rgb(217,95,2)"
24967,2020-04-26,Somalia,2,62,390,"rgb(217,95,2)"
24968,2020-04-27,Somalia,5,46,436,"rgb(217,95,2)"
24969,2020-04-28,Somalia,3,44,480,"rgb(217,95,2)"
24970,2020-04-29,Somalia,2,48,528,"rgb(217,95,2)"
24971,2020-04-30,Somalia,0,54,582,"rgb(217,95,2)"
24972,2020-05-01,Somalia,0,19,601,"rgb(217,95,2)"
24973,2020-05-02,Somalia,0,0,601,"rgb(217,95,2)"
24974,2020-05-03,Somalia,3,70,671,"rgb(217,95,2)"
24975,2020-05-04,Somalia,1,51,722,"rgb(217,95,2)"
24976,2020-05-05,Somalia,3,34,756,"rgb(217,95,2)"
24977,2020-05-06,Somalia,3,79,835,"rgb(217,95,2)"
24978,2020-05-07,Somalia,1,38,873,"rgb(217,95,2)"
24979,2020-05-08,Somalia,5,55,928,"rgb(217,95,2)"
24980,2020-05-09,Somalia,0,0,928,"rgb(217,95,2)"
24981,2020-05-10,Somalia,4,69,997,"rgb(217,95,2)"
24982,2020-05-11,Somalia,3,57,1054,"rgb(217,95,2)"
24983,2020-05-12,Somalia,1,35,1089,"rgb(217,95,2)"
24984,2020-05-13,Somalia,0,81,1170,"rgb(217,95,2)"
24985,2020-05-14,Somalia,0,49,1219,"rgb(217,95,2)"
24986,2020-05-15,Somalia,1,65,1284,"rgb(217,95,2)"
24987,2020-05-16,Somalia,0,0,1284,"rgb(217,95,2)"
24988,2020-05-17,Somalia,2,73,1357,"rgb(217,95,2)"
24989,2020-05-18,Somalia,1,64,1421,"rgb(217,95,2)"
24990,2020-05-19,Somalia,1,34,1455,"rgb(217,95,2)"
24991,2020-05-20,Somalia,2,47,1502,"rgb(217,95,2)"
24992,2020-05-21,Somalia,2,71,1573,"rgb(217,95,2)"
24993,2020-05-22,Somalia,0,21,1594,"rgb(217,95,2)"
24994,2020-05-23,Somalia,0,0,1594,"rgb(217,95,2)"
24995,2020-05-24,Somalia,0,0,1594,"rgb(217,95,2)"
24996,2020-05-25,Somalia,0,0,1594,"rgb(217,95,2)"
24997,2020-05-26,Somalia,5,95,1689,"rgb(217,95,2)"
24998,2020-05-27,Somalia,1,22,1711,"rgb(217,95,2)"
24999,2020-05-28,Somalia,0,20,1731,"rgb(217,95,2)"
25000,2020-05-29,Somalia,5,97,1828,"rgb(217,95,2)"
25001,2020-05-30,Somalia,0,0,1828,"rgb(217,95,2)"
25002,2020-05-31,Somalia,1,88,1916,"rgb(217,95,2)"
25003,2020-06-01,Somalia,5,60,1976,"rgb(217,95,2)"
25004,2020-06-02,Somalia,1,47,2023,"rgb(217,95,2)"
25005,2020-06-03,Somalia,0,66,2089,"rgb(217,95,2)"
25006,2020-06-04,Somalia,0,57,2146,"rgb(217,95,2)"
25007,2020-06-05,Somalia,0,58,2204,"rgb(217,95,2)"
25008,2020-06-06,Somalia,0,0,2204,"rgb(217,95,2)"
25009,2020-06-07,Somalia,3,85,2289,"rgb(217,95,2)"
25010,2020-06-08,Somalia,1,45,2334,"rgb(217,95,2)"
25011,2020-06-09,Somalia,1,34,2368,"rgb(217,95,2)"
25012,2020-06-10,Somalia,1,48,2416,"rgb(217,95,2)"
25013,2020-06-11,Somalia,0,36,2452,"rgb(217,95,2)"
25014,2020-06-12,Somalia,0,61,2513,"rgb(217,95,2)"
25015,2020-06-13,Somalia,0,0,2513,"rgb(217,95,2)"
25016,2020-06-14,Somalia,2,66,2579,"rgb(217,95,2)"
25017,2020-06-15,Somalia,1,24,2603,"rgb(217,95,2)"
25018,2020-06-16,Somalia,0,39,2642,"rgb(217,95,2)"
25019,2020-06-17,Somalia,0,16,2658,"rgb(217,95,2)"
25020,2020-06-18,Somalia,0,38,2696,"rgb(217,95,2)"
25021,2020-06-19,Somalia,0,23,2719,"rgb(217,95,2)"
25022,2020-06-20,Somalia,0,0,2719,"rgb(217,95,2)"
25023,2020-06-21,Somalia,0,36,2755,"rgb(217,95,2)"
25024,2020-06-22,Somalia,2,24,2779,"rgb(217,95,2)"
25025,2020-06-23,Somalia,0,33,2812,"rgb(217,95,2)"
25026,2020-06-24,Somalia,0,23,2835,"rgb(217,95,2)"
25027,2020-06-25,Somalia,0,25,2860,"rgb(217,95,2)"
25028,2020-06-26,Somalia,0,18,2878,"rgb(217,95,2)"
25029,2020-06-27,Somalia,0,0,2878,"rgb(217,95,2)"
25030,2020-06-28,Somalia,0,0,2878,"rgb(217,95,2)"
25031,2020-06-29,Somalia,0,16,2894,"rgb(217,95,2)"
25032,2020-06-30,Somalia,0,10,2904,"rgb(217,95,2)"
25033,2020-07-01,Somalia,0,20,2924,"rgb(217,95,2)"
25034,2020-07-02,Somalia,0,0,2924,"rgb(217,95,2)"
25035,2020-07-03,Somalia,0,20,2944,"rgb(217,95,2)"
25036,2020-07-04,Somalia,0,0,2944,"rgb(217,95,2)"
25037,2020-07-05,Somalia,2,17,2961,"rgb(217,95,2)"
25038,2020-07-06,Somalia,0,36,2997,"rgb(217,95,2)"
25039,2020-07-07,Somalia,0,9,3006,"rgb(217,95,2)"
25040,2020-07-08,Somalia,0,9,3015,"rgb(217,95,2)"
25041,2020-07-09,Somalia,0,13,3028,"rgb(217,95,2)"
25042,2020-07-10,Somalia,0,10,3038,"rgb(217,95,2)"
25043,2020-07-11,Somalia,0,0,3038,"rgb(217,95,2)"
25044,2020-07-12,Somalia,0,13,3051,"rgb(217,95,2)"
25045,2020-07-13,Somalia,1,8,3059,"rgb(217,95,2)"
25046,2020-03-15,Suriname,0,1,1,"rgb(117,112,179)"
25047,2020-03-21,Suriname,0,0,1,"rgb(117,112,179)"
25048,2020-03-22,Suriname,0,4,5,"rgb(117,112,179)"
25049,2020-03-23,Suriname,0,0,5,"rgb(117,112,179)"
25050,2020-03-24,Suriname,0,1,6,"rgb(117,112,179)"
25051,2020-03-25,Suriname,0,2,8,"rgb(117,112,179)"
25052,2020-03-26,Suriname,0,0,8,"rgb(117,112,179)"
25053,2020-03-27,Suriname,0,0,8,"rgb(117,112,179)"
25054,2020-03-28,Suriname,0,0,8,"rgb(117,112,179)"
25055,2020-03-29,Suriname,0,0,8,"rgb(117,112,179)"
25056,2020-03-30,Suriname,0,0,8,"rgb(117,112,179)"
25057,2020-03-31,Suriname,0,0,8,"rgb(117,112,179)"
25058,2020-04-01,Suriname,0,2,10,"rgb(117,112,179)"
25059,2020-04-02,Suriname,0,0,10,"rgb(117,112,179)"
25060,2020-04-03,Suriname,0,0,10,"rgb(117,112,179)"
25061,2020-04-04,Suriname,1,0,10,"rgb(117,112,179)"
25062,2020-04-05,Suriname,0,0,10,"rgb(117,112,179)"
25063,2020-04-06,Suriname,0,0,10,"rgb(117,112,179)"
25064,2020-04-07,Suriname,0,0,10,"rgb(117,112,179)"
25065,2020-04-08,Suriname,0,0,10,"rgb(117,112,179)"
25066,2020-04-09,Suriname,0,0,10,"rgb(117,112,179)"
25067,2020-04-10,Suriname,0,0,10,"rgb(117,112,179)"
25068,2020-04-11,Suriname,0,0,10,"rgb(117,112,179)"
25069,2020-04-12,Suriname,0,0,10,"rgb(117,112,179)"
25070,2020-04-13,Suriname,0,0,10,"rgb(117,112,179)"
25071,2020-04-14,Suriname,0,0,10,"rgb(117,112,179)"
25072,2020-04-15,Suriname,0,0,10,"rgb(117,112,179)"
25073,2020-04-16,Suriname,0,0,10,"rgb(117,112,179)"
25074,2020-04-17,Suriname,0,0,10,"rgb(117,112,179)"
25075,2020-04-18,Suriname,0,0,10,"rgb(117,112,179)"
25076,2020-04-19,Suriname,0,0,10,"rgb(117,112,179)"
25077,2020-04-20,Suriname,0,0,10,"rgb(117,112,179)"
25078,2020-04-21,Suriname,0,0,10,"rgb(117,112,179)"
25079,2020-04-22,Suriname,0,0,10,"rgb(117,112,179)"
25080,2020-04-23,Suriname,0,0,10,"rgb(117,112,179)"
25081,2020-04-24,Suriname,0,0,10,"rgb(117,112,179)"
25082,2020-04-25,Suriname,0,0,10,"rgb(117,112,179)"
25083,2020-04-26,Suriname,0,0,10,"rgb(117,112,179)"
25084,2020-04-27,Suriname,0,0,10,"rgb(117,112,179)"
25085,2020-04-28,Suriname,0,0,10,"rgb(117,112,179)"
25086,2020-04-29,Suriname,0,0,10,"rgb(117,112,179)"
25087,2020-04-30,Suriname,0,0,10,"rgb(117,112,179)"
25088,2020-05-01,Suriname,0,0,10,"rgb(117,112,179)"
25089,2020-05-02,Suriname,0,0,10,"rgb(117,112,179)"
25090,2020-05-03,Suriname,0,0,10,"rgb(117,112,179)"
25091,2020-05-04,Suriname,0,0,10,"rgb(117,112,179)"
25092,2020-05-05,Suriname,0,0,10,"rgb(117,112,179)"
25093,2020-05-06,Suriname,0,0,10,"rgb(117,112,179)"
25094,2020-05-07,Suriname,0,0,10,"rgb(117,112,179)"
25095,2020-05-08,Suriname,0,0,10,"rgb(117,112,179)"
25096,2020-05-09,Suriname,0,0,10,"rgb(117,112,179)"
25097,2020-05-10,Suriname,0,0,10,"rgb(117,112,179)"
25098,2020-05-11,Suriname,0,0,10,"rgb(117,112,179)"
25099,2020-05-12,Suriname,0,0,10,"rgb(117,112,179)"
25100,2020-05-13,Suriname,0,0,10,"rgb(117,112,179)"
25101,2020-05-14,Suriname,0,0,10,"rgb(117,112,179)"
25102,2020-05-15,Suriname,0,0,10,"rgb(117,112,179)"
25103,2020-05-16,Suriname,0,0,10,"rgb(117,112,179)"
25104,2020-05-17,Suriname,0,0,10,"rgb(117,112,179)"
25105,2020-05-18,Suriname,0,0,10,"rgb(117,112,179)"
25106,2020-05-19,Suriname,0,1,11,"rgb(117,112,179)"
25107,2020-05-20,Suriname,0,0,11,"rgb(117,112,179)"
25108,2020-05-21,Suriname,0,0,11,"rgb(117,112,179)"
25109,2020-05-22,Suriname,0,0,11,"rgb(117,112,179)"
25110,2020-05-23,Suriname,0,0,11,"rgb(117,112,179)"
25111,2020-05-24,Suriname,0,0,11,"rgb(117,112,179)"
25112,2020-05-25,Suriname,0,0,11,"rgb(117,112,179)"
25113,2020-05-26,Suriname,0,0,11,"rgb(117,112,179)"
25114,2020-05-27,Suriname,0,0,11,"rgb(117,112,179)"
25115,2020-05-28,Suriname,0,1,12,"rgb(117,112,179)"
25116,2020-05-29,Suriname,0,0,12,"rgb(117,112,179)"
25117,2020-05-30,Suriname,0,0,12,"rgb(117,112,179)"
25118,2020-05-31,Suriname,0,2,14,"rgb(117,112,179)"
25119,2020-06-01,Suriname,0,9,23,"rgb(117,112,179)"
25120,2020-06-02,Suriname,0,21,44,"rgb(117,112,179)"
25121,2020-06-03,Suriname,0,10,54,"rgb(117,112,179)"
25122,2020-06-04,Suriname,0,20,74,"rgb(117,112,179)"
25123,2020-06-05,Suriname,0,8,82,"rgb(117,112,179)"
25124,2020-06-06,Suriname,0,9,91,"rgb(117,112,179)"
25125,2020-06-07,Suriname,0,9,100,"rgb(117,112,179)"
25126,2020-06-08,Suriname,0,22,122,"rgb(117,112,179)"
25127,2020-06-09,Suriname,1,8,130,"rgb(117,112,179)"
25128,2020-06-10,Suriname,0,7,137,"rgb(117,112,179)"
25129,2020-06-11,Suriname,0,0,137,"rgb(117,112,179)"
25130,2020-06-12,Suriname,0,31,168,"rgb(117,112,179)"
25131,2020-06-13,Suriname,1,19,187,"rgb(117,112,179)"
25132,2020-06-14,Suriname,0,9,196,"rgb(117,112,179)"
25133,2020-06-15,Suriname,0,12,208,"rgb(117,112,179)"
25134,2020-06-16,Suriname,2,21,229,"rgb(117,112,179)"
25135,2020-06-17,Suriname,1,7,236,"rgb(117,112,179)"
25136,2020-06-18,Suriname,0,25,261,"rgb(117,112,179)"
25137,2020-06-19,Suriname,1,16,277,"rgb(117,112,179)"
25138,2020-06-20,Suriname,1,16,293,"rgb(117,112,179)"
25139,2020-06-21,Suriname,0,9,302,"rgb(117,112,179)"
25140,2020-06-22,Suriname,0,12,314,"rgb(117,112,179)"
25141,2020-06-23,Suriname,0,5,319,"rgb(117,112,179)"
25142,2020-06-24,Suriname,1,0,319,"rgb(117,112,179)"
25143,2020-06-25,Suriname,1,38,357,"rgb(117,112,179)"
25144,2020-06-26,Suriname,0,16,373,"rgb(117,112,179)"
25145,2020-06-27,Suriname,0,18,391,"rgb(117,112,179)"
25146,2020-06-28,Suriname,0,0,391,"rgb(117,112,179)"
25147,2020-06-29,Suriname,1,99,490,"rgb(117,112,179)"
25148,2020-06-30,Suriname,2,11,501,"rgb(117,112,179)"
25149,2020-07-01,Suriname,0,16,517,"rgb(117,112,179)"
25150,2020-07-02,Suriname,0,18,535,"rgb(117,112,179)"
25151,2020-07-03,Suriname,0,12,547,"rgb(117,112,179)"
25152,2020-07-04,Suriname,0,14,561,"rgb(117,112,179)"
25153,2020-07-05,Suriname,1,4,565,"rgb(117,112,179)"
25154,2020-07-06,Suriname,0,29,594,"rgb(117,112,179)"
25155,2020-07-07,Suriname,0,20,614,"rgb(117,112,179)"
25156,2020-07-08,Suriname,0,0,614,"rgb(117,112,179)"
25157,2020-07-09,Suriname,3,51,665,"rgb(117,112,179)"
25158,2020-07-10,Suriname,0,29,694,"rgb(117,112,179)"
25159,2020-07-11,Suriname,1,32,726,"rgb(117,112,179)"
25160,2020-07-12,Suriname,0,15,741,"rgb(117,112,179)"
25161,2020-07-13,Suriname,0,0,741,"rgb(117,112,179)"
25162,2020-04-06,South Sudan,0,1,1,"rgb(231,41,138)"
25163,2020-04-07,South Sudan,0,0,1,"rgb(231,41,138)"
25164,2020-04-08,South Sudan,0,0,1,"rgb(231,41,138)"
25165,2020-04-09,South Sudan,0,1,2,"rgb(231,41,138)"
25166,2020-04-10,South Sudan,0,0,2,"rgb(231,41,138)"
25167,2020-04-11,South Sudan,0,1,3,"rgb(231,41,138)"
25168,2020-04-12,South Sudan,0,1,4,"rgb(231,41,138)"
25169,2020-04-13,South Sudan,0,0,4,"rgb(231,41,138)"
25170,2020-04-14,South Sudan,0,0,4,"rgb(231,41,138)"
25171,2020-04-15,South Sudan,0,0,4,"rgb(231,41,138)"
25172,2020-04-16,South Sudan,0,0,4,"rgb(231,41,138)"
25173,2020-04-17,South Sudan,0,0,4,"rgb(231,41,138)"
25174,2020-04-18,South Sudan,0,0,4,"rgb(231,41,138)"
25175,2020-04-19,South Sudan,0,0,4,"rgb(231,41,138)"
25176,2020-04-20,South Sudan,0,0,4,"rgb(231,41,138)"
25177,2020-04-21,South Sudan,0,0,4,"rgb(231,41,138)"
25178,2020-04-22,South Sudan,0,0,4,"rgb(231,41,138)"
25179,2020-04-23,South Sudan,0,0,4,"rgb(231,41,138)"
25180,2020-04-24,South Sudan,0,0,4,"rgb(231,41,138)"
25181,2020-04-25,South Sudan,0,1,5,"rgb(231,41,138)"
25182,2020-04-26,South Sudan,0,0,5,"rgb(231,41,138)"
25183,2020-04-27,South Sudan,0,1,6,"rgb(231,41,138)"
25184,2020-04-28,South Sudan,0,0,6,"rgb(231,41,138)"
25185,2020-04-29,South Sudan,0,28,34,"rgb(231,41,138)"
25186,2020-04-30,South Sudan,0,0,34,"rgb(231,41,138)"
25187,2020-05-01,South Sudan,0,1,35,"rgb(231,41,138)"
25188,2020-05-02,South Sudan,0,10,45,"rgb(231,41,138)"
25189,2020-05-03,South Sudan,0,0,45,"rgb(231,41,138)"
25190,2020-05-04,South Sudan,0,1,46,"rgb(231,41,138)"
25191,2020-05-05,South Sudan,0,0,46,"rgb(231,41,138)"
25192,2020-05-06,South Sudan,0,6,52,"rgb(231,41,138)"
25193,2020-05-07,South Sudan,0,22,74,"rgb(231,41,138)"
25194,2020-05-08,South Sudan,0,16,90,"rgb(231,41,138)"
25195,2020-05-09,South Sudan,0,30,120,"rgb(231,41,138)"
25196,2020-05-10,South Sudan,0,23,143,"rgb(231,41,138)"
25197,2020-05-11,South Sudan,0,13,156,"rgb(231,41,138)"
25198,2020-05-12,South Sudan,0,0,156,"rgb(231,41,138)"
25199,2020-05-13,South Sudan,0,38,194,"rgb(231,41,138)"
25200,2020-05-14,South Sudan,0,9,203,"rgb(231,41,138)"
25201,2020-05-15,South Sudan,1,28,231,"rgb(231,41,138)"
25202,2020-05-16,South Sudan,3,5,236,"rgb(231,41,138)"
25203,2020-05-17,South Sudan,0,0,236,"rgb(231,41,138)"
25204,2020-05-18,South Sudan,0,46,282,"rgb(231,41,138)"
25205,2020-05-19,South Sudan,0,0,282,"rgb(231,41,138)"
25206,2020-05-20,South Sudan,2,3,285,"rgb(231,41,138)"
25207,2020-05-21,South Sudan,0,0,285,"rgb(231,41,138)"
25208,2020-05-22,South Sudan,0,54,339,"rgb(231,41,138)"
25209,2020-05-23,South Sudan,0,0,339,"rgb(231,41,138)"
25210,2020-05-24,South Sudan,0,224,563,"rgb(231,41,138)"
25211,2020-05-25,South Sudan,0,0,563,"rgb(231,41,138)"
25212,2020-05-26,South Sudan,2,92,655,"rgb(231,41,138)"
25213,2020-05-27,South Sudan,0,151,806,"rgb(231,41,138)"
25214,2020-05-28,South Sudan,0,0,806,"rgb(231,41,138)"
25215,2020-05-29,South Sudan,0,0,806,"rgb(231,41,138)"
25216,2020-05-30,South Sudan,2,188,994,"rgb(231,41,138)"
25217,2020-05-31,South Sudan,0,0,994,"rgb(231,41,138)"
25218,2020-06-01,South Sudan,0,0,994,"rgb(231,41,138)"
25219,2020-06-02,South Sudan,0,0,994,"rgb(231,41,138)"
25220,2020-06-03,South Sudan,0,0,994,"rgb(231,41,138)"
25221,2020-06-04,South Sudan,0,0,994,"rgb(231,41,138)"
25222,2020-06-05,South Sudan,4,323,1317,"rgb(231,41,138)"
25223,2020-06-06,South Sudan,0,0,1317,"rgb(231,41,138)"
25224,2020-06-07,South Sudan,0,0,1317,"rgb(231,41,138)"
25225,2020-06-08,South Sudan,0,0,1317,"rgb(231,41,138)"
25226,2020-06-09,South Sudan,5,287,1604,"rgb(231,41,138)"
25227,2020-06-10,South Sudan,0,0,1604,"rgb(231,41,138)"
25228,2020-06-11,South Sudan,0,0,1604,"rgb(231,41,138)"
25229,2020-06-12,South Sudan,0,0,1604,"rgb(231,41,138)"
25230,2020-06-13,South Sudan,3,66,1670,"rgb(231,41,138)"
25231,2020-06-14,South Sudan,5,23,1693,"rgb(231,41,138)"
25232,2020-06-15,South Sudan,0,0,1693,"rgb(231,41,138)"
25233,2020-06-16,South Sudan,3,62,1755,"rgb(231,41,138)"
25234,2020-06-17,South Sudan,0,21,1776,"rgb(231,41,138)"
25235,2020-06-18,South Sudan,1,31,1807,"rgb(231,41,138)"
25236,2020-06-19,South Sudan,0,6,1813,"rgb(231,41,138)"
25237,2020-06-20,South Sudan,0,0,1813,"rgb(231,41,138)"
25238,2020-06-21,South Sudan,3,51,1864,"rgb(231,41,138)"
25239,2020-06-22,South Sudan,0,18,1882,"rgb(231,41,138)"
25240,2020-06-23,South Sudan,0,10,1892,"rgb(231,41,138)"
25241,2020-06-24,South Sudan,1,24,1916,"rgb(231,41,138)"
25242,2020-06-25,South Sudan,1,14,1930,"rgb(231,41,138)"
25243,2020-06-26,South Sudan,0,12,1942,"rgb(231,41,138)"
25244,2020-06-27,South Sudan,0,10,1952,"rgb(231,41,138)"
25245,2020-06-28,South Sudan,0,6,1958,"rgb(231,41,138)"
25246,2020-06-29,South Sudan,0,31,1989,"rgb(231,41,138)"
25247,2020-06-30,South Sudan,1,17,2006,"rgb(231,41,138)"
25248,2020-07-01,South Sudan,0,0,2006,"rgb(231,41,138)"
25249,2020-07-02,South Sudan,0,0,2006,"rgb(231,41,138)"
25250,2020-07-03,South Sudan,1,30,2036,"rgb(231,41,138)"
25251,2020-07-04,South Sudan,0,0,2036,"rgb(231,41,138)"
25252,2020-07-05,South Sudan,0,0,2036,"rgb(231,41,138)"
25253,2020-07-06,South Sudan,0,0,2036,"rgb(231,41,138)"
25254,2020-07-07,South Sudan,2,57,2093,"rgb(231,41,138)"
25255,2020-07-08,South Sudan,0,5,2098,"rgb(231,41,138)"
25256,2020-07-09,South Sudan,0,8,2106,"rgb(231,41,138)"
25257,2020-07-10,South Sudan,0,7,2113,"rgb(231,41,138)"
25258,2020-07-11,South Sudan,1,16,2129,"rgb(231,41,138)"
25259,2020-07-12,South Sudan,0,0,2129,"rgb(231,41,138)"
25260,2020-07-13,South Sudan,0,10,2139,"rgb(231,41,138)"
25261,2020-04-09,São Tomé and Principe,0,4,4,"rgb(102,166,30)"
25262,2020-04-10,São Tomé and Principe,0,0,4,"rgb(102,166,30)"
25263,2020-04-11,São Tomé and Principe,0,0,4,"rgb(102,166,30)"
25264,2020-04-12,São Tomé and Principe,0,0,4,"rgb(102,166,30)"
25265,2020-04-13,São Tomé and Principe,0,0,4,"rgb(102,166,30)"
25266,2020-04-14,São Tomé and Principe,0,0,4,"rgb(102,166,30)"
25267,2020-04-15,São Tomé and Principe,0,0,4,"rgb(102,166,30)"
25268,2020-04-16,São Tomé and Principe,0,0,4,"rgb(102,166,30)"
25269,2020-04-17,São Tomé and Principe,0,0,4,"rgb(102,166,30)"
25270,2020-04-18,São Tomé and Principe,0,0,4,"rgb(102,166,30)"
25271,2020-04-19,São Tomé and Principe,0,0,4,"rgb(102,166,30)"
25272,2020-04-20,São Tomé and Principe,0,0,4,"rgb(102,166,30)"
25273,2020-04-21,São Tomé and Principe,0,0,4,"rgb(102,166,30)"
25274,2020-04-22,São Tomé and Principe,0,0,4,"rgb(102,166,30)"
25275,2020-04-23,São Tomé and Principe,0,3,7,"rgb(102,166,30)"
25276,2020-04-24,São Tomé and Principe,0,1,8,"rgb(102,166,30)"
25277,2020-04-25,São Tomé and Principe,0,0,8,"rgb(102,166,30)"
25278,2020-04-26,São Tomé and Principe,0,0,8,"rgb(102,166,30)"
25279,2020-04-27,São Tomé and Principe,0,0,8,"rgb(102,166,30)"
25280,2020-04-28,São Tomé and Principe,0,0,8,"rgb(102,166,30)"
25281,2020-04-29,São Tomé and Principe,0,3,11,"rgb(102,166,30)"
25282,2020-04-30,São Tomé and Principe,0,3,14,"rgb(102,166,30)"
25283,2020-05-01,São Tomé and Principe,1,2,16,"rgb(102,166,30)"
25284,2020-05-02,São Tomé and Principe,0,2,18,"rgb(102,166,30)"
25285,2020-05-03,São Tomé and Principe,0,0,18,"rgb(102,166,30)"
25286,2020-05-04,São Tomé and Principe,0,0,18,"rgb(102,166,30)"
25287,2020-05-05,São Tomé and Principe,2,156,174,"rgb(102,166,30)"
25288,2020-05-06,São Tomé and Principe,0,0,174,"rgb(102,166,30)"
25289,2020-05-07,São Tomé and Principe,0,0,174,"rgb(102,166,30)"
25290,2020-05-08,São Tomé and Principe,1,13,187,"rgb(102,166,30)"
25291,2020-05-09,São Tomé and Principe,1,21,208,"rgb(102,166,30)"
25292,2020-05-10,São Tomé and Principe,0,0,208,"rgb(102,166,30)"
25293,2020-05-11,São Tomé and Principe,0,0,208,"rgb(102,166,30)"
25294,2020-05-12,São Tomé and Principe,0,4,212,"rgb(102,166,30)"
25295,2020-05-13,São Tomé and Principe,1,8,220,"rgb(102,166,30)"
25296,2020-05-14,São Tomé and Principe,1,15,235,"rgb(102,166,30)"
25297,2020-05-15,São Tomé and Principe,0,0,235,"rgb(102,166,30)"
25298,2020-05-16,São Tomé and Principe,0,0,235,"rgb(102,166,30)"
25299,2020-05-17,São Tomé and Principe,0,0,235,"rgb(102,166,30)"
25300,2020-05-18,São Tomé and Principe,0,0,235,"rgb(102,166,30)"
25301,2020-05-19,São Tomé and Principe,0,11,246,"rgb(102,166,30)"
25302,2020-05-20,São Tomé and Principe,1,5,251,"rgb(102,166,30)"
25303,2020-05-21,São Tomé and Principe,0,0,251,"rgb(102,166,30)"
25304,2020-05-22,São Tomé and Principe,0,0,251,"rgb(102,166,30)"
25305,2020-05-23,São Tomé and Principe,0,0,251,"rgb(102,166,30)"
25306,2020-05-24,São Tomé and Principe,0,40,291,"rgb(102,166,30)"
25307,2020-05-25,São Tomé and Principe,1,8,299,"rgb(102,166,30)"
25308,2020-05-26,São Tomé and Principe,2,0,299,"rgb(102,166,30)"
25309,2020-05-27,São Tomé and Principe,1,142,441,"rgb(102,166,30)"
25310,2020-05-28,São Tomé and Principe,0,2,443,"rgb(102,166,30)"
25311,2020-05-29,São Tomé and Principe,0,15,458,"rgb(102,166,30)"
25312,2020-05-30,São Tomé and Principe,0,5,463,"rgb(102,166,30)"
25313,2020-05-31,São Tomé and Principe,0,16,479,"rgb(102,166,30)"
25314,2020-06-01,São Tomé and Principe,0,4,483,"rgb(102,166,30)"
25315,2020-06-02,São Tomé and Principe,0,1,484,"rgb(102,166,30)"
25316,2020-06-03,São Tomé and Principe,0,0,484,"rgb(102,166,30)"
25317,2020-06-04,São Tomé and Principe,0,0,484,"rgb(102,166,30)"
25318,2020-06-05,São Tomé and Principe,0,15,499,"rgb(102,166,30)"
25319,2020-06-06,São Tomé and Principe,0,10,509,"rgb(102,166,30)"
25320,2020-06-07,São Tomé and Principe,0,4,513,"rgb(102,166,30)"
25321,2020-06-08,São Tomé and Principe,0,1,514,"rgb(102,166,30)"
25322,2020-06-09,São Tomé and Principe,0,0,514,"rgb(102,166,30)"
25323,2020-06-10,São Tomé and Principe,0,0,514,"rgb(102,166,30)"
25324,2020-06-11,São Tomé and Principe,0,118,632,"rgb(102,166,30)"
25325,2020-06-12,São Tomé and Principe,0,7,639,"rgb(102,166,30)"
25326,2020-06-13,São Tomé and Principe,0,11,650,"rgb(102,166,30)"
25327,2020-06-14,São Tomé and Principe,0,9,659,"rgb(102,166,30)"
25328,2020-06-15,São Tomé and Principe,0,2,661,"rgb(102,166,30)"
25329,2020-06-16,São Tomé and Principe,0,0,661,"rgb(102,166,30)"
25330,2020-06-17,São Tomé and Principe,0,10,671,"rgb(102,166,30)"
25331,2020-06-18,São Tomé and Principe,0,12,683,"rgb(102,166,30)"
25332,2020-06-19,São Tomé and Principe,0,5,688,"rgb(102,166,30)"
25333,2020-06-20,São Tomé and Principe,0,5,693,"rgb(102,166,30)"
25334,2020-06-21,São Tomé and Principe,0,5,698,"rgb(102,166,30)"
25335,2020-06-22,São Tomé and Principe,0,0,698,"rgb(102,166,30)"
25336,2020-06-23,São Tomé and Principe,0,4,702,"rgb(102,166,30)"
25337,2020-06-24,São Tomé and Principe,0,5,707,"rgb(102,166,30)"
25338,2020-06-25,São Tomé and Principe,1,3,710,"rgb(102,166,30)"
25339,2020-06-26,São Tomé and Principe,0,1,711,"rgb(102,166,30)"
25340,2020-06-27,São Tomé and Principe,0,1,712,"rgb(102,166,30)"
25341,2020-06-28,São Tomé and Principe,0,1,713,"rgb(102,166,30)"
25342,2020-06-29,São Tomé and Principe,0,0,713,"rgb(102,166,30)"
25343,2020-06-30,São Tomé and Principe,0,0,713,"rgb(102,166,30)"
25344,2020-07-01,São Tomé and Principe,0,1,714,"rgb(102,166,30)"
25345,2020-07-02,São Tomé and Principe,0,1,715,"rgb(102,166,30)"
25346,2020-07-03,São Tomé and Principe,0,2,717,"rgb(102,166,30)"
25347,2020-07-04,São Tomé and Principe,0,2,719,"rgb(102,166,30)"
25348,2020-07-05,São Tomé and Principe,0,0,719,"rgb(102,166,30)"
25349,2020-07-06,São Tomé and Principe,0,1,720,"rgb(102,166,30)"
25350,2020-07-07,São Tomé and Principe,0,1,721,"rgb(102,166,30)"
25351,2020-07-08,São Tomé and Principe,0,3,724,"rgb(102,166,30)"
25352,2020-07-09,São Tomé and Principe,0,0,724,"rgb(102,166,30)"
25353,2020-07-10,São Tomé and Principe,1,2,726,"rgb(102,166,30)"
25354,2020-07-11,São Tomé and Principe,0,1,727,"rgb(102,166,30)"
25355,2020-07-12,São Tomé and Principe,0,0,727,"rgb(102,166,30)"
25356,2020-07-13,São Tomé and Principe,0,2,729,"rgb(102,166,30)"
25357,2020-03-19,El Salvador,0,1,1,"rgb(230,171,2)"
25358,2020-03-20,El Salvador,0,0,1,"rgb(230,171,2)"
25359,2020-03-21,El Salvador,0,2,3,"rgb(230,171,2)"
25360,2020-03-22,El Salvador,0,0,3,"rgb(230,171,2)"
25361,2020-03-23,El Salvador,0,0,3,"rgb(230,171,2)"
25362,2020-03-24,El Salvador,0,2,5,"rgb(230,171,2)"
25363,2020-03-25,El Salvador,0,4,9,"rgb(230,171,2)"
25364,2020-03-26,El Salvador,0,4,13,"rgb(230,171,2)"
25365,2020-03-27,El Salvador,0,0,13,"rgb(230,171,2)"
25366,2020-03-28,El Salvador,0,0,13,"rgb(230,171,2)"
25367,2020-03-29,El Salvador,0,6,19,"rgb(230,171,2)"
25368,2020-03-30,El Salvador,0,11,30,"rgb(230,171,2)"
25369,2020-03-31,El Salvador,0,2,32,"rgb(230,171,2)"
25370,2020-04-01,El Salvador,1,0,32,"rgb(230,171,2)"
25371,2020-04-02,El Salvador,1,9,41,"rgb(230,171,2)"
25372,2020-04-03,El Salvador,0,5,46,"rgb(230,171,2)"
25373,2020-04-04,El Salvador,1,10,56,"rgb(230,171,2)"
25374,2020-04-05,El Salvador,0,6,62,"rgb(230,171,2)"
25375,2020-04-06,El Salvador,0,7,69,"rgb(230,171,2)"
25376,2020-04-07,El Salvador,1,9,78,"rgb(230,171,2)"
25377,2020-04-08,El Salvador,0,0,78,"rgb(230,171,2)"
25378,2020-04-09,El Salvador,1,25,103,"rgb(230,171,2)"
25379,2020-04-10,El Salvador,1,14,117,"rgb(230,171,2)"
25380,2020-04-11,El Salvador,0,1,118,"rgb(230,171,2)"
25381,2020-04-12,El Salvador,0,0,118,"rgb(230,171,2)"
25382,2020-04-13,El Salvador,0,7,125,"rgb(230,171,2)"
25383,2020-04-14,El Salvador,0,24,149,"rgb(230,171,2)"
25384,2020-04-15,El Salvador,0,10,159,"rgb(230,171,2)"
25385,2020-04-16,El Salvador,0,0,159,"rgb(230,171,2)"
25386,2020-04-17,El Salvador,0,5,164,"rgb(230,171,2)"
25387,2020-04-18,El Salvador,1,13,177,"rgb(230,171,2)"
25388,2020-04-19,El Salvador,0,13,190,"rgb(230,171,2)"
25389,2020-04-20,El Salvador,0,11,201,"rgb(230,171,2)"
25390,2020-04-21,El Salvador,0,17,218,"rgb(230,171,2)"
25391,2020-04-22,El Salvador,0,7,225,"rgb(230,171,2)"
25392,2020-04-23,El Salvador,1,12,237,"rgb(230,171,2)"
25393,2020-04-24,El Salvador,0,13,250,"rgb(230,171,2)"
25394,2020-04-25,El Salvador,0,11,261,"rgb(230,171,2)"
25395,2020-04-26,El Salvador,0,37,298,"rgb(230,171,2)"
25396,2020-04-27,El Salvador,0,0,298,"rgb(230,171,2)"
25397,2020-04-28,El Salvador,0,25,323,"rgb(230,171,2)"
25398,2020-04-29,El Salvador,1,22,345,"rgb(230,171,2)"
25399,2020-04-30,El Salvador,0,32,377,"rgb(230,171,2)"
25400,2020-05-01,El Salvador,1,47,424,"rgb(230,171,2)"
25401,2020-05-02,El Salvador,0,22,446,"rgb(230,171,2)"
25402,2020-05-03,El Salvador,1,0,446,"rgb(230,171,2)"
25403,2020-05-04,El Salvador,1,109,555,"rgb(230,171,2)"
25404,2020-05-05,El Salvador,1,32,587,"rgb(230,171,2)"
25405,2020-05-06,El Salvador,1,0,587,"rgb(230,171,2)"
25406,2020-05-07,El Salvador,1,108,695,"rgb(230,171,2)"
25407,2020-05-08,El Salvador,0,0,695,"rgb(230,171,2)"
25408,2020-05-09,El Salvador,1,89,784,"rgb(230,171,2)"
25409,2020-05-10,El Salvador,1,105,889,"rgb(230,171,2)"
25410,2020-05-11,El Salvador,0,69,958,"rgb(230,171,2)"
25411,2020-05-12,El Salvador,1,40,998,"rgb(230,171,2)"
25412,2020-05-13,El Salvador,2,39,1037,"rgb(230,171,2)"
25413,2020-05-14,El Salvador,0,75,1112,"rgb(230,171,2)"
25414,2020-05-15,El Salvador,3,98,1210,"rgb(230,171,2)"
25415,2020-05-16,El Salvador,2,55,1265,"rgb(230,171,2)"
25416,2020-05-17,El Salvador,1,0,1265,"rgb(230,171,2)"
25417,2020-05-18,El Salvador,4,73,1338,"rgb(230,171,2)"
25418,2020-05-19,El Salvador,0,75,1413,"rgb(230,171,2)"
25419,2020-05-20,El Salvador,1,85,1498,"rgb(230,171,2)"
25420,2020-05-21,El Salvador,1,73,1571,"rgb(230,171,2)"
25421,2020-05-22,El Salvador,1,69,1640,"rgb(230,171,2)"
25422,2020-05-23,El Salvador,0,85,1725,"rgb(230,171,2)"
25423,2020-05-24,El Salvador,2,94,1819,"rgb(230,171,2)"
25424,2020-05-25,El Salvador,0,96,1915,"rgb(230,171,2)"
25425,2020-05-26,El Salvador,1,68,1983,"rgb(230,171,2)"
25426,2020-05-27,El Salvador,0,59,2042,"rgb(230,171,2)"
25427,2020-05-28,El Salvador,3,67,2109,"rgb(230,171,2)"
25428,2020-05-29,El Salvador,0,85,2194,"rgb(230,171,2)"
25429,2020-05-30,El Salvador,4,84,2278,"rgb(230,171,2)"
25430,2020-05-31,El Salvador,3,239,2517,"rgb(230,171,2)"
25431,2020-06-01,El Salvador,0,0,2517,"rgb(230,171,2)"
25432,2020-06-02,El Salvador,0,65,2582,"rgb(230,171,2)"
25433,2020-06-03,El Salvador,3,71,2653,"rgb(230,171,2)"
25434,2020-06-04,El Salvador,2,52,2705,"rgb(230,171,2)"
25435,2020-06-05,El Salvador,1,76,2781,"rgb(230,171,2)"
25436,2020-06-06,El Salvador,1,68,2849,"rgb(230,171,2)"
25437,2020-06-07,El Salvador,0,85,2934,"rgb(230,171,2)"
25438,2020-06-08,El Salvador,2,81,3015,"rgb(230,171,2)"
25439,2020-06-09,El Salvador,3,89,3104,"rgb(230,171,2)"
25440,2020-06-10,El Salvador,2,87,3191,"rgb(230,171,2)"
25441,2020-06-11,El Salvador,4,83,3274,"rgb(230,171,2)"
25442,2020-06-12,El Salvador,4,207,3481,"rgb(230,171,2)"
25443,2020-06-13,El Salvador,4,0,3481,"rgb(230,171,2)"
25444,2020-06-14,El Salvador,0,122,3603,"rgb(230,171,2)"
25445,2020-06-15,El Salvador,2,117,3720,"rgb(230,171,2)"
25446,2020-06-16,El Salvador,2,106,3826,"rgb(230,171,2)"
25447,2020-06-17,El Salvador,2,115,3941,"rgb(230,171,2)"
25448,2020-06-18,El Salvador,4,125,4066,"rgb(230,171,2)"
25449,2020-06-19,El Salvador,4,134,4200,"rgb(230,171,2)"
25450,2020-06-20,El Salvador,7,129,4329,"rgb(230,171,2)"
25451,2020-06-21,El Salvador,5,297,4626,"rgb(230,171,2)"
25452,2020-06-22,El Salvador,9,0,4626,"rgb(230,171,2)"
25453,2020-06-23,El Salvador,0,182,4808,"rgb(230,171,2)"
25454,2020-06-24,El Salvador,6,165,4973,"rgb(230,171,2)"
25455,2020-06-25,El Salvador,13,177,5150,"rgb(230,171,2)"
25456,2020-06-26,El Salvador,7,186,5336,"rgb(230,171,2)"
25457,2020-06-27,El Salvador,10,181,5517,"rgb(230,171,2)"
25458,2020-06-28,El Salvador,9,417,5934,"rgb(230,171,2)"
25459,2020-06-29,El Salvador,12,0,5934,"rgb(230,171,2)"
25460,2020-06-30,El Salvador,0,239,6173,"rgb(230,171,2)"
25461,2020-07-01,El Salvador,10,265,6438,"rgb(230,171,2)"
25462,2020-07-02,El Salvador,8,298,6736,"rgb(230,171,2)"
25463,2020-07-03,El Salvador,9,264,7000,"rgb(230,171,2)"
25464,2020-07-04,El Salvador,19,267,7267,"rgb(230,171,2)"
25465,2020-07-05,El Salvador,0,240,7507,"rgb(230,171,2)"
25466,2020-07-06,El Salvador,7,270,7777,"rgb(230,171,2)"
25467,2020-07-07,El Salvador,6,250,8027,"rgb(230,171,2)"
25468,2020-07-08,El Salvador,6,280,8307,"rgb(230,171,2)"
25469,2020-07-09,El Salvador,6,259,8566,"rgb(230,171,2)"
25470,2020-07-10,El Salvador,8,278,8844,"rgb(230,171,2)"
25471,2020-07-11,El Salvador,6,298,9142,"rgb(230,171,2)"
25472,2020-07-12,El Salvador,5,249,9391,"rgb(230,171,2)"
25473,2020-07-13,El Salvador,13,283,9674,"rgb(230,171,2)"
25474,2020-03-03,Netherlands - Sint Maarten,0,1,1,"rgb(166,118,29)"
25475,2020-03-26,Netherlands - Sint Maarten,0,1,2,"rgb(166,118,29)"
25476,2020-03-27,Netherlands - Sint Maarten,0,0,2,"rgb(166,118,29)"
25477,2020-03-28,Netherlands - Sint Maarten,0,1,3,"rgb(166,118,29)"
25478,2020-03-29,Netherlands - Sint Maarten,0,0,3,"rgb(166,118,29)"
25479,2020-03-30,Netherlands - Sint Maarten,0,0,3,"rgb(166,118,29)"
25480,2020-04-01,Netherlands - Sint Maarten,0,3,6,"rgb(166,118,29)"
25481,2020-04-02,Netherlands - Sint Maarten,1,10,16,"rgb(166,118,29)"
25482,2020-04-03,Netherlands - Sint Maarten,1,7,23,"rgb(166,118,29)"
25483,2020-04-04,Netherlands - Sint Maarten,0,0,23,"rgb(166,118,29)"
25484,2020-04-05,Netherlands - Sint Maarten,0,0,23,"rgb(166,118,29)"
25485,2020-04-06,Netherlands - Sint Maarten,2,2,25,"rgb(166,118,29)"
25486,2020-04-07,Netherlands - Sint Maarten,0,0,25,"rgb(166,118,29)"
25487,2020-04-08,Netherlands - Sint Maarten,4,15,40,"rgb(166,118,29)"
25488,2020-04-09,Netherlands - Sint Maarten,0,0,40,"rgb(166,118,29)"
25489,2020-04-10,Netherlands - Sint Maarten,0,10,50,"rgb(166,118,29)"
25490,2020-04-11,Netherlands - Sint Maarten,1,0,50,"rgb(166,118,29)"
25491,2020-04-12,Netherlands - Sint Maarten,0,0,50,"rgb(166,118,29)"
25492,2020-04-13,Netherlands - Sint Maarten,0,0,50,"rgb(166,118,29)"
25493,2020-04-14,Netherlands - Sint Maarten,0,2,52,"rgb(166,118,29)"
25494,2020-04-15,Netherlands - Sint Maarten,0,0,52,"rgb(166,118,29)"
25495,2020-04-16,Netherlands - Sint Maarten,0,5,57,"rgb(166,118,29)"
25496,2020-04-17,Netherlands - Sint Maarten,0,0,57,"rgb(166,118,29)"
25497,2020-04-18,Netherlands - Sint Maarten,0,0,57,"rgb(166,118,29)"
25498,2020-04-19,Netherlands - Sint Maarten,0,7,64,"rgb(166,118,29)"
25499,2020-04-20,Netherlands - Sint Maarten,1,3,67,"rgb(166,118,29)"
25500,2020-04-21,Netherlands - Sint Maarten,0,1,68,"rgb(166,118,29)"
25501,2020-04-22,Netherlands - Sint Maarten,0,0,68,"rgb(166,118,29)"
25502,2020-04-23,Netherlands - Sint Maarten,2,5,73,"rgb(166,118,29)"
25503,2020-04-24,Netherlands - Sint Maarten,0,0,73,"rgb(166,118,29)"
25504,2020-04-25,Netherlands - Sint Maarten,0,0,73,"rgb(166,118,29)"
25505,2020-04-26,Netherlands - Sint Maarten,0,0,73,"rgb(166,118,29)"
25506,2020-04-27,Netherlands - Sint Maarten,1,1,74,"rgb(166,118,29)"
25507,2020-04-28,Netherlands - Sint Maarten,0,1,75,"rgb(166,118,29)"
25508,2020-04-29,Netherlands - Sint Maarten,0,0,75,"rgb(166,118,29)"
25509,2020-04-30,Netherlands - Sint Maarten,0,1,76,"rgb(166,118,29)"
25510,2020-05-01,Netherlands - Sint Maarten,0,0,76,"rgb(166,118,29)"
25511,2020-05-02,Netherlands - Sint Maarten,0,0,76,"rgb(166,118,29)"
25512,2020-05-03,Netherlands - Sint Maarten,0,0,76,"rgb(166,118,29)"
25513,2020-05-04,Netherlands - Sint Maarten,0,0,76,"rgb(166,118,29)"
25514,2020-05-05,Netherlands - Sint Maarten,0,0,76,"rgb(166,118,29)"
25515,2020-05-06,Netherlands - Sint Maarten,1,0,76,"rgb(166,118,29)"
25516,2020-05-07,Netherlands - Sint Maarten,0,0,76,"rgb(166,118,29)"
25517,2020-05-08,Netherlands - Sint Maarten,0,0,76,"rgb(166,118,29)"
25518,2020-05-09,Netherlands - Sint Maarten,1,0,76,"rgb(166,118,29)"
25519,2020-05-10,Netherlands - Sint Maarten,0,0,76,"rgb(166,118,29)"
25520,2020-05-11,Netherlands - Sint Maarten,0,0,76,"rgb(166,118,29)"
25521,2020-05-12,Netherlands - Sint Maarten,0,0,76,"rgb(166,118,29)"
25522,2020-05-13,Netherlands - Sint Maarten,0,1,77,"rgb(166,118,29)"
25523,2020-05-14,Netherlands - Sint Maarten,0,0,77,"rgb(166,118,29)"
25524,2020-05-15,Netherlands - Sint Maarten,0,0,77,"rgb(166,118,29)"
25525,2020-05-16,Netherlands - Sint Maarten,0,0,77,"rgb(166,118,29)"
25526,2020-05-17,Netherlands - Sint Maarten,0,0,77,"rgb(166,118,29)"
25527,2020-05-18,Netherlands - Sint Maarten,0,0,77,"rgb(166,118,29)"
25528,2020-05-19,Netherlands - Sint Maarten,0,0,77,"rgb(166,118,29)"
25529,2020-05-20,Netherlands - Sint Maarten,0,0,77,"rgb(166,118,29)"
25530,2020-05-21,Netherlands - Sint Maarten,0,0,77,"rgb(166,118,29)"
25531,2020-05-22,Netherlands - Sint Maarten,0,0,77,"rgb(166,118,29)"
25532,2020-05-23,Netherlands - Sint Maarten,0,0,77,"rgb(166,118,29)"
25533,2020-05-24,Netherlands - Sint Maarten,0,0,77,"rgb(166,118,29)"
25534,2020-05-25,Netherlands - Sint Maarten,0,0,77,"rgb(166,118,29)"
25535,2020-05-26,Netherlands - Sint Maarten,0,0,77,"rgb(166,118,29)"
25536,2020-05-27,Netherlands - Sint Maarten,0,0,77,"rgb(166,118,29)"
25537,2020-05-28,Netherlands - Sint Maarten,0,0,77,"rgb(166,118,29)"
25538,2020-05-29,Netherlands - Sint Maarten,0,0,77,"rgb(166,118,29)"
25539,2020-05-30,Netherlands - Sint Maarten,0,0,77,"rgb(166,118,29)"
25540,2020-05-31,Netherlands - Sint Maarten,0,0,77,"rgb(166,118,29)"
25541,2020-06-01,Netherlands - Sint Maarten,0,0,77,"rgb(166,118,29)"
25542,2020-06-02,Netherlands - Sint Maarten,0,0,77,"rgb(166,118,29)"
25543,2020-06-03,Netherlands - Sint Maarten,0,0,77,"rgb(166,118,29)"
25544,2020-06-04,Netherlands - Sint Maarten,0,0,77,"rgb(166,118,29)"
25545,2020-06-05,Netherlands - Sint Maarten,0,0,77,"rgb(166,118,29)"
25546,2020-06-06,Netherlands - Sint Maarten,0,0,77,"rgb(166,118,29)"
25547,2020-06-07,Netherlands - Sint Maarten,0,0,77,"rgb(166,118,29)"
25548,2020-06-08,Netherlands - Sint Maarten,0,0,77,"rgb(166,118,29)"
25549,2020-06-09,Netherlands - Sint Maarten,0,0,77,"rgb(166,118,29)"
25550,2020-06-10,Netherlands - Sint Maarten,0,0,77,"rgb(166,118,29)"
25551,2020-06-11,Netherlands - Sint Maarten,0,0,77,"rgb(166,118,29)"
25552,2020-06-12,Netherlands - Sint Maarten,0,0,77,"rgb(166,118,29)"
25553,2020-06-13,Netherlands - Sint Maarten,0,0,77,"rgb(166,118,29)"
25554,2020-06-14,Netherlands - Sint Maarten,0,0,77,"rgb(166,118,29)"
25555,2020-06-15,Netherlands - Sint Maarten,0,0,77,"rgb(166,118,29)"
25556,2020-06-16,Netherlands - Sint Maarten,0,0,77,"rgb(166,118,29)"
25557,2020-06-17,Netherlands - Sint Maarten,0,0,77,"rgb(166,118,29)"
25558,2020-06-18,Netherlands - Sint Maarten,0,0,77,"rgb(166,118,29)"
25559,2020-06-19,Netherlands - Sint Maarten,0,0,77,"rgb(166,118,29)"
25560,2020-06-20,Netherlands - Sint Maarten,0,0,77,"rgb(166,118,29)"
25561,2020-06-21,Netherlands - Sint Maarten,0,0,77,"rgb(166,118,29)"
25562,2020-06-22,Netherlands - Sint Maarten,0,0,77,"rgb(166,118,29)"
25563,2020-06-23,Netherlands - Sint Maarten,0,0,77,"rgb(166,118,29)"
25564,2020-06-24,Netherlands - Sint Maarten,0,0,77,"rgb(166,118,29)"
25565,2020-06-25,Netherlands - Sint Maarten,0,0,77,"rgb(166,118,29)"
25566,2020-06-26,Netherlands - Sint Maarten,0,0,77,"rgb(166,118,29)"
25567,2020-06-27,Netherlands - Sint Maarten,0,0,77,"rgb(166,118,29)"
25568,2020-06-28,Netherlands - Sint Maarten,0,0,77,"rgb(166,118,29)"
25569,2020-06-29,Netherlands - Sint Maarten,0,0,77,"rgb(166,118,29)"
25570,2020-06-30,Netherlands - Sint Maarten,0,0,77,"rgb(166,118,29)"
25571,2020-07-01,Netherlands - Sint Maarten,0,0,77,"rgb(166,118,29)"
25572,2020-07-02,Netherlands - Sint Maarten,0,0,77,"rgb(166,118,29)"
25573,2020-07-03,Netherlands - Sint Maarten,0,0,77,"rgb(166,118,29)"
25574,2020-07-04,Netherlands - Sint Maarten,0,0,77,"rgb(166,118,29)"
25575,2020-07-05,Netherlands - Sint Maarten,0,1,78,"rgb(166,118,29)"
25576,2020-07-06,Netherlands - Sint Maarten,0,0,78,"rgb(166,118,29)"
25577,2020-07-07,Netherlands - Sint Maarten,0,0,78,"rgb(166,118,29)"
25578,2020-07-08,Netherlands - Sint Maarten,0,0,78,"rgb(166,118,29)"
25579,2020-07-09,Netherlands - Sint Maarten,0,0,78,"rgb(166,118,29)"
25580,2020-07-10,Netherlands - Sint Maarten,0,0,78,"rgb(166,118,29)"
25581,2020-07-11,Netherlands - Sint Maarten,0,0,78,"rgb(166,118,29)"
25582,2020-07-12,Netherlands - Sint Maarten,0,0,78,"rgb(166,118,29)"
25583,2020-07-13,Netherlands - Sint Maarten,0,0,78,"rgb(166,118,29)"
25584,2020-03-23,Syria,0,1,1,"rgb(102,102,102)"
25585,2020-03-24,Syria,0,0,1,"rgb(102,102,102)"
25586,2020-03-25,Syria,0,0,1,"rgb(102,102,102)"
25587,2020-03-26,Syria,0,0,1,"rgb(102,102,102)"
25588,2020-03-27,Syria,0,4,5,"rgb(102,102,102)"
25589,2020-03-28,Syria,0,0,5,"rgb(102,102,102)"
25590,2020-03-29,Syria,0,0,5,"rgb(102,102,102)"
25591,2020-03-30,Syria,1,4,9,"rgb(102,102,102)"
25592,2020-03-31,Syria,1,1,10,"rgb(102,102,102)"
25593,2020-04-01,Syria,0,0,10,"rgb(102,102,102)"
25594,2020-04-02,Syria,0,0,10,"rgb(102,102,102)"
25595,2020-04-03,Syria,0,6,16,"rgb(102,102,102)"
25596,2020-04-04,Syria,0,0,16,"rgb(102,102,102)"
25597,2020-04-05,Syria,0,0,16,"rgb(102,102,102)"
25598,2020-04-06,Syria,0,3,19,"rgb(102,102,102)"
25599,2020-04-07,Syria,0,0,19,"rgb(102,102,102)"
25600,2020-04-08,Syria,0,0,19,"rgb(102,102,102)"
25601,2020-04-09,Syria,0,0,19,"rgb(102,102,102)"
25602,2020-04-10,Syria,0,0,19,"rgb(102,102,102)"
25603,2020-04-11,Syria,0,0,19,"rgb(102,102,102)"
25604,2020-04-12,Syria,0,6,25,"rgb(102,102,102)"
25605,2020-04-13,Syria,0,0,25,"rgb(102,102,102)"
25606,2020-04-14,Syria,0,0,25,"rgb(102,102,102)"
25607,2020-04-15,Syria,0,4,29,"rgb(102,102,102)"
25608,2020-04-16,Syria,0,4,33,"rgb(102,102,102)"
25609,2020-04-17,Syria,0,0,33,"rgb(102,102,102)"
25610,2020-04-18,Syria,0,5,38,"rgb(102,102,102)"
25611,2020-04-19,Syria,0,0,38,"rgb(102,102,102)"
25612,2020-04-20,Syria,1,1,39,"rgb(102,102,102)"
25613,2020-04-21,Syria,0,0,39,"rgb(102,102,102)"
25614,2020-04-22,Syria,0,3,42,"rgb(102,102,102)"
25615,2020-04-23,Syria,0,0,42,"rgb(102,102,102)"
25616,2020-04-24,Syria,0,0,42,"rgb(102,102,102)"
25617,2020-04-25,Syria,0,0,42,"rgb(102,102,102)"
25618,2020-04-26,Syria,0,0,42,"rgb(102,102,102)"
25619,2020-04-27,Syria,0,1,43,"rgb(102,102,102)"
25620,2020-04-28,Syria,0,0,43,"rgb(102,102,102)"
25621,2020-04-29,Syria,0,0,43,"rgb(102,102,102)"
25622,2020-04-30,Syria,0,0,43,"rgb(102,102,102)"
25623,2020-05-01,Syria,0,0,43,"rgb(102,102,102)"
25624,2020-05-02,Syria,0,1,44,"rgb(102,102,102)"
25625,2020-05-03,Syria,0,0,44,"rgb(102,102,102)"
25626,2020-05-04,Syria,0,0,44,"rgb(102,102,102)"
25627,2020-05-05,Syria,0,0,44,"rgb(102,102,102)"
25628,2020-05-06,Syria,0,0,44,"rgb(102,102,102)"
25629,2020-05-07,Syria,0,1,45,"rgb(102,102,102)"
25630,2020-05-08,Syria,0,0,45,"rgb(102,102,102)"
25631,2020-05-09,Syria,0,2,47,"rgb(102,102,102)"
25632,2020-05-10,Syria,0,0,47,"rgb(102,102,102)"
25633,2020-05-11,Syria,0,0,47,"rgb(102,102,102)"
25634,2020-05-12,Syria,0,0,47,"rgb(102,102,102)"
25635,2020-05-13,Syria,0,0,47,"rgb(102,102,102)"
25636,2020-05-14,Syria,0,1,48,"rgb(102,102,102)"
25637,2020-05-15,Syria,0,0,48,"rgb(102,102,102)"
25638,2020-05-16,Syria,0,2,50,"rgb(102,102,102)"
25639,2020-05-17,Syria,0,1,51,"rgb(102,102,102)"
25640,2020-05-18,Syria,0,7,58,"rgb(102,102,102)"
25641,2020-05-19,Syria,0,0,58,"rgb(102,102,102)"
25642,2020-05-20,Syria,0,0,58,"rgb(102,102,102)"
25643,2020-05-21,Syria,0,0,58,"rgb(102,102,102)"
25644,2020-05-22,Syria,0,0,58,"rgb(102,102,102)"
25645,2020-05-23,Syria,1,1,59,"rgb(102,102,102)"
25646,2020-05-24,Syria,0,11,70,"rgb(102,102,102)"
25647,2020-05-25,Syria,0,16,86,"rgb(102,102,102)"
25648,2020-05-26,Syria,0,20,106,"rgb(102,102,102)"
25649,2020-05-27,Syria,0,15,121,"rgb(102,102,102)"
25650,2020-05-28,Syria,0,0,121,"rgb(102,102,102)"
25651,2020-05-29,Syria,0,0,121,"rgb(102,102,102)"
25652,2020-05-30,Syria,0,1,122,"rgb(102,102,102)"
25653,2020-05-31,Syria,0,0,122,"rgb(102,102,102)"
25654,2020-06-01,Syria,0,0,122,"rgb(102,102,102)"
25655,2020-06-02,Syria,1,1,123,"rgb(102,102,102)"
25656,2020-06-03,Syria,1,0,123,"rgb(102,102,102)"
25657,2020-06-04,Syria,0,0,123,"rgb(102,102,102)"
25658,2020-06-05,Syria,0,1,124,"rgb(102,102,102)"
25659,2020-06-06,Syria,0,0,124,"rgb(102,102,102)"
25660,2020-06-07,Syria,0,0,124,"rgb(102,102,102)"
25661,2020-06-08,Syria,0,17,141,"rgb(102,102,102)"
25662,2020-06-09,Syria,0,3,144,"rgb(102,102,102)"
25663,2020-06-10,Syria,0,2,146,"rgb(102,102,102)"
25664,2020-06-11,Syria,0,6,152,"rgb(102,102,102)"
25665,2020-06-12,Syria,0,12,164,"rgb(102,102,102)"
25666,2020-06-13,Syria,0,0,164,"rgb(102,102,102)"
25667,2020-06-14,Syria,0,6,170,"rgb(102,102,102)"
25668,2020-06-15,Syria,0,7,177,"rgb(102,102,102)"
25669,2020-06-16,Syria,0,0,177,"rgb(102,102,102)"
25670,2020-06-17,Syria,0,0,177,"rgb(102,102,102)"
25671,2020-06-18,Syria,1,1,178,"rgb(102,102,102)"
25672,2020-06-19,Syria,0,9,187,"rgb(102,102,102)"
25673,2020-06-20,Syria,0,0,187,"rgb(102,102,102)"
25674,2020-06-21,Syria,0,11,198,"rgb(102,102,102)"
25675,2020-06-22,Syria,0,6,204,"rgb(102,102,102)"
25676,2020-06-23,Syria,0,15,219,"rgb(102,102,102)"
25677,2020-06-24,Syria,0,12,231,"rgb(102,102,102)"
25678,2020-06-25,Syria,0,0,231,"rgb(102,102,102)"
25679,2020-06-26,Syria,0,11,242,"rgb(102,102,102)"
25680,2020-06-27,Syria,1,13,255,"rgb(102,102,102)"
25681,2020-06-28,Syria,1,1,256,"rgb(102,102,102)"
25682,2020-06-29,Syria,0,0,256,"rgb(102,102,102)"
25683,2020-06-30,Syria,0,13,269,"rgb(102,102,102)"
25684,2020-07-01,Syria,0,10,279,"rgb(102,102,102)"
25685,2020-07-02,Syria,0,14,293,"rgb(102,102,102)"
25686,2020-07-03,Syria,0,19,312,"rgb(102,102,102)"
25687,2020-07-04,Syria,1,16,328,"rgb(102,102,102)"
25688,2020-07-05,Syria,0,10,338,"rgb(102,102,102)"
25689,2020-07-06,Syria,3,20,358,"rgb(102,102,102)"
25690,2020-07-07,Syria,1,14,372,"rgb(102,102,102)"
25691,2020-07-08,Syria,0,0,372,"rgb(102,102,102)"
25692,2020-07-09,Syria,0,0,372,"rgb(102,102,102)"
25693,2020-07-10,Syria,0,0,372,"rgb(102,102,102)"
25694,2020-07-11,Syria,2,22,394,"rgb(102,102,102)"
25695,2020-07-12,Syria,0,0,394,"rgb(102,102,102)"
25696,2020-07-13,Syria,0,0,394,"rgb(102,102,102)"
25697,2020-03-15,Eswatini,0,1,1,"rgb(102, 197, 204)"
25698,2020-03-16,Eswatini,0,0,1,"rgb(102, 197, 204)"
25699,2020-03-17,Eswatini,0,0,1,"rgb(102, 197, 204)"
25700,2020-03-18,Eswatini,0,0,1,"rgb(102, 197, 204)"
25701,2020-03-19,Eswatini,0,0,1,"rgb(102, 197, 204)"
25702,2020-03-20,Eswatini,0,0,1,"rgb(102, 197, 204)"
25703,2020-03-21,Eswatini,0,0,1,"rgb(102, 197, 204)"
25704,2020-03-22,Eswatini,0,0,1,"rgb(102, 197, 204)"
25705,2020-03-23,Eswatini,0,3,4,"rgb(102, 197, 204)"
25706,2020-03-24,Eswatini,0,0,4,"rgb(102, 197, 204)"
25707,2020-03-25,Eswatini,0,0,4,"rgb(102, 197, 204)"
25708,2020-03-26,Eswatini,0,0,4,"rgb(102, 197, 204)"
25709,2020-03-27,Eswatini,0,2,6,"rgb(102, 197, 204)"
25710,2020-03-28,Eswatini,0,3,9,"rgb(102, 197, 204)"
25711,2020-03-29,Eswatini,0,0,9,"rgb(102, 197, 204)"
25712,2020-03-30,Eswatini,0,0,9,"rgb(102, 197, 204)"
25713,2020-03-31,Eswatini,0,0,9,"rgb(102, 197, 204)"
25714,2020-04-01,Eswatini,0,0,9,"rgb(102, 197, 204)"
25715,2020-04-02,Eswatini,0,0,9,"rgb(102, 197, 204)"
25716,2020-04-03,Eswatini,0,0,9,"rgb(102, 197, 204)"
25717,2020-04-04,Eswatini,0,0,9,"rgb(102, 197, 204)"
25718,2020-04-05,Eswatini,0,0,9,"rgb(102, 197, 204)"
25719,2020-04-06,Eswatini,0,0,9,"rgb(102, 197, 204)"
25720,2020-04-07,Eswatini,0,1,10,"rgb(102, 197, 204)"
25721,2020-04-08,Eswatini,0,0,10,"rgb(102, 197, 204)"
25722,2020-04-09,Eswatini,0,2,12,"rgb(102, 197, 204)"
25723,2020-04-10,Eswatini,0,0,12,"rgb(102, 197, 204)"
25724,2020-04-11,Eswatini,0,0,12,"rgb(102, 197, 204)"
25725,2020-04-12,Eswatini,0,2,14,"rgb(102, 197, 204)"
25726,2020-04-13,Eswatini,0,0,14,"rgb(102, 197, 204)"
25727,2020-04-14,Eswatini,0,1,15,"rgb(102, 197, 204)"
25728,2020-04-15,Eswatini,0,0,15,"rgb(102, 197, 204)"
25729,2020-04-16,Eswatini,0,1,16,"rgb(102, 197, 204)"
25730,2020-04-17,Eswatini,0,0,16,"rgb(102, 197, 204)"
25731,2020-04-18,Eswatini,1,3,19,"rgb(102, 197, 204)"
25732,2020-04-19,Eswatini,0,0,19,"rgb(102, 197, 204)"
25733,2020-04-20,Eswatini,0,3,22,"rgb(102, 197, 204)"
25734,2020-04-21,Eswatini,0,2,24,"rgb(102, 197, 204)"
25735,2020-04-22,Eswatini,0,0,24,"rgb(102, 197, 204)"
25736,2020-04-23,Eswatini,0,7,31,"rgb(102, 197, 204)"
25737,2020-04-24,Eswatini,0,1,32,"rgb(102, 197, 204)"
25738,2020-04-25,Eswatini,0,8,40,"rgb(102, 197, 204)"
25739,2020-04-26,Eswatini,0,0,40,"rgb(102, 197, 204)"
25740,2020-04-27,Eswatini,0,19,59,"rgb(102, 197, 204)"
25741,2020-04-28,Eswatini,0,6,65,"rgb(102, 197, 204)"
25742,2020-04-29,Eswatini,0,6,71,"rgb(102, 197, 204)"
25743,2020-04-30,Eswatini,0,20,91,"rgb(102, 197, 204)"
25744,2020-05-01,Eswatini,0,9,100,"rgb(102, 197, 204)"
25745,2020-05-02,Eswatini,0,6,106,"rgb(102, 197, 204)"
25746,2020-05-03,Eswatini,0,2,108,"rgb(102, 197, 204)"
25747,2020-05-04,Eswatini,0,4,112,"rgb(102, 197, 204)"
25748,2020-05-05,Eswatini,0,4,116,"rgb(102, 197, 204)"
25749,2020-05-06,Eswatini,0,0,116,"rgb(102, 197, 204)"
25750,2020-05-07,Eswatini,1,7,123,"rgb(102, 197, 204)"
25751,2020-05-08,Eswatini,0,30,153,"rgb(102, 197, 204)"
25752,2020-05-09,Eswatini,0,6,159,"rgb(102, 197, 204)"
25753,2020-05-10,Eswatini,0,4,163,"rgb(102, 197, 204)"
25754,2020-05-11,Eswatini,0,9,172,"rgb(102, 197, 204)"
25755,2020-05-12,Eswatini,0,3,175,"rgb(102, 197, 204)"
25756,2020-05-13,Eswatini,0,9,184,"rgb(102, 197, 204)"
25757,2020-05-14,Eswatini,0,3,187,"rgb(102, 197, 204)"
25758,2020-05-15,Eswatini,0,0,187,"rgb(102, 197, 204)"
25759,2020-05-16,Eswatini,0,3,190,"rgb(102, 197, 204)"
25760,2020-05-17,Eswatini,0,12,202,"rgb(102, 197, 204)"
25761,2020-05-18,Eswatini,0,1,203,"rgb(102, 197, 204)"
25762,2020-05-19,Eswatini,0,0,203,"rgb(102, 197, 204)"
25763,2020-05-20,Eswatini,0,5,208,"rgb(102, 197, 204)"
25764,2020-05-21,Eswatini,0,9,217,"rgb(102, 197, 204)"
25765,2020-05-22,Eswatini,0,3,220,"rgb(102, 197, 204)"
25766,2020-05-23,Eswatini,0,0,220,"rgb(102, 197, 204)"
25767,2020-05-24,Eswatini,0,18,238,"rgb(102, 197, 204)"
25768,2020-05-25,Eswatini,0,12,250,"rgb(102, 197, 204)"
25769,2020-05-26,Eswatini,0,6,256,"rgb(102, 197, 204)"
25770,2020-05-27,Eswatini,0,5,261,"rgb(102, 197, 204)"
25771,2020-05-28,Eswatini,0,11,272,"rgb(102, 197, 204)"
25772,2020-05-29,Eswatini,0,7,279,"rgb(102, 197, 204)"
25773,2020-05-30,Eswatini,0,0,279,"rgb(102, 197, 204)"
25774,2020-05-31,Eswatini,0,4,283,"rgb(102, 197, 204)"
25775,2020-06-01,Eswatini,0,2,285,"rgb(102, 197, 204)"
25776,2020-06-02,Eswatini,1,8,293,"rgb(102, 197, 204)"
25777,2020-06-03,Eswatini,0,0,293,"rgb(102, 197, 204)"
25778,2020-06-04,Eswatini,0,2,295,"rgb(102, 197, 204)"
25779,2020-06-05,Eswatini,0,5,300,"rgb(102, 197, 204)"
25780,2020-06-06,Eswatini,0,5,305,"rgb(102, 197, 204)"
25781,2020-06-07,Eswatini,0,17,322,"rgb(102, 197, 204)"
25782,2020-06-08,Eswatini,0,11,333,"rgb(102, 197, 204)"
25783,2020-06-09,Eswatini,0,7,340,"rgb(102, 197, 204)"
25784,2020-06-10,Eswatini,0,31,371,"rgb(102, 197, 204)"
25785,2020-06-11,Eswatini,0,27,398,"rgb(102, 197, 204)"
25786,2020-06-12,Eswatini,0,51,449,"rgb(102, 197, 204)"
25787,2020-06-13,Eswatini,0,23,472,"rgb(102, 197, 204)"
25788,2020-06-14,Eswatini,0,14,486,"rgb(102, 197, 204)"
25789,2020-06-15,Eswatini,1,4,490,"rgb(102, 197, 204)"
25790,2020-06-16,Eswatini,0,16,506,"rgb(102, 197, 204)"
25791,2020-06-17,Eswatini,0,14,520,"rgb(102, 197, 204)"
25792,2020-06-18,Eswatini,0,43,563,"rgb(102, 197, 204)"
25793,2020-06-19,Eswatini,0,23,586,"rgb(102, 197, 204)"
25794,2020-06-20,Eswatini,0,37,623,"rgb(102, 197, 204)"
25795,2020-06-21,Eswatini,1,4,627,"rgb(102, 197, 204)"
25796,2020-06-22,Eswatini,0,8,635,"rgb(102, 197, 204)"
25797,2020-06-23,Eswatini,1,8,643,"rgb(102, 197, 204)"
25798,2020-06-24,Eswatini,1,31,674,"rgb(102, 197, 204)"
25799,2020-06-25,Eswatini,0,16,690,"rgb(102, 197, 204)"
25800,2020-06-26,Eswatini,1,16,706,"rgb(102, 197, 204)"
25801,2020-06-27,Eswatini,0,22,728,"rgb(102, 197, 204)"
25802,2020-06-28,Eswatini,0,17,745,"rgb(102, 197, 204)"
25803,2020-06-29,Eswatini,3,36,781,"rgb(102, 197, 204)"
25804,2020-06-30,Eswatini,0,14,795,"rgb(102, 197, 204)"
25805,2020-07-01,Eswatini,0,17,812,"rgb(102, 197, 204)"
25806,2020-07-02,Eswatini,0,28,840,"rgb(102, 197, 204)"
25807,2020-07-03,Eswatini,0,33,873,"rgb(102, 197, 204)"
25808,2020-07-04,Eswatini,2,36,909,"rgb(102, 197, 204)"
25809,2020-07-05,Eswatini,0,45,954,"rgb(102, 197, 204)"
25810,2020-07-06,Eswatini,0,34,988,"rgb(102, 197, 204)"
25811,2020-07-07,Eswatini,0,23,1011,"rgb(102, 197, 204)"
25812,2020-07-08,Eswatini,1,45,1056,"rgb(102, 197, 204)"
25813,2020-07-09,Eswatini,0,82,1138,"rgb(102, 197, 204)"
25814,2020-07-10,Eswatini,3,75,1213,"rgb(102, 197, 204)"
25815,2020-07-11,Eswatini,1,44,1257,"rgb(102, 197, 204)"
25816,2020-07-12,Eswatini,0,54,1311,"rgb(102, 197, 204)"
25817,2020-07-13,Eswatini,2,40,1351,"rgb(102, 197, 204)"
25818,2020-03-25,Turks and Caicos Islands,0,1,1,"rgb(246, 207, 113)"
25819,2020-03-26,Turks and Caicos Islands,0,0,1,"rgb(246, 207, 113)"
25820,2020-03-27,Turks and Caicos Islands,0,1,2,"rgb(246, 207, 113)"
25821,2020-03-28,Turks and Caicos Islands,0,0,2,"rgb(246, 207, 113)"
25822,2020-03-29,Turks and Caicos Islands,0,3,5,"rgb(246, 207, 113)"
25823,2020-03-30,Turks and Caicos Islands,0,0,5,"rgb(246, 207, 113)"
25824,2020-03-31,Turks and Caicos Islands,0,0,5,"rgb(246, 207, 113)"
25825,2020-04-01,Turks and Caicos Islands,0,0,5,"rgb(246, 207, 113)"
25826,2020-04-02,Turks and Caicos Islands,0,0,5,"rgb(246, 207, 113)"
25827,2020-04-03,Turks and Caicos Islands,0,0,5,"rgb(246, 207, 113)"
25828,2020-04-04,Turks and Caicos Islands,0,0,5,"rgb(246, 207, 113)"
25829,2020-04-05,Turks and Caicos Islands,0,0,5,"rgb(246, 207, 113)"
25830,2020-04-06,Turks and Caicos Islands,1,0,5,"rgb(246, 207, 113)"
25831,2020-04-07,Turks and Caicos Islands,0,3,8,"rgb(246, 207, 113)"
25832,2020-04-08,Turks and Caicos Islands,0,0,8,"rgb(246, 207, 113)"
25833,2020-04-09,Turks and Caicos Islands,0,0,8,"rgb(246, 207, 113)"
25834,2020-04-10,Turks and Caicos Islands,0,0,8,"rgb(246, 207, 113)"
25835,2020-04-11,Turks and Caicos Islands,0,1,9,"rgb(246, 207, 113)"
25836,2020-04-12,Turks and Caicos Islands,0,0,9,"rgb(246, 207, 113)"
25837,2020-04-13,Turks and Caicos Islands,0,0,9,"rgb(246, 207, 113)"
25838,2020-04-14,Turks and Caicos Islands,0,1,10,"rgb(246, 207, 113)"
25839,2020-04-15,Turks and Caicos Islands,0,0,10,"rgb(246, 207, 113)"
25840,2020-04-16,Turks and Caicos Islands,0,1,11,"rgb(246, 207, 113)"
25841,2020-04-17,Turks and Caicos Islands,0,0,11,"rgb(246, 207, 113)"
25842,2020-04-18,Turks and Caicos Islands,0,0,11,"rgb(246, 207, 113)"
25843,2020-04-19,Turks and Caicos Islands,0,0,11,"rgb(246, 207, 113)"
25844,2020-04-20,Turks and Caicos Islands,0,0,11,"rgb(246, 207, 113)"
25845,2020-04-21,Turks and Caicos Islands,0,0,11,"rgb(246, 207, 113)"
25846,2020-04-22,Turks and Caicos Islands,0,0,11,"rgb(246, 207, 113)"
25847,2020-04-23,Turks and Caicos Islands,0,0,11,"rgb(246, 207, 113)"
25848,2020-04-24,Turks and Caicos Islands,0,0,11,"rgb(246, 207, 113)"
25849,2020-04-25,Turks and Caicos Islands,0,0,11,"rgb(246, 207, 113)"
25850,2020-04-26,Turks and Caicos Islands,0,0,11,"rgb(246, 207, 113)"
25851,2020-04-27,Turks and Caicos Islands,0,0,11,"rgb(246, 207, 113)"
25852,2020-04-28,Turks and Caicos Islands,0,1,12,"rgb(246, 207, 113)"
25853,2020-04-29,Turks and Caicos Islands,0,0,12,"rgb(246, 207, 113)"
25854,2020-04-30,Turks and Caicos Islands,0,0,12,"rgb(246, 207, 113)"
25855,2020-05-01,Turks and Caicos Islands,0,0,12,"rgb(246, 207, 113)"
25856,2020-05-02,Turks and Caicos Islands,0,0,12,"rgb(246, 207, 113)"
25857,2020-05-03,Turks and Caicos Islands,0,0,12,"rgb(246, 207, 113)"
25858,2020-05-04,Turks and Caicos Islands,0,0,12,"rgb(246, 207, 113)"
25859,2020-05-05,Turks and Caicos Islands,0,0,12,"rgb(246, 207, 113)"
25860,2020-05-06,Turks and Caicos Islands,0,0,12,"rgb(246, 207, 113)"
25861,2020-05-07,Turks and Caicos Islands,0,0,12,"rgb(246, 207, 113)"
25862,2020-05-08,Turks and Caicos Islands,0,0,12,"rgb(246, 207, 113)"
25863,2020-05-09,Turks and Caicos Islands,0,0,12,"rgb(246, 207, 113)"
25864,2020-05-10,Turks and Caicos Islands,0,0,12,"rgb(246, 207, 113)"
25865,2020-05-11,Turks and Caicos Islands,0,0,12,"rgb(246, 207, 113)"
25866,2020-05-12,Turks and Caicos Islands,0,0,12,"rgb(246, 207, 113)"
25867,2020-05-13,Turks and Caicos Islands,0,0,12,"rgb(246, 207, 113)"
25868,2020-05-14,Turks and Caicos Islands,0,0,12,"rgb(246, 207, 113)"
25869,2020-05-15,Turks and Caicos Islands,0,0,12,"rgb(246, 207, 113)"
25870,2020-05-16,Turks and Caicos Islands,0,0,12,"rgb(246, 207, 113)"
25871,2020-05-17,Turks and Caicos Islands,0,0,12,"rgb(246, 207, 113)"
25872,2020-05-18,Turks and Caicos Islands,0,0,12,"rgb(246, 207, 113)"
25873,2020-05-19,Turks and Caicos Islands,0,0,12,"rgb(246, 207, 113)"
25874,2020-05-20,Turks and Caicos Islands,0,0,12,"rgb(246, 207, 113)"
25875,2020-05-21,Turks and Caicos Islands,0,0,12,"rgb(246, 207, 113)"
25876,2020-05-22,Turks and Caicos Islands,0,0,12,"rgb(246, 207, 113)"
25877,2020-05-23,Turks and Caicos Islands,0,0,12,"rgb(246, 207, 113)"
25878,2020-05-24,Turks and Caicos Islands,0,0,12,"rgb(246, 207, 113)"
25879,2020-05-25,Turks and Caicos Islands,0,0,12,"rgb(246, 207, 113)"
25880,2020-05-26,Turks and Caicos Islands,0,0,12,"rgb(246, 207, 113)"
25881,2020-05-27,Turks and Caicos Islands,0,0,12,"rgb(246, 207, 113)"
25882,2020-05-28,Turks and Caicos Islands,0,0,12,"rgb(246, 207, 113)"
25883,2020-05-29,Turks and Caicos Islands,0,0,12,"rgb(246, 207, 113)"
25884,2020-05-30,Turks and Caicos Islands,0,0,12,"rgb(246, 207, 113)"
25885,2020-05-31,Turks and Caicos Islands,0,0,12,"rgb(246, 207, 113)"
25886,2020-06-01,Turks and Caicos Islands,0,0,12,"rgb(246, 207, 113)"
25887,2020-06-02,Turks and Caicos Islands,0,0,12,"rgb(246, 207, 113)"
25888,2020-06-03,Turks and Caicos Islands,0,0,12,"rgb(246, 207, 113)"
25889,2020-06-04,Turks and Caicos Islands,0,0,12,"rgb(246, 207, 113)"
25890,2020-06-05,Turks and Caicos Islands,0,0,12,"rgb(246, 207, 113)"
25891,2020-06-06,Turks and Caicos Islands,0,0,12,"rgb(246, 207, 113)"
25892,2020-06-07,Turks and Caicos Islands,0,0,12,"rgb(246, 207, 113)"
25893,2020-06-08,Turks and Caicos Islands,0,0,12,"rgb(246, 207, 113)"
25894,2020-06-09,Turks and Caicos Islands,0,0,12,"rgb(246, 207, 113)"
25895,2020-06-10,Turks and Caicos Islands,0,0,12,"rgb(246, 207, 113)"
25896,2020-06-11,Turks and Caicos Islands,0,0,12,"rgb(246, 207, 113)"
25897,2020-06-12,Turks and Caicos Islands,0,0,12,"rgb(246, 207, 113)"
25898,2020-06-13,Turks and Caicos Islands,0,0,12,"rgb(246, 207, 113)"
25899,2020-06-14,Turks and Caicos Islands,0,0,12,"rgb(246, 207, 113)"
25900,2020-06-15,Turks and Caicos Islands,0,0,12,"rgb(246, 207, 113)"
25901,2020-06-16,Turks and Caicos Islands,0,0,12,"rgb(246, 207, 113)"
25902,2020-06-17,Turks and Caicos Islands,0,0,12,"rgb(246, 207, 113)"
25903,2020-06-18,Turks and Caicos Islands,0,0,12,"rgb(246, 207, 113)"
25904,2020-06-19,Turks and Caicos Islands,0,0,12,"rgb(246, 207, 113)"
25905,2020-06-20,Turks and Caicos Islands,0,0,12,"rgb(246, 207, 113)"
25906,2020-06-21,Turks and Caicos Islands,0,0,12,"rgb(246, 207, 113)"
25907,2020-06-22,Turks and Caicos Islands,0,2,14,"rgb(246, 207, 113)"
25908,2020-06-23,Turks and Caicos Islands,0,0,14,"rgb(246, 207, 113)"
25909,2020-06-24,Turks and Caicos Islands,0,0,14,"rgb(246, 207, 113)"
25910,2020-06-25,Turks and Caicos Islands,0,1,15,"rgb(246, 207, 113)"
25911,2020-06-26,Turks and Caicos Islands,0,0,15,"rgb(246, 207, 113)"
25912,2020-06-27,Turks and Caicos Islands,0,0,15,"rgb(246, 207, 113)"
25913,2020-06-28,Turks and Caicos Islands,0,1,16,"rgb(246, 207, 113)"
25914,2020-06-29,Turks and Caicos Islands,0,12,28,"rgb(246, 207, 113)"
25915,2020-06-30,Turks and Caicos Islands,0,13,41,"rgb(246, 207, 113)"
25916,2020-07-01,Turks and Caicos Islands,1,0,41,"rgb(246, 207, 113)"
25917,2020-07-02,Turks and Caicos Islands,0,1,42,"rgb(246, 207, 113)"
25918,2020-07-03,Turks and Caicos Islands,0,2,44,"rgb(246, 207, 113)"
25919,2020-07-04,Turks and Caicos Islands,0,0,44,"rgb(246, 207, 113)"
25920,2020-07-05,Turks and Caicos Islands,0,1,45,"rgb(246, 207, 113)"
25921,2020-07-06,Turks and Caicos Islands,0,2,47,"rgb(246, 207, 113)"
25922,2020-07-07,Turks and Caicos Islands,0,2,49,"rgb(246, 207, 113)"
25923,2020-07-08,Turks and Caicos Islands,0,0,49,"rgb(246, 207, 113)"
25924,2020-07-09,Turks and Caicos Islands,0,6,55,"rgb(246, 207, 113)"
25925,2020-07-10,Turks and Caicos Islands,0,0,55,"rgb(246, 207, 113)"
25926,2020-07-11,Turks and Caicos Islands,0,11,66,"rgb(246, 207, 113)"
25927,2020-07-12,Turks and Caicos Islands,0,0,66,"rgb(246, 207, 113)"
25928,2020-07-13,Turks and Caicos Islands,0,6,72,"rgb(246, 207, 113)"
25929,2020-03-20,Chad,0,1,1,"rgb(248, 156, 116)"
25930,2020-03-21,Chad,0,0,1,"rgb(248, 156, 116)"
25931,2020-03-22,Chad,0,1,2,"rgb(248, 156, 116)"
25932,2020-03-23,Chad,0,0,2,"rgb(248, 156, 116)"
25933,2020-03-24,Chad,0,0,2,"rgb(248, 156, 116)"
25934,2020-03-25,Chad,0,1,3,"rgb(248, 156, 116)"
25935,2020-03-26,Chad,0,0,3,"rgb(248, 156, 116)"
25936,2020-03-27,Chad,0,2,5,"rgb(248, 156, 116)"
25937,2020-03-28,Chad,0,0,5,"rgb(248, 156, 116)"
25938,2020-03-29,Chad,0,0,5,"rgb(248, 156, 116)"
25939,2020-03-30,Chad,0,0,5,"rgb(248, 156, 116)"
25940,2020-03-31,Chad,0,2,7,"rgb(248, 156, 116)"
25941,2020-04-01,Chad,0,0,7,"rgb(248, 156, 116)"
25942,2020-04-02,Chad,0,0,7,"rgb(248, 156, 116)"
25943,2020-04-03,Chad,0,0,7,"rgb(248, 156, 116)"
25944,2020-04-04,Chad,0,0,7,"rgb(248, 156, 116)"
25945,2020-04-05,Chad,0,1,8,"rgb(248, 156, 116)"
25946,2020-04-06,Chad,0,1,9,"rgb(248, 156, 116)"
25947,2020-04-07,Chad,0,0,9,"rgb(248, 156, 116)"
25948,2020-04-08,Chad,0,0,9,"rgb(248, 156, 116)"
25949,2020-04-09,Chad,0,1,10,"rgb(248, 156, 116)"
25950,2020-04-10,Chad,0,1,11,"rgb(248, 156, 116)"
25951,2020-04-11,Chad,0,0,11,"rgb(248, 156, 116)"
25952,2020-04-12,Chad,0,0,11,"rgb(248, 156, 116)"
25953,2020-04-13,Chad,0,4,15,"rgb(248, 156, 116)"
25954,2020-04-14,Chad,0,8,23,"rgb(248, 156, 116)"
25955,2020-04-15,Chad,0,0,23,"rgb(248, 156, 116)"
25956,2020-04-16,Chad,0,4,27,"rgb(248, 156, 116)"
25957,2020-04-17,Chad,0,0,27,"rgb(248, 156, 116)"
25958,2020-04-18,Chad,0,6,33,"rgb(248, 156, 116)"
25959,2020-04-19,Chad,0,0,33,"rgb(248, 156, 116)"
25960,2020-04-20,Chad,0,0,33,"rgb(248, 156, 116)"
25961,2020-04-21,Chad,0,0,33,"rgb(248, 156, 116)"
25962,2020-04-22,Chad,0,1,34,"rgb(248, 156, 116)"
25963,2020-04-23,Chad,0,0,34,"rgb(248, 156, 116)"
25964,2020-04-24,Chad,0,6,40,"rgb(248, 156, 116)"
25965,2020-04-25,Chad,0,0,40,"rgb(248, 156, 116)"
25966,2020-04-26,Chad,0,0,40,"rgb(248, 156, 116)"
25967,2020-04-27,Chad,0,6,46,"rgb(248, 156, 116)"
25968,2020-04-28,Chad,0,0,46,"rgb(248, 156, 116)"
25969,2020-04-29,Chad,2,6,52,"rgb(248, 156, 116)"
25970,2020-04-30,Chad,0,0,52,"rgb(248, 156, 116)"
25971,2020-05-01,Chad,3,21,73,"rgb(248, 156, 116)"
25972,2020-05-02,Chad,0,0,73,"rgb(248, 156, 116)"
25973,2020-05-03,Chad,5,44,117,"rgb(248, 156, 116)"
25974,2020-05-04,Chad,0,0,117,"rgb(248, 156, 116)"
25975,2020-05-05,Chad,0,0,117,"rgb(248, 156, 116)"
25976,2020-05-06,Chad,7,53,170,"rgb(248, 156, 116)"
25977,2020-05-07,Chad,0,0,170,"rgb(248, 156, 116)"
25978,2020-05-08,Chad,10,83,253,"rgb(248, 156, 116)"
25979,2020-05-09,Chad,1,7,260,"rgb(248, 156, 116)"
25980,2020-05-10,Chad,3,62,322,"rgb(248, 156, 116)"
25981,2020-05-11,Chad,0,0,322,"rgb(248, 156, 116)"
25982,2020-05-12,Chad,0,0,322,"rgb(248, 156, 116)"
25983,2020-05-13,Chad,9,35,357,"rgb(248, 156, 116)"
25984,2020-05-14,Chad,2,15,372,"rgb(248, 156, 116)"
25985,2020-05-15,Chad,4,27,399,"rgb(248, 156, 116)"
25986,2020-05-16,Chad,2,29,428,"rgb(248, 156, 116)"
25987,2020-05-17,Chad,2,46,474,"rgb(248, 156, 116)"
25988,2020-05-18,Chad,3,29,503,"rgb(248, 156, 116)"
25989,2020-05-19,Chad,0,16,519,"rgb(248, 156, 116)"
25990,2020-05-20,Chad,3,26,545,"rgb(248, 156, 116)"
25991,2020-05-21,Chad,1,20,565,"rgb(248, 156, 116)"
25992,2020-05-22,Chad,1,23,588,"rgb(248, 156, 116)"
25993,2020-05-23,Chad,1,23,611,"rgb(248, 156, 116)"
25994,2020-05-24,Chad,1,37,648,"rgb(248, 156, 116)"
25995,2020-05-25,Chad,0,27,675,"rgb(248, 156, 116)"
25996,2020-05-26,Chad,1,12,687,"rgb(248, 156, 116)"
25997,2020-05-27,Chad,1,13,700,"rgb(248, 156, 116)"
25998,2020-05-28,Chad,2,15,715,"rgb(248, 156, 116)"
25999,2020-05-29,Chad,1,11,726,"rgb(248, 156, 116)"
26000,2020-05-30,Chad,0,33,759,"rgb(248, 156, 116)"
26001,2020-05-31,Chad,0,0,759,"rgb(248, 156, 116)"
26002,2020-06-01,Chad,0,19,778,"rgb(248, 156, 116)"
26003,2020-06-02,Chad,1,12,790,"rgb(248, 156, 116)"
26004,2020-06-03,Chad,0,13,803,"rgb(248, 156, 116)"
26005,2020-06-04,Chad,0,17,820,"rgb(248, 156, 116)"
26006,2020-06-05,Chad,0,8,828,"rgb(248, 156, 116)"
26007,2020-06-06,Chad,2,8,836,"rgb(248, 156, 116)"
26008,2020-06-07,Chad,1,0,836,"rgb(248, 156, 116)"
26009,2020-06-08,Chad,0,1,837,"rgb(248, 156, 116)"
26010,2020-06-09,Chad,1,2,839,"rgb(248, 156, 116)"
26011,2020-06-10,Chad,1,5,844,"rgb(248, 156, 116)"
26012,2020-06-11,Chad,1,2,846,"rgb(248, 156, 116)"
26013,2020-06-12,Chad,0,2,848,"rgb(248, 156, 116)"
26014,2020-06-13,Chad,0,0,848,"rgb(248, 156, 116)"
26015,2020-06-14,Chad,0,0,848,"rgb(248, 156, 116)"
26016,2020-06-15,Chad,1,2,850,"rgb(248, 156, 116)"
26017,2020-06-16,Chad,0,0,850,"rgb(248, 156, 116)"
26018,2020-06-17,Chad,1,3,853,"rgb(248, 156, 116)"
26019,2020-06-18,Chad,0,1,854,"rgb(248, 156, 116)"
26020,2020-06-19,Chad,0,0,854,"rgb(248, 156, 116)"
26021,2020-06-20,Chad,0,4,858,"rgb(248, 156, 116)"
26022,2020-06-21,Chad,0,0,858,"rgb(248, 156, 116)"
26023,2020-06-22,Chad,0,0,858,"rgb(248, 156, 116)"
26024,2020-06-23,Chad,0,0,858,"rgb(248, 156, 116)"
26025,2020-06-24,Chad,0,2,860,"rgb(248, 156, 116)"
26026,2020-06-25,Chad,0,0,860,"rgb(248, 156, 116)"
26027,2020-06-26,Chad,0,3,863,"rgb(248, 156, 116)"
26028,2020-06-27,Chad,0,2,865,"rgb(248, 156, 116)"
26029,2020-06-28,Chad,0,0,865,"rgb(248, 156, 116)"
26030,2020-06-29,Chad,0,1,866,"rgb(248, 156, 116)"
26031,2020-06-30,Chad,0,0,866,"rgb(248, 156, 116)"
26032,2020-07-01,Chad,0,0,866,"rgb(248, 156, 116)"
26033,2020-07-02,Chad,0,0,866,"rgb(248, 156, 116)"
26034,2020-07-03,Chad,0,2,868,"rgb(248, 156, 116)"
26035,2020-07-04,Chad,0,3,871,"rgb(248, 156, 116)"
26036,2020-07-05,Chad,0,0,871,"rgb(248, 156, 116)"
26037,2020-07-06,Chad,0,1,872,"rgb(248, 156, 116)"
26038,2020-07-07,Chad,0,0,872,"rgb(248, 156, 116)"
26039,2020-07-08,Chad,0,1,873,"rgb(248, 156, 116)"
26040,2020-07-09,Chad,0,0,873,"rgb(248, 156, 116)"
26041,2020-07-10,Chad,0,0,873,"rgb(248, 156, 116)"
26042,2020-07-11,Chad,0,1,874,"rgb(248, 156, 116)"
26043,2020-07-12,Chad,0,0,874,"rgb(248, 156, 116)"
26044,2020-07-13,Chad,1,6,880,"rgb(248, 156, 116)"
26045,2020-03-07,Togo,0,1,1,"rgb(220, 176, 242)"
26046,2020-03-15,Togo,0,0,1,"rgb(220, 176, 242)"
26047,2020-03-16,Togo,0,0,1,"rgb(220, 176, 242)"
26048,2020-03-17,Togo,0,0,1,"rgb(220, 176, 242)"
26049,2020-03-18,Togo,0,0,1,"rgb(220, 176, 242)"
26050,2020-03-19,Togo,0,0,1,"rgb(220, 176, 242)"
26051,2020-03-20,Togo,0,0,1,"rgb(220, 176, 242)"
26052,2020-03-21,Togo,0,8,9,"rgb(220, 176, 242)"
26053,2020-03-22,Togo,0,6,15,"rgb(220, 176, 242)"
26054,2020-03-23,Togo,0,0,15,"rgb(220, 176, 242)"
26055,2020-03-24,Togo,0,3,18,"rgb(220, 176, 242)"
26056,2020-03-25,Togo,0,0,18,"rgb(220, 176, 242)"
26057,2020-03-26,Togo,0,5,23,"rgb(220, 176, 242)"
26058,2020-03-27,Togo,0,1,24,"rgb(220, 176, 242)"
26059,2020-03-28,Togo,1,1,25,"rgb(220, 176, 242)"
26060,2020-03-29,Togo,0,3,28,"rgb(220, 176, 242)"
26061,2020-03-30,Togo,0,2,30,"rgb(220, 176, 242)"
26062,2020-03-31,Togo,0,4,34,"rgb(220, 176, 242)"
26063,2020-04-01,Togo,0,0,34,"rgb(220, 176, 242)"
26064,2020-04-02,Togo,1,2,36,"rgb(220, 176, 242)"
26065,2020-04-03,Togo,0,3,39,"rgb(220, 176, 242)"
26066,2020-04-04,Togo,1,1,40,"rgb(220, 176, 242)"
26067,2020-04-05,Togo,0,1,41,"rgb(220, 176, 242)"
26068,2020-04-06,Togo,0,3,44,"rgb(220, 176, 242)"
26069,2020-04-07,Togo,0,14,58,"rgb(220, 176, 242)"
26070,2020-04-08,Togo,0,7,65,"rgb(220, 176, 242)"
26071,2020-04-09,Togo,0,5,70,"rgb(220, 176, 242)"
26072,2020-04-10,Togo,0,3,73,"rgb(220, 176, 242)"
26073,2020-04-11,Togo,0,3,76,"rgb(220, 176, 242)"
26074,2020-04-12,Togo,0,0,76,"rgb(220, 176, 242)"
26075,2020-04-13,Togo,0,0,76,"rgb(220, 176, 242)"
26076,2020-04-14,Togo,0,1,77,"rgb(220, 176, 242)"
26077,2020-04-15,Togo,0,0,77,"rgb(220, 176, 242)"
26078,2020-04-16,Togo,0,4,81,"rgb(220, 176, 242)"
26079,2020-04-17,Togo,2,0,81,"rgb(220, 176, 242)"
26080,2020-04-18,Togo,0,2,83,"rgb(220, 176, 242)"
26081,2020-04-19,Togo,0,1,84,"rgb(220, 176, 242)"
26082,2020-04-20,Togo,0,0,84,"rgb(220, 176, 242)"
26083,2020-04-21,Togo,1,0,84,"rgb(220, 176, 242)"
26084,2020-04-22,Togo,0,2,86,"rgb(220, 176, 242)"
26085,2020-04-23,Togo,0,2,88,"rgb(220, 176, 242)"
26086,2020-04-24,Togo,0,0,88,"rgb(220, 176, 242)"
26087,2020-04-25,Togo,0,2,90,"rgb(220, 176, 242)"
26088,2020-04-26,Togo,0,6,96,"rgb(220, 176, 242)"
26089,2020-04-27,Togo,0,2,98,"rgb(220, 176, 242)"
26090,2020-04-28,Togo,0,1,99,"rgb(220, 176, 242)"
26091,2020-04-29,Togo,0,0,99,"rgb(220, 176, 242)"
26092,2020-04-30,Togo,1,10,109,"rgb(220, 176, 242)"
26093,2020-05-01,Togo,2,7,116,"rgb(220, 176, 242)"
26094,2020-05-02,Togo,0,7,123,"rgb(220, 176, 242)"
26095,2020-05-03,Togo,0,0,123,"rgb(220, 176, 242)"
26096,2020-05-04,Togo,0,1,124,"rgb(220, 176, 242)"
26097,2020-05-05,Togo,0,2,126,"rgb(220, 176, 242)"
26098,2020-05-06,Togo,0,2,128,"rgb(220, 176, 242)"
26099,2020-05-07,Togo,0,0,128,"rgb(220, 176, 242)"
26100,2020-05-08,Togo,0,7,135,"rgb(220, 176, 242)"
26101,2020-05-09,Togo,1,10,145,"rgb(220, 176, 242)"
26102,2020-05-10,Togo,0,8,153,"rgb(220, 176, 242)"
26103,2020-05-11,Togo,1,21,174,"rgb(220, 176, 242)"
26104,2020-05-12,Togo,0,7,181,"rgb(220, 176, 242)"
26105,2020-05-13,Togo,0,18,199,"rgb(220, 176, 242)"
26106,2020-05-14,Togo,0,20,219,"rgb(220, 176, 242)"
26107,2020-05-15,Togo,0,19,238,"rgb(220, 176, 242)"
26108,2020-05-16,Togo,0,25,263,"rgb(220, 176, 242)"
26109,2020-05-17,Togo,0,35,298,"rgb(220, 176, 242)"
26110,2020-05-18,Togo,0,3,301,"rgb(220, 176, 242)"
26111,2020-05-19,Togo,1,29,330,"rgb(220, 176, 242)"
26112,2020-05-20,Togo,0,8,338,"rgb(220, 176, 242)"
26113,2020-05-21,Togo,0,2,340,"rgb(220, 176, 242)"
26114,2020-05-22,Togo,0,14,354,"rgb(220, 176, 242)"
26115,2020-05-23,Togo,0,9,363,"rgb(220, 176, 242)"
26116,2020-05-24,Togo,0,10,373,"rgb(220, 176, 242)"
26117,2020-05-25,Togo,0,8,381,"rgb(220, 176, 242)"
26118,2020-05-26,Togo,1,5,386,"rgb(220, 176, 242)"
26119,2020-05-27,Togo,0,5,391,"rgb(220, 176, 242)"
26120,2020-05-28,Togo,0,4,395,"rgb(220, 176, 242)"
26121,2020-05-29,Togo,0,27,422,"rgb(220, 176, 242)"
26122,2020-05-30,Togo,0,6,428,"rgb(220, 176, 242)"
26123,2020-05-31,Togo,0,5,433,"rgb(220, 176, 242)"
26124,2020-06-01,Togo,0,9,442,"rgb(220, 176, 242)"
26125,2020-06-02,Togo,0,1,443,"rgb(220, 176, 242)"
26126,2020-06-03,Togo,0,2,445,"rgb(220, 176, 242)"
26127,2020-06-04,Togo,0,7,452,"rgb(220, 176, 242)"
26128,2020-06-05,Togo,0,13,465,"rgb(220, 176, 242)"
26129,2020-06-06,Togo,0,20,485,"rgb(220, 176, 242)"
26130,2020-06-07,Togo,0,2,487,"rgb(220, 176, 242)"
26131,2020-06-08,Togo,0,8,495,"rgb(220, 176, 242)"
26132,2020-06-09,Togo,0,2,497,"rgb(220, 176, 242)"
26133,2020-06-10,Togo,0,4,501,"rgb(220, 176, 242)"
26134,2020-06-11,Togo,0,21,522,"rgb(220, 176, 242)"
26135,2020-06-12,Togo,0,2,524,"rgb(220, 176, 242)"
26136,2020-06-13,Togo,0,1,525,"rgb(220, 176, 242)"
26137,2020-06-14,Togo,0,5,530,"rgb(220, 176, 242)"
26138,2020-06-15,Togo,0,1,531,"rgb(220, 176, 242)"
26139,2020-06-16,Togo,0,1,532,"rgb(220, 176, 242)"
26140,2020-06-17,Togo,0,5,537,"rgb(220, 176, 242)"
26141,2020-06-18,Togo,0,7,544,"rgb(220, 176, 242)"
26142,2020-06-19,Togo,0,3,547,"rgb(220, 176, 242)"
26143,2020-06-20,Togo,0,8,555,"rgb(220, 176, 242)"
26144,2020-06-21,Togo,0,6,561,"rgb(220, 176, 242)"
26145,2020-06-22,Togo,0,8,569,"rgb(220, 176, 242)"
26146,2020-06-23,Togo,0,0,569,"rgb(220, 176, 242)"
26147,2020-06-24,Togo,0,7,576,"rgb(220, 176, 242)"
26148,2020-06-25,Togo,1,7,583,"rgb(220, 176, 242)"
26149,2020-06-26,Togo,0,5,588,"rgb(220, 176, 242)"
26150,2020-06-27,Togo,0,3,591,"rgb(220, 176, 242)"
26151,2020-06-28,Togo,0,24,615,"rgb(220, 176, 242)"
26152,2020-06-29,Togo,0,27,642,"rgb(220, 176, 242)"
26153,2020-06-30,Togo,0,1,643,"rgb(220, 176, 242)"
26154,2020-07-01,Togo,0,7,650,"rgb(220, 176, 242)"
26155,2020-07-02,Togo,0,11,661,"rgb(220, 176, 242)"
26156,2020-07-03,Togo,0,6,667,"rgb(220, 176, 242)"
26157,2020-07-04,Togo,0,4,671,"rgb(220, 176, 242)"
26158,2020-07-05,Togo,1,5,676,"rgb(220, 176, 242)"
26159,2020-07-06,Togo,0,4,680,"rgb(220, 176, 242)"
26160,2020-07-07,Togo,0,0,680,"rgb(220, 176, 242)"
26161,2020-07-08,Togo,0,9,689,"rgb(220, 176, 242)"
26162,2020-07-09,Togo,0,6,695,"rgb(220, 176, 242)"
26163,2020-07-10,Togo,0,9,704,"rgb(220, 176, 242)"
26164,2020-07-11,Togo,0,6,710,"rgb(220, 176, 242)"
26165,2020-07-12,Togo,0,8,718,"rgb(220, 176, 242)"
26166,2020-07-13,Togo,0,2,720,"rgb(220, 176, 242)"
26167,2019-12-31,Thailand,0,0,0,"rgb(135, 197, 95)"
26168,2020-01-01,Thailand,0,0,0,"rgb(135, 197, 95)"
26169,2020-01-02,Thailand,0,0,0,"rgb(135, 197, 95)"
26170,2020-01-03,Thailand,0,0,0,"rgb(135, 197, 95)"
26171,2020-01-04,Thailand,0,0,0,"rgb(135, 197, 95)"
26172,2020-01-05,Thailand,0,0,0,"rgb(135, 197, 95)"
26173,2020-01-06,Thailand,0,0,0,"rgb(135, 197, 95)"
26174,2020-01-07,Thailand,0,0,0,"rgb(135, 197, 95)"
26175,2020-01-08,Thailand,0,0,0,"rgb(135, 197, 95)"
26176,2020-01-09,Thailand,0,0,0,"rgb(135, 197, 95)"
26177,2020-01-10,Thailand,0,0,0,"rgb(135, 197, 95)"
26178,2020-01-11,Thailand,0,0,0,"rgb(135, 197, 95)"
26179,2020-01-12,Thailand,0,0,0,"rgb(135, 197, 95)"
26180,2020-01-13,Thailand,0,1,1,"rgb(135, 197, 95)"
26181,2020-01-14,Thailand,0,0,1,"rgb(135, 197, 95)"
26182,2020-01-15,Thailand,0,0,1,"rgb(135, 197, 95)"
26183,2020-01-16,Thailand,0,0,1,"rgb(135, 197, 95)"
26184,2020-01-17,Thailand,0,1,2,"rgb(135, 197, 95)"
26185,2020-01-18,Thailand,0,0,2,"rgb(135, 197, 95)"
26186,2020-01-19,Thailand,0,0,2,"rgb(135, 197, 95)"
26187,2020-01-20,Thailand,0,0,2,"rgb(135, 197, 95)"
26188,2020-01-21,Thailand,0,0,2,"rgb(135, 197, 95)"
26189,2020-01-22,Thailand,0,2,4,"rgb(135, 197, 95)"
26190,2020-01-23,Thailand,0,0,4,"rgb(135, 197, 95)"
26191,2020-01-24,Thailand,0,0,4,"rgb(135, 197, 95)"
26192,2020-01-25,Thailand,0,1,5,"rgb(135, 197, 95)"
26193,2020-01-26,Thailand,0,0,5,"rgb(135, 197, 95)"
26194,2020-01-27,Thailand,0,3,8,"rgb(135, 197, 95)"
26195,2020-01-28,Thailand,0,6,14,"rgb(135, 197, 95)"
26196,2020-01-29,Thailand,0,0,14,"rgb(135, 197, 95)"
26197,2020-01-30,Thailand,0,0,14,"rgb(135, 197, 95)"
26198,2020-01-31,Thailand,0,0,14,"rgb(135, 197, 95)"
26199,2020-02-01,Thailand,0,5,19,"rgb(135, 197, 95)"
26200,2020-02-02,Thailand,0,0,19,"rgb(135, 197, 95)"
26201,2020-02-03,Thailand,0,0,19,"rgb(135, 197, 95)"
26202,2020-02-04,Thailand,0,0,19,"rgb(135, 197, 95)"
26203,2020-02-05,Thailand,0,6,25,"rgb(135, 197, 95)"
26204,2020-02-06,Thailand,0,0,25,"rgb(135, 197, 95)"
26205,2020-02-07,Thailand,0,0,25,"rgb(135, 197, 95)"
26206,2020-02-08,Thailand,0,7,32,"rgb(135, 197, 95)"
26207,2020-02-09,Thailand,0,0,32,"rgb(135, 197, 95)"
26208,2020-02-10,Thailand,0,0,32,"rgb(135, 197, 95)"
26209,2020-02-11,Thailand,0,0,32,"rgb(135, 197, 95)"
26210,2020-02-12,Thailand,0,1,33,"rgb(135, 197, 95)"
26211,2020-02-13,Thailand,0,0,33,"rgb(135, 197, 95)"
26212,2020-02-14,Thailand,0,0,33,"rgb(135, 197, 95)"
26213,2020-02-15,Thailand,0,1,34,"rgb(135, 197, 95)"
26214,2020-02-16,Thailand,0,0,34,"rgb(135, 197, 95)"
26215,2020-02-17,Thailand,0,0,34,"rgb(135, 197, 95)"
26216,2020-02-18,Thailand,0,1,35,"rgb(135, 197, 95)"
26217,2020-02-19,Thailand,0,0,35,"rgb(135, 197, 95)"
26218,2020-02-20,Thailand,0,0,35,"rgb(135, 197, 95)"
26219,2020-02-21,Thailand,0,0,35,"rgb(135, 197, 95)"
26220,2020-02-22,Thailand,0,0,35,"rgb(135, 197, 95)"
26221,2020-02-23,Thailand,0,0,35,"rgb(135, 197, 95)"
26222,2020-02-24,Thailand,0,0,35,"rgb(135, 197, 95)"
26223,2020-02-25,Thailand,0,2,37,"rgb(135, 197, 95)"
26224,2020-02-26,Thailand,0,3,40,"rgb(135, 197, 95)"
26225,2020-02-27,Thailand,0,0,40,"rgb(135, 197, 95)"
26226,2020-02-28,Thailand,0,0,40,"rgb(135, 197, 95)"
26227,2020-02-29,Thailand,0,2,42,"rgb(135, 197, 95)"
26228,2020-03-01,Thailand,1,0,42,"rgb(135, 197, 95)"
26229,2020-03-02,Thailand,0,1,43,"rgb(135, 197, 95)"
26230,2020-03-05,Thailand,0,4,47,"rgb(135, 197, 95)"
26231,2020-03-07,Thailand,0,3,50,"rgb(135, 197, 95)"
26232,2020-03-11,Thailand,0,9,59,"rgb(135, 197, 95)"
26233,2020-03-12,Thailand,0,11,70,"rgb(135, 197, 95)"
26234,2020-03-14,Thailand,0,12,82,"rgb(135, 197, 95)"
26235,2020-03-15,Thailand,0,0,82,"rgb(135, 197, 95)"
26236,2020-03-16,Thailand,0,32,114,"rgb(135, 197, 95)"
26237,2020-03-17,Thailand,0,63,177,"rgb(135, 197, 95)"
26238,2020-03-18,Thailand,0,0,177,"rgb(135, 197, 95)"
26239,2020-03-19,Thailand,0,0,177,"rgb(135, 197, 95)"
26240,2020-03-20,Thailand,0,35,212,"rgb(135, 197, 95)"
26241,2020-03-21,Thailand,0,154,366,"rgb(135, 197, 95)"
26242,2020-03-22,Thailand,0,233,599,"rgb(135, 197, 95)"
26243,2020-03-23,Thailand,0,122,721,"rgb(135, 197, 95)"
26244,2020-03-24,Thailand,3,106,827,"rgb(135, 197, 95)"
26245,2020-03-25,Thailand,0,107,934,"rgb(135, 197, 95)"
26246,2020-03-26,Thailand,0,111,1045,"rgb(135, 197, 95)"
26247,2020-03-27,Thailand,1,91,1136,"rgb(135, 197, 95)"
26248,2020-03-28,Thailand,0,0,1136,"rgb(135, 197, 95)"
26249,2020-03-29,Thailand,1,109,1245,"rgb(135, 197, 95)"
26250,2020-03-30,Thailand,1,143,1388,"rgb(135, 197, 95)"
26251,2020-03-31,Thailand,3,263,1651,"rgb(135, 197, 95)"
26252,2020-04-01,Thailand,0,0,1651,"rgb(135, 197, 95)"
26253,2020-04-02,Thailand,2,120,1771,"rgb(135, 197, 95)"
26254,2020-04-03,Thailand,3,104,1875,"rgb(135, 197, 95)"
26255,2020-04-04,Thailand,4,103,1978,"rgb(135, 197, 95)"
26256,2020-04-05,Thailand,4,191,2169,"rgb(135, 197, 95)"
26257,2020-04-06,Thailand,3,51,2220,"rgb(135, 197, 95)"
26258,2020-04-07,Thailand,0,38,2258,"rgb(135, 197, 95)"
26259,2020-04-08,Thailand,4,111,2369,"rgb(135, 197, 95)"
26260,2020-04-09,Thailand,2,54,2423,"rgb(135, 197, 95)"
26261,2020-04-10,Thailand,1,50,2473,"rgb(135, 197, 95)"
26262,2020-04-11,Thailand,2,45,2518,"rgb(135, 197, 95)"
26263,2020-04-12,Thailand,3,33,2551,"rgb(135, 197, 95)"
26264,2020-04-13,Thailand,2,28,2579,"rgb(135, 197, 95)"
26265,2020-04-14,Thailand,1,34,2613,"rgb(135, 197, 95)"
26266,2020-04-15,Thailand,2,30,2643,"rgb(135, 197, 95)"
26267,2020-04-16,Thailand,3,29,2672,"rgb(135, 197, 95)"
26268,2020-04-17,Thailand,1,28,2700,"rgb(135, 197, 95)"
26269,2020-04-18,Thailand,0,0,2700,"rgb(135, 197, 95)"
26270,2020-04-19,Thailand,0,33,2733,"rgb(135, 197, 95)"
26271,2020-04-20,Thailand,0,32,2765,"rgb(135, 197, 95)"
26272,2020-04-21,Thailand,0,27,2792,"rgb(135, 197, 95)"
26273,2020-04-22,Thailand,1,19,2811,"rgb(135, 197, 95)"
26274,2020-04-23,Thailand,2,28,2839,"rgb(135, 197, 95)"
26275,2020-04-24,Thailand,0,0,2839,"rgb(135, 197, 95)"
26276,2020-04-25,Thailand,0,15,2854,"rgb(135, 197, 95)"
26277,2020-04-26,Thailand,1,68,2922,"rgb(135, 197, 95)"
26278,2020-04-27,Thailand,0,0,2922,"rgb(135, 197, 95)"
26279,2020-04-28,Thailand,3,16,2938,"rgb(135, 197, 95)"
26280,2020-04-29,Thailand,0,0,2938,"rgb(135, 197, 95)"
26281,2020-04-30,Thailand,0,16,2954,"rgb(135, 197, 95)"
26282,2020-05-01,Thailand,0,6,2960,"rgb(135, 197, 95)"
26283,2020-05-02,Thailand,0,0,2960,"rgb(135, 197, 95)"
26284,2020-05-03,Thailand,0,6,2966,"rgb(135, 197, 95)"
26285,2020-05-04,Thailand,0,3,2969,"rgb(135, 197, 95)"
26286,2020-05-05,Thailand,0,18,2987,"rgb(135, 197, 95)"
26287,2020-05-06,Thailand,0,1,2988,"rgb(135, 197, 95)"
26288,2020-05-07,Thailand,1,1,2989,"rgb(135, 197, 95)"
26289,2020-05-08,Thailand,0,3,2992,"rgb(135, 197, 95)"
26290,2020-05-09,Thailand,0,8,3000,"rgb(135, 197, 95)"
26291,2020-05-10,Thailand,1,4,3004,"rgb(135, 197, 95)"
26292,2020-05-11,Thailand,0,11,3015,"rgb(135, 197, 95)"
26293,2020-05-12,Thailand,0,0,3015,"rgb(135, 197, 95)"
26294,2020-05-13,Thailand,0,2,3017,"rgb(135, 197, 95)"
26295,2020-05-14,Thailand,0,0,3017,"rgb(135, 197, 95)"
26296,2020-05-15,Thailand,0,1,3018,"rgb(135, 197, 95)"
26297,2020-05-16,Thailand,0,7,3025,"rgb(135, 197, 95)"
26298,2020-05-17,Thailand,0,3,3028,"rgb(135, 197, 95)"
26299,2020-05-18,Thailand,0,0,3028,"rgb(135, 197, 95)"
26300,2020-05-19,Thailand,0,3,3031,"rgb(135, 197, 95)"
26301,2020-05-20,Thailand,0,3,3034,"rgb(135, 197, 95)"
26302,2020-05-21,Thailand,0,0,3034,"rgb(135, 197, 95)"
26303,2020-05-22,Thailand,0,3,3037,"rgb(135, 197, 95)"
26304,2020-05-23,Thailand,0,3,3040,"rgb(135, 197, 95)"
26305,2020-05-24,Thailand,0,0,3040,"rgb(135, 197, 95)"
26306,2020-05-25,Thailand,1,2,3042,"rgb(135, 197, 95)"
26307,2020-05-26,Thailand,0,0,3042,"rgb(135, 197, 95)"
26308,2020-05-27,Thailand,0,3,3045,"rgb(135, 197, 95)"
26309,2020-05-28,Thailand,0,9,3054,"rgb(135, 197, 95)"
26310,2020-05-29,Thailand,0,11,3065,"rgb(135, 197, 95)"
26311,2020-05-30,Thailand,0,11,3076,"rgb(135, 197, 95)"
26312,2020-05-31,Thailand,0,5,3081,"rgb(135, 197, 95)"
26313,2020-06-01,Thailand,0,0,3081,"rgb(135, 197, 95)"
26314,2020-06-02,Thailand,0,1,3082,"rgb(135, 197, 95)"
26315,2020-06-03,Thailand,1,1,3083,"rgb(135, 197, 95)"
26316,2020-06-04,Thailand,0,18,3101,"rgb(135, 197, 95)"
26317,2020-06-05,Thailand,0,1,3102,"rgb(135, 197, 95)"
26318,2020-06-06,Thailand,0,2,3104,"rgb(135, 197, 95)"
26319,2020-06-07,Thailand,0,8,3112,"rgb(135, 197, 95)"
26320,2020-06-08,Thailand,0,7,3119,"rgb(135, 197, 95)"
26321,2020-06-09,Thailand,0,0,3119,"rgb(135, 197, 95)"
26322,2020-06-10,Thailand,0,6,3125,"rgb(135, 197, 95)"
26323,2020-06-11,Thailand,0,0,3125,"rgb(135, 197, 95)"
26324,2020-06-12,Thailand,0,0,3125,"rgb(135, 197, 95)"
26325,2020-06-13,Thailand,0,4,3129,"rgb(135, 197, 95)"
26326,2020-06-14,Thailand,0,5,3134,"rgb(135, 197, 95)"
26327,2020-06-15,Thailand,0,1,3135,"rgb(135, 197, 95)"
26328,2020-06-16,Thailand,0,0,3135,"rgb(135, 197, 95)"
26329,2020-06-17,Thailand,0,0,3135,"rgb(135, 197, 95)"
26330,2020-06-18,Thailand,0,6,3141,"rgb(135, 197, 95)"
26331,2020-06-19,Thailand,0,0,3141,"rgb(135, 197, 95)"
26332,2020-06-20,Thailand,0,5,3146,"rgb(135, 197, 95)"
26333,2020-06-21,Thailand,0,1,3147,"rgb(135, 197, 95)"
26334,2020-06-22,Thailand,0,1,3148,"rgb(135, 197, 95)"
26335,2020-06-23,Thailand,0,3,3151,"rgb(135, 197, 95)"
26336,2020-06-24,Thailand,0,5,3156,"rgb(135, 197, 95)"
26337,2020-06-25,Thailand,0,2,3158,"rgb(135, 197, 95)"
26338,2020-06-26,Thailand,0,0,3158,"rgb(135, 197, 95)"
26339,2020-06-27,Thailand,0,4,3162,"rgb(135, 197, 95)"
26340,2020-06-28,Thailand,0,0,3162,"rgb(135, 197, 95)"
26341,2020-06-29,Thailand,0,0,3162,"rgb(135, 197, 95)"
26342,2020-06-30,Thailand,0,9,3171,"rgb(135, 197, 95)"
26343,2020-07-01,Thailand,0,2,3173,"rgb(135, 197, 95)"
26344,2020-07-02,Thailand,0,6,3179,"rgb(135, 197, 95)"
26345,2020-07-03,Thailand,0,1,3180,"rgb(135, 197, 95)"
26346,2020-07-04,Thailand,0,5,3185,"rgb(135, 197, 95)"
26347,2020-07-05,Thailand,0,5,3190,"rgb(135, 197, 95)"
26348,2020-07-06,Thailand,0,5,3195,"rgb(135, 197, 95)"
26349,2020-07-07,Thailand,0,0,3195,"rgb(135, 197, 95)"
26350,2020-07-08,Thailand,0,2,3197,"rgb(135, 197, 95)"
26351,2020-07-09,Thailand,0,5,3202,"rgb(135, 197, 95)"
26352,2020-07-10,Thailand,0,0,3202,"rgb(135, 197, 95)"
26353,2020-07-11,Thailand,0,14,3216,"rgb(135, 197, 95)"
26354,2020-07-12,Thailand,0,1,3217,"rgb(135, 197, 95)"
26355,2020-07-13,Thailand,0,3,3220,"rgb(135, 197, 95)"
26356,2020-05-01,Tajikistan,0,15,15,"rgb(158, 185, 243)"
26357,2020-05-02,Tajikistan,0,0,15,"rgb(158, 185, 243)"
26358,2020-05-03,Tajikistan,0,17,32,"rgb(158, 185, 243)"
26359,2020-05-04,Tajikistan,2,44,76,"rgb(158, 185, 243)"
26360,2020-05-05,Tajikistan,1,154,230,"rgb(158, 185, 243)"
26361,2020-05-06,Tajikistan,2,63,293,"rgb(158, 185, 243)"
26362,2020-05-07,Tajikistan,3,86,379,"rgb(158, 185, 243)"
26363,2020-05-08,Tajikistan,4,82,461,"rgb(158, 185, 243)"
26364,2020-05-09,Tajikistan,0,61,522,"rgb(158, 185, 243)"
26365,2020-05-10,Tajikistan,8,90,612,"rgb(158, 185, 243)"
26366,2020-05-11,Tajikistan,0,0,612,"rgb(158, 185, 243)"
26367,2020-05-12,Tajikistan,1,49,661,"rgb(158, 185, 243)"
26368,2020-05-13,Tajikistan,2,68,729,"rgb(158, 185, 243)"
26369,2020-05-14,Tajikistan,0,72,801,"rgb(158, 185, 243)"
26370,2020-05-15,Tajikistan,6,106,907,"rgb(158, 185, 243)"
26371,2020-05-16,Tajikistan,4,211,1118,"rgb(158, 185, 243)"
26372,2020-05-17,Tajikistan,3,204,1322,"rgb(158, 185, 243)"
26373,2020-05-18,Tajikistan,3,202,1524,"rgb(158, 185, 243)"
26374,2020-05-19,Tajikistan,2,205,1729,"rgb(158, 185, 243)"
26375,2020-05-20,Tajikistan,0,0,1729,"rgb(158, 185, 243)"
26376,2020-05-21,Tajikistan,3,207,1936,"rgb(158, 185, 243)"
26377,2020-05-22,Tajikistan,0,204,2140,"rgb(158, 185, 243)"
26378,2020-05-23,Tajikistan,0,210,2350,"rgb(158, 185, 243)"
26379,2020-05-24,Tajikistan,0,201,2551,"rgb(158, 185, 243)"
26380,2020-05-25,Tajikistan,0,187,2738,"rgb(158, 185, 243)"
26381,2020-05-26,Tajikistan,2,362,3100,"rgb(158, 185, 243)"
26382,2020-05-27,Tajikistan,0,0,3100,"rgb(158, 185, 243)"
26383,2020-05-28,Tajikistan,0,0,3100,"rgb(158, 185, 243)"
26384,2020-05-29,Tajikistan,1,463,3563,"rgb(158, 185, 243)"
26385,2020-05-30,Tajikistan,0,0,3563,"rgb(158, 185, 243)"
26386,2020-05-31,Tajikistan,0,244,3807,"rgb(158, 185, 243)"
26387,2020-06-01,Tajikistan,0,0,3807,"rgb(158, 185, 243)"
26388,2020-06-02,Tajikistan,0,123,3930,"rgb(158, 185, 243)"
26389,2020-06-03,Tajikistan,0,83,4013,"rgb(158, 185, 243)"
26390,2020-06-04,Tajikistan,0,87,4100,"rgb(158, 185, 243)"
26391,2020-06-05,Tajikistan,1,189,4289,"rgb(158, 185, 243)"
26392,2020-06-06,Tajikistan,0,81,4370,"rgb(158, 185, 243)"
26393,2020-06-07,Tajikistan,0,83,4453,"rgb(158, 185, 243)"
26394,2020-06-08,Tajikistan,0,76,4529,"rgb(158, 185, 243)"
26395,2020-06-09,Tajikistan,0,80,4609,"rgb(158, 185, 243)"
26396,2020-06-10,Tajikistan,0,81,4690,"rgb(158, 185, 243)"
26397,2020-06-11,Tajikistan,0,73,4763,"rgb(158, 185, 243)"
26398,2020-06-12,Tajikistan,1,71,4834,"rgb(158, 185, 243)"
26399,2020-06-13,Tajikistan,0,68,4902,"rgb(158, 185, 243)"
26400,2020-06-14,Tajikistan,1,69,4971,"rgb(158, 185, 243)"
26401,2020-06-15,Tajikistan,0,64,5035,"rgb(158, 185, 243)"
26402,2020-06-16,Tajikistan,0,62,5097,"rgb(158, 185, 243)"
26403,2020-06-17,Tajikistan,0,63,5160,"rgb(158, 185, 243)"
26404,2020-06-18,Tajikistan,1,61,5221,"rgb(158, 185, 243)"
26405,2020-06-19,Tajikistan,0,58,5279,"rgb(158, 185, 243)"
26406,2020-06-20,Tajikistan,0,59,5338,"rgb(158, 185, 243)"
26407,2020-06-21,Tajikistan,1,61,5399,"rgb(158, 185, 243)"
26408,2020-06-22,Tajikistan,0,58,5457,"rgb(158, 185, 243)"
26409,2020-06-23,Tajikistan,0,56,5513,"rgb(158, 185, 243)"
26410,2020-06-24,Tajikistan,0,54,5567,"rgb(158, 185, 243)"
26411,2020-06-25,Tajikistan,0,63,5630,"rgb(158, 185, 243)"
26412,2020-06-26,Tajikistan,0,61,5691,"rgb(158, 185, 243)"
26413,2020-06-27,Tajikistan,0,56,5747,"rgb(158, 185, 243)"
26414,2020-06-28,Tajikistan,0,52,5799,"rgb(158, 185, 243)"
26415,2020-06-29,Tajikistan,0,50,5849,"rgb(158, 185, 243)"
26416,2020-06-30,Tajikistan,0,51,5900,"rgb(158, 185, 243)"
26417,2020-07-01,Tajikistan,0,54,5954,"rgb(158, 185, 243)"
26418,2020-07-02,Tajikistan,0,51,6005,"rgb(158, 185, 243)"
26419,2020-07-03,Tajikistan,0,53,6058,"rgb(158, 185, 243)"
26420,2020-07-04,Tajikistan,0,50,6108,"rgb(158, 185, 243)"
26421,2020-07-05,Tajikistan,0,51,6159,"rgb(158, 185, 243)"
26422,2020-07-06,Tajikistan,1,54,6213,"rgb(158, 185, 243)"
26423,2020-07-07,Tajikistan,0,49,6262,"rgb(158, 185, 243)"
26424,2020-07-08,Tajikistan,0,53,6315,"rgb(158, 185, 243)"
26425,2020-07-09,Tajikistan,1,49,6364,"rgb(158, 185, 243)"
26426,2020-07-10,Tajikistan,0,46,6410,"rgb(158, 185, 243)"
26427,2020-07-11,Tajikistan,1,47,6457,"rgb(158, 185, 243)"
26428,2020-07-12,Tajikistan,0,49,6506,"rgb(158, 185, 243)"
26429,2020-07-13,Tajikistan,0,46,6552,"rgb(158, 185, 243)"
26430,2020-03-22,Timor-Leste (East Timor),0,1,1,"rgb(254, 136, 177)"
26431,2020-03-23,Timor-Leste (East Timor),0,0,1,"rgb(254, 136, 177)"
26432,2020-03-24,Timor-Leste (East Timor),0,0,1,"rgb(254, 136, 177)"
26433,2020-03-25,Timor-Leste (East Timor),0,0,1,"rgb(254, 136, 177)"
26434,2020-03-26,Timor-Leste (East Timor),0,0,1,"rgb(254, 136, 177)"
26435,2020-03-27,Timor-Leste (East Timor),0,0,1,"rgb(254, 136, 177)"
26436,2020-03-28,Timor-Leste (East Timor),0,0,1,"rgb(254, 136, 177)"
26437,2020-03-29,Timor-Leste (East Timor),0,0,1,"rgb(254, 136, 177)"
26438,2020-03-30,Timor-Leste (East Timor),0,0,1,"rgb(254, 136, 177)"
26439,2020-03-31,Timor-Leste (East Timor),0,0,1,"rgb(254, 136, 177)"
26440,2020-04-01,Timor-Leste (East Timor),0,0,1,"rgb(254, 136, 177)"
26441,2020-04-02,Timor-Leste (East Timor),0,0,1,"rgb(254, 136, 177)"
26442,2020-04-03,Timor-Leste (East Timor),0,0,1,"rgb(254, 136, 177)"
26443,2020-04-04,Timor-Leste (East Timor),0,0,1,"rgb(254, 136, 177)"
26444,2020-04-05,Timor-Leste (East Timor),0,0,1,"rgb(254, 136, 177)"
26445,2020-04-06,Timor-Leste (East Timor),0,0,1,"rgb(254, 136, 177)"
26446,2020-04-07,Timor-Leste (East Timor),0,0,1,"rgb(254, 136, 177)"
26447,2020-04-08,Timor-Leste (East Timor),0,0,1,"rgb(254, 136, 177)"
26448,2020-04-09,Timor-Leste (East Timor),0,0,1,"rgb(254, 136, 177)"
26449,2020-04-10,Timor-Leste (East Timor),0,1,2,"rgb(254, 136, 177)"
26450,2020-04-11,Timor-Leste (East Timor),0,0,2,"rgb(254, 136, 177)"
26451,2020-04-12,Timor-Leste (East Timor),0,0,2,"rgb(254, 136, 177)"
26452,2020-04-13,Timor-Leste (East Timor),0,0,2,"rgb(254, 136, 177)"
26453,2020-04-14,Timor-Leste (East Timor),0,2,4,"rgb(254, 136, 177)"
26454,2020-04-15,Timor-Leste (East Timor),0,2,6,"rgb(254, 136, 177)"
26455,2020-04-16,Timor-Leste (East Timor),0,0,6,"rgb(254, 136, 177)"
26456,2020-04-17,Timor-Leste (East Timor),0,12,18,"rgb(254, 136, 177)"
26457,2020-04-18,Timor-Leste (East Timor),0,0,18,"rgb(254, 136, 177)"
26458,2020-04-19,Timor-Leste (East Timor),0,0,18,"rgb(254, 136, 177)"
26459,2020-04-20,Timor-Leste (East Timor),0,1,19,"rgb(254, 136, 177)"
26460,2020-04-21,Timor-Leste (East Timor),0,3,22,"rgb(254, 136, 177)"
26461,2020-04-22,Timor-Leste (East Timor),0,1,23,"rgb(254, 136, 177)"
26462,2020-04-23,Timor-Leste (East Timor),0,0,23,"rgb(254, 136, 177)"
26463,2020-04-24,Timor-Leste (East Timor),0,0,23,"rgb(254, 136, 177)"
26464,2020-04-25,Timor-Leste (East Timor),0,1,24,"rgb(254, 136, 177)"
26465,2020-04-26,Timor-Leste (East Timor),0,0,24,"rgb(254, 136, 177)"
26466,2020-04-27,Timor-Leste (East Timor),0,0,24,"rgb(254, 136, 177)"
26467,2020-04-28,Timor-Leste (East Timor),0,0,24,"rgb(254, 136, 177)"
26468,2020-04-29,Timor-Leste (East Timor),0,0,24,"rgb(254, 136, 177)"
26469,2020-04-30,Timor-Leste (East Timor),0,0,24,"rgb(254, 136, 177)"
26470,2020-05-01,Timor-Leste (East Timor),0,0,24,"rgb(254, 136, 177)"
26471,2020-05-02,Timor-Leste (East Timor),0,0,24,"rgb(254, 136, 177)"
26472,2020-05-03,Timor-Leste (East Timor),0,0,24,"rgb(254, 136, 177)"
26473,2020-05-04,Timor-Leste (East Timor),0,0,24,"rgb(254, 136, 177)"
26474,2020-05-05,Timor-Leste (East Timor),0,0,24,"rgb(254, 136, 177)"
26475,2020-05-06,Timor-Leste (East Timor),0,0,24,"rgb(254, 136, 177)"
26476,2020-05-07,Timor-Leste (East Timor),0,0,24,"rgb(254, 136, 177)"
26477,2020-05-08,Timor-Leste (East Timor),0,0,24,"rgb(254, 136, 177)"
26478,2020-05-09,Timor-Leste (East Timor),0,0,24,"rgb(254, 136, 177)"
26479,2020-05-10,Timor-Leste (East Timor),0,0,24,"rgb(254, 136, 177)"
26480,2020-05-11,Timor-Leste (East Timor),0,0,24,"rgb(254, 136, 177)"
26481,2020-05-12,Timor-Leste (East Timor),0,0,24,"rgb(254, 136, 177)"
26482,2020-05-13,Timor-Leste (East Timor),0,0,24,"rgb(254, 136, 177)"
26483,2020-05-14,Timor-Leste (East Timor),0,0,24,"rgb(254, 136, 177)"
26484,2020-05-15,Timor-Leste (East Timor),0,0,24,"rgb(254, 136, 177)"
26485,2020-05-16,Timor-Leste (East Timor),0,0,24,"rgb(254, 136, 177)"
26486,2020-05-17,Timor-Leste (East Timor),0,0,24,"rgb(254, 136, 177)"
26487,2020-05-18,Timor-Leste (East Timor),0,0,24,"rgb(254, 136, 177)"
26488,2020-05-19,Timor-Leste (East Timor),0,0,24,"rgb(254, 136, 177)"
26489,2020-05-20,Timor-Leste (East Timor),0,0,24,"rgb(254, 136, 177)"
26490,2020-05-21,Timor-Leste (East Timor),0,0,24,"rgb(254, 136, 177)"
26491,2020-05-22,Timor-Leste (East Timor),0,0,24,"rgb(254, 136, 177)"
26492,2020-05-23,Timor-Leste (East Timor),0,0,24,"rgb(254, 136, 177)"
26493,2020-05-24,Timor-Leste (East Timor),0,0,24,"rgb(254, 136, 177)"
26494,2020-05-25,Timor-Leste (East Timor),0,0,24,"rgb(254, 136, 177)"
26495,2020-05-26,Timor-Leste (East Timor),0,0,24,"rgb(254, 136, 177)"
26496,2020-05-27,Timor-Leste (East Timor),0,0,24,"rgb(254, 136, 177)"
26497,2020-05-28,Timor-Leste (East Timor),0,0,24,"rgb(254, 136, 177)"
26498,2020-05-29,Timor-Leste (East Timor),0,0,24,"rgb(254, 136, 177)"
26499,2020-05-30,Timor-Leste (East Timor),0,0,24,"rgb(254, 136, 177)"
26500,2020-05-31,Timor-Leste (East Timor),0,0,24,"rgb(254, 136, 177)"
26501,2020-06-01,Timor-Leste (East Timor),0,0,24,"rgb(254, 136, 177)"
26502,2020-06-02,Timor-Leste (East Timor),0,0,24,"rgb(254, 136, 177)"
26503,2020-06-03,Timor-Leste (East Timor),0,0,24,"rgb(254, 136, 177)"
26504,2020-06-04,Timor-Leste (East Timor),0,0,24,"rgb(254, 136, 177)"
26505,2020-06-05,Timor-Leste (East Timor),0,0,24,"rgb(254, 136, 177)"
26506,2020-06-06,Timor-Leste (East Timor),0,0,24,"rgb(254, 136, 177)"
26507,2020-06-07,Timor-Leste (East Timor),0,0,24,"rgb(254, 136, 177)"
26508,2020-06-08,Timor-Leste (East Timor),0,0,24,"rgb(254, 136, 177)"
26509,2020-06-09,Timor-Leste (East Timor),0,0,24,"rgb(254, 136, 177)"
26510,2020-06-10,Timor-Leste (East Timor),0,0,24,"rgb(254, 136, 177)"
26511,2020-06-11,Timor-Leste (East Timor),0,0,24,"rgb(254, 136, 177)"
26512,2020-06-12,Timor-Leste (East Timor),0,0,24,"rgb(254, 136, 177)"
26513,2020-06-13,Timor-Leste (East Timor),0,0,24,"rgb(254, 136, 177)"
26514,2020-06-14,Timor-Leste (East Timor),0,0,24,"rgb(254, 136, 177)"
26515,2020-06-15,Timor-Leste (East Timor),0,0,24,"rgb(254, 136, 177)"
26516,2020-06-16,Timor-Leste (East Timor),0,0,24,"rgb(254, 136, 177)"
26517,2020-06-17,Timor-Leste (East Timor),0,0,24,"rgb(254, 136, 177)"
26518,2020-06-18,Timor-Leste (East Timor),0,0,24,"rgb(254, 136, 177)"
26519,2020-06-19,Timor-Leste (East Timor),0,0,24,"rgb(254, 136, 177)"
26520,2020-06-20,Timor-Leste (East Timor),0,0,24,"rgb(254, 136, 177)"
26521,2020-06-21,Timor-Leste (East Timor),0,0,24,"rgb(254, 136, 177)"
26522,2020-06-22,Timor-Leste (East Timor),0,0,24,"rgb(254, 136, 177)"
26523,2020-06-23,Timor-Leste (East Timor),0,0,24,"rgb(254, 136, 177)"
26524,2020-06-24,Timor-Leste (East Timor),0,0,24,"rgb(254, 136, 177)"
26525,2020-06-25,Timor-Leste (East Timor),0,0,24,"rgb(254, 136, 177)"
26526,2020-06-26,Timor-Leste (East Timor),0,0,24,"rgb(254, 136, 177)"
26527,2020-06-27,Timor-Leste (East Timor),0,0,24,"rgb(254, 136, 177)"
26528,2020-06-28,Timor-Leste (East Timor),0,0,24,"rgb(254, 136, 177)"
26529,2020-06-29,Timor-Leste (East Timor),0,0,24,"rgb(254, 136, 177)"
26530,2020-06-30,Timor-Leste (East Timor),0,0,24,"rgb(254, 136, 177)"
26531,2020-07-01,Timor-Leste (East Timor),0,0,24,"rgb(254, 136, 177)"
26532,2020-07-02,Timor-Leste (East Timor),0,0,24,"rgb(254, 136, 177)"
26533,2020-07-03,Timor-Leste (East Timor),0,0,24,"rgb(254, 136, 177)"
26534,2020-07-04,Timor-Leste (East Timor),0,0,24,"rgb(254, 136, 177)"
26535,2020-07-05,Timor-Leste (East Timor),0,0,24,"rgb(254, 136, 177)"
26536,2020-07-06,Timor-Leste (East Timor),0,0,24,"rgb(254, 136, 177)"
26537,2020-07-07,Timor-Leste (East Timor),0,0,24,"rgb(254, 136, 177)"
26538,2020-07-08,Timor-Leste (East Timor),0,0,24,"rgb(254, 136, 177)"
26539,2020-07-09,Timor-Leste (East Timor),0,0,24,"rgb(254, 136, 177)"
26540,2020-07-10,Timor-Leste (East Timor),0,0,24,"rgb(254, 136, 177)"
26541,2020-07-11,Timor-Leste (East Timor),0,0,24,"rgb(254, 136, 177)"
26542,2020-07-12,Timor-Leste (East Timor),0,0,24,"rgb(254, 136, 177)"
26543,2020-07-13,Timor-Leste (East Timor),0,0,24,"rgb(254, 136, 177)"
26544,2020-03-03,Tunisia,0,1,1,"rgb(201, 219, 116)"
26545,2020-03-10,Tunisia,0,1,2,"rgb(201, 219, 116)"
26546,2020-03-11,Tunisia,0,3,5,"rgb(201, 219, 116)"
26547,2020-03-12,Tunisia,0,2,7,"rgb(201, 219, 116)"
26548,2020-03-13,Tunisia,0,6,13,"rgb(201, 219, 116)"
26549,2020-03-14,Tunisia,0,3,16,"rgb(201, 219, 116)"
26550,2020-03-15,Tunisia,0,0,16,"rgb(201, 219, 116)"
26551,2020-03-16,Tunisia,0,2,18,"rgb(201, 219, 116)"
26552,2020-03-17,Tunisia,0,2,20,"rgb(201, 219, 116)"
26553,2020-03-18,Tunisia,0,4,24,"rgb(201, 219, 116)"
26554,2020-03-19,Tunisia,0,5,29,"rgb(201, 219, 116)"
26555,2020-03-20,Tunisia,0,10,39,"rgb(201, 219, 116)"
26556,2020-03-21,Tunisia,1,15,54,"rgb(201, 219, 116)"
26557,2020-03-22,Tunisia,0,6,60,"rgb(201, 219, 116)"
26558,2020-03-23,Tunisia,2,15,75,"rgb(201, 219, 116)"
26559,2020-03-24,Tunisia,0,14,89,"rgb(201, 219, 116)"
26560,2020-03-25,Tunisia,0,25,114,"rgb(201, 219, 116)"
26561,2020-03-26,Tunisia,2,59,173,"rgb(201, 219, 116)"
26562,2020-03-27,Tunisia,0,0,173,"rgb(201, 219, 116)"
26563,2020-03-28,Tunisia,1,54,227,"rgb(201, 219, 116)"
26564,2020-03-29,Tunisia,0,0,227,"rgb(201, 219, 116)"
26565,2020-03-30,Tunisia,2,51,278,"rgb(201, 219, 116)"
26566,2020-03-31,Tunisia,0,34,312,"rgb(201, 219, 116)"
26567,2020-04-01,Tunisia,1,50,362,"rgb(201, 219, 116)"
26568,2020-04-02,Tunisia,1,32,394,"rgb(201, 219, 116)"
26569,2020-04-03,Tunisia,3,61,455,"rgb(201, 219, 116)"
26570,2020-04-04,Tunisia,0,0,455,"rgb(201, 219, 116)"
26571,2020-04-05,Tunisia,5,40,495,"rgb(201, 219, 116)"
26572,2020-04-06,Tunisia,1,58,553,"rgb(201, 219, 116)"
26573,2020-04-07,Tunisia,3,21,574,"rgb(201, 219, 116)"
26574,2020-04-08,Tunisia,0,22,596,"rgb(201, 219, 116)"
26575,2020-04-09,Tunisia,1,27,623,"rgb(201, 219, 116)"
26576,2020-04-10,Tunisia,2,20,643,"rgb(201, 219, 116)"
26577,2020-04-11,Tunisia,0,28,671,"rgb(201, 219, 116)"
26578,2020-04-12,Tunisia,3,14,685,"rgb(201, 219, 116)"
26579,2020-04-13,Tunisia,3,22,707,"rgb(201, 219, 116)"
26580,2020-04-14,Tunisia,3,19,726,"rgb(201, 219, 116)"
26581,2020-04-15,Tunisia,0,21,747,"rgb(201, 219, 116)"
26582,2020-04-16,Tunisia,1,33,780,"rgb(201, 219, 116)"
26583,2020-04-17,Tunisia,2,42,822,"rgb(201, 219, 116)"
26584,2020-04-18,Tunisia,0,42,864,"rgb(201, 219, 116)"
26585,2020-04-19,Tunisia,0,2,866,"rgb(201, 219, 116)"
26586,2020-04-20,Tunisia,1,13,879,"rgb(201, 219, 116)"
26587,2020-04-21,Tunisia,0,5,884,"rgb(201, 219, 116)"
26588,2020-04-22,Tunisia,0,17,901,"rgb(201, 219, 116)"
26589,2020-04-23,Tunisia,0,0,901,"rgb(201, 219, 116)"
26590,2020-04-24,Tunisia,0,17,918,"rgb(201, 219, 116)"
26591,2020-04-25,Tunisia,0,4,922,"rgb(201, 219, 116)"
26592,2020-04-26,Tunisia,0,17,939,"rgb(201, 219, 116)"
26593,2020-04-27,Tunisia,0,10,949,"rgb(201, 219, 116)"
26594,2020-04-28,Tunisia,1,18,967,"rgb(201, 219, 116)"
26595,2020-04-29,Tunisia,1,8,975,"rgb(201, 219, 116)"
26596,2020-04-30,Tunisia,0,5,980,"rgb(201, 219, 116)"
26597,2020-05-01,Tunisia,0,14,994,"rgb(201, 219, 116)"
26598,2020-05-02,Tunisia,1,4,998,"rgb(201, 219, 116)"
26599,2020-05-03,Tunisia,1,11,1009,"rgb(201, 219, 116)"
26600,2020-05-04,Tunisia,0,4,1013,"rgb(201, 219, 116)"
26601,2020-05-05,Tunisia,1,5,1018,"rgb(201, 219, 116)"
26602,2020-05-06,Tunisia,0,4,1022,"rgb(201, 219, 116)"
26603,2020-05-07,Tunisia,0,3,1025,"rgb(201, 219, 116)"
26604,2020-05-08,Tunisia,1,1,1026,"rgb(201, 219, 116)"
26605,2020-05-09,Tunisia,1,4,1030,"rgb(201, 219, 116)"
26606,2020-05-10,Tunisia,0,2,1032,"rgb(201, 219, 116)"
26607,2020-05-11,Tunisia,0,0,1032,"rgb(201, 219, 116)"
26608,2020-05-12,Tunisia,0,0,1032,"rgb(201, 219, 116)"
26609,2020-05-13,Tunisia,0,0,1032,"rgb(201, 219, 116)"
26610,2020-05-14,Tunisia,0,0,1032,"rgb(201, 219, 116)"
26611,2020-05-15,Tunisia,0,0,1032,"rgb(201, 219, 116)"
26612,2020-05-16,Tunisia,0,3,1035,"rgb(201, 219, 116)"
26613,2020-05-17,Tunisia,0,0,1035,"rgb(201, 219, 116)"
26614,2020-05-18,Tunisia,0,2,1037,"rgb(201, 219, 116)"
26615,2020-05-19,Tunisia,1,6,1043,"rgb(201, 219, 116)"
26616,2020-05-20,Tunisia,1,1,1044,"rgb(201, 219, 116)"
26617,2020-05-21,Tunisia,0,1,1045,"rgb(201, 219, 116)"
26618,2020-05-22,Tunisia,0,1,1046,"rgb(201, 219, 116)"
26619,2020-05-23,Tunisia,0,2,1048,"rgb(201, 219, 116)"
26620,2020-05-24,Tunisia,1,0,1048,"rgb(201, 219, 116)"
26621,2020-05-25,Tunisia,0,3,1051,"rgb(201, 219, 116)"
26622,2020-05-26,Tunisia,0,0,1051,"rgb(201, 219, 116)"
26623,2020-05-27,Tunisia,0,0,1051,"rgb(201, 219, 116)"
26624,2020-05-28,Tunisia,0,0,1051,"rgb(201, 219, 116)"
26625,2020-05-29,Tunisia,0,17,1068,"rgb(201, 219, 116)"
26626,2020-05-30,Tunisia,0,3,1071,"rgb(201, 219, 116)"
26627,2020-05-31,Tunisia,0,5,1076,"rgb(201, 219, 116)"
26628,2020-06-01,Tunisia,0,1,1077,"rgb(201, 219, 116)"
26629,2020-06-02,Tunisia,0,7,1084,"rgb(201, 219, 116)"
26630,2020-06-03,Tunisia,0,2,1086,"rgb(201, 219, 116)"
26631,2020-06-04,Tunisia,1,1,1087,"rgb(201, 219, 116)"
26632,2020-06-05,Tunisia,0,0,1087,"rgb(201, 219, 116)"
26633,2020-06-06,Tunisia,0,0,1087,"rgb(201, 219, 116)"
26634,2020-06-07,Tunisia,0,0,1087,"rgb(201, 219, 116)"
26635,2020-06-08,Tunisia,0,0,1087,"rgb(201, 219, 116)"
26636,2020-06-09,Tunisia,0,0,1087,"rgb(201, 219, 116)"
26637,2020-06-10,Tunisia,0,0,1087,"rgb(201, 219, 116)"
26638,2020-06-11,Tunisia,0,0,1087,"rgb(201, 219, 116)"
26639,2020-06-12,Tunisia,0,0,1087,"rgb(201, 219, 116)"
26640,2020-06-13,Tunisia,0,6,1093,"rgb(201, 219, 116)"
26641,2020-06-14,Tunisia,0,1,1094,"rgb(201, 219, 116)"
26642,2020-06-15,Tunisia,0,2,1096,"rgb(201, 219, 116)"
26643,2020-06-16,Tunisia,0,14,1110,"rgb(201, 219, 116)"
26644,2020-06-17,Tunisia,0,15,1125,"rgb(201, 219, 116)"
26645,2020-06-18,Tunisia,1,3,1128,"rgb(201, 219, 116)"
26646,2020-06-19,Tunisia,0,4,1132,"rgb(201, 219, 116)"
26647,2020-06-20,Tunisia,0,14,1146,"rgb(201, 219, 116)"
26648,2020-06-21,Tunisia,0,10,1156,"rgb(201, 219, 116)"
26649,2020-06-22,Tunisia,0,1,1157,"rgb(201, 219, 116)"
26650,2020-06-23,Tunisia,0,2,1159,"rgb(201, 219, 116)"
26651,2020-06-24,Tunisia,0,0,1159,"rgb(201, 219, 116)"
26652,2020-06-25,Tunisia,0,1,1160,"rgb(201, 219, 116)"
26653,2020-06-26,Tunisia,0,2,1162,"rgb(201, 219, 116)"
26654,2020-06-27,Tunisia,0,2,1164,"rgb(201, 219, 116)"
26655,2020-06-28,Tunisia,0,4,1168,"rgb(201, 219, 116)"
26656,2020-06-29,Tunisia,0,1,1169,"rgb(201, 219, 116)"
26657,2020-06-30,Tunisia,0,3,1172,"rgb(201, 219, 116)"
26658,2020-07-01,Tunisia,0,2,1174,"rgb(201, 219, 116)"
26659,2020-07-02,Tunisia,0,1,1175,"rgb(201, 219, 116)"
26660,2020-07-03,Tunisia,0,3,1178,"rgb(201, 219, 116)"
26661,2020-07-04,Tunisia,0,3,1181,"rgb(201, 219, 116)"
26662,2020-07-05,Tunisia,0,5,1186,"rgb(201, 219, 116)"
26663,2020-07-06,Tunisia,0,2,1188,"rgb(201, 219, 116)"
26664,2020-07-07,Tunisia,0,11,1199,"rgb(201, 219, 116)"
26665,2020-07-08,Tunisia,0,6,1205,"rgb(201, 219, 116)"
26666,2020-07-09,Tunisia,0,16,1221,"rgb(201, 219, 116)"
26667,2020-07-10,Tunisia,0,10,1231,"rgb(201, 219, 116)"
26668,2020-07-11,Tunisia,0,9,1240,"rgb(201, 219, 116)"
26669,2020-07-12,Tunisia,0,5,1245,"rgb(201, 219, 116)"
26670,2020-07-13,Tunisia,0,18,1263,"rgb(201, 219, 116)"
26671,2020-03-12,Turkey,0,1,1,"rgb(139, 224, 164)"
26672,2020-03-13,Turkey,0,1,2,"rgb(139, 224, 164)"
26673,2020-03-16,Turkey,0,16,18,"rgb(139, 224, 164)"
26674,2020-03-17,Turkey,0,29,47,"rgb(139, 224, 164)"
26675,2020-03-18,Turkey,0,51,98,"rgb(139, 224, 164)"
26676,2020-03-19,Turkey,1,93,191,"rgb(139, 224, 164)"
26677,2020-03-20,Turkey,3,168,359,"rgb(139, 224, 164)"
26678,2020-03-21,Turkey,5,311,670,"rgb(139, 224, 164)"
26679,2020-03-22,Turkey,12,277,947,"rgb(139, 224, 164)"
26680,2020-03-23,Turkey,9,289,1236,"rgb(139, 224, 164)"
26681,2020-03-24,Turkey,7,293,1529,"rgb(139, 224, 164)"
26682,2020-03-25,Turkey,7,343,1872,"rgb(139, 224, 164)"
26683,2020-03-26,Turkey,15,561,2433,"rgb(139, 224, 164)"
26684,2020-03-27,Turkey,16,1196,3629,"rgb(139, 224, 164)"
26685,2020-03-28,Turkey,17,2069,5698,"rgb(139, 224, 164)"
26686,2020-03-29,Turkey,16,1704,7402,"rgb(139, 224, 164)"
26687,2020-03-30,Turkey,23,1815,9217,"rgb(139, 224, 164)"
26688,2020-03-31,Turkey,37,1610,10827,"rgb(139, 224, 164)"
26689,2020-04-01,Turkey,46,2704,13531,"rgb(139, 224, 164)"
26690,2020-04-02,Turkey,63,2148,15679,"rgb(139, 224, 164)"
26691,2020-04-03,Turkey,79,2456,18135,"rgb(139, 224, 164)"
26692,2020-04-04,Turkey,69,2786,20921,"rgb(139, 224, 164)"
26693,2020-04-05,Turkey,76,3013,23934,"rgb(139, 224, 164)"
26694,2020-04-06,Turkey,73,3135,27069,"rgb(139, 224, 164)"
26695,2020-04-07,Turkey,75,3148,30217,"rgb(139, 224, 164)"
26696,2020-04-08,Turkey,76,3892,34109,"rgb(139, 224, 164)"
26697,2020-04-09,Turkey,87,4117,38226,"rgb(139, 224, 164)"
26698,2020-04-10,Turkey,96,4056,42282,"rgb(139, 224, 164)"
26699,2020-04-11,Turkey,98,4747,47029,"rgb(139, 224, 164)"
26700,2020-04-12,Turkey,95,5138,52167,"rgb(139, 224, 164)"
26701,2020-04-13,Turkey,97,4789,56956,"rgb(139, 224, 164)"
26702,2020-04-14,Turkey,98,4093,61049,"rgb(139, 224, 164)"
26703,2020-04-15,Turkey,107,4062,65111,"rgb(139, 224, 164)"
26704,2020-04-16,Turkey,115,4281,69392,"rgb(139, 224, 164)"
26705,2020-04-17,Turkey,125,4801,74193,"rgb(139, 224, 164)"
26706,2020-04-18,Turkey,126,4353,78546,"rgb(139, 224, 164)"
26707,2020-04-19,Turkey,121,3783,82329,"rgb(139, 224, 164)"
26708,2020-04-20,Turkey,127,3977,86306,"rgb(139, 224, 164)"
26709,2020-04-21,Turkey,123,4674,90980,"rgb(139, 224, 164)"
26710,2020-04-22,Turkey,119,4611,95591,"rgb(139, 224, 164)"
26711,2020-04-23,Turkey,117,3083,98674,"rgb(139, 224, 164)"
26712,2020-04-24,Turkey,115,3116,101790,"rgb(139, 224, 164)"
26713,2020-04-25,Turkey,109,3122,104912,"rgb(139, 224, 164)"
26714,2020-04-26,Turkey,106,2861,107773,"rgb(139, 224, 164)"
26715,2020-04-27,Turkey,99,2357,110130,"rgb(139, 224, 164)"
26716,2020-04-28,Turkey,95,2131,112261,"rgb(139, 224, 164)"
26717,2020-04-29,Turkey,92,2392,114653,"rgb(139, 224, 164)"
26718,2020-04-30,Turkey,89,2936,117589,"rgb(139, 224, 164)"
26719,2020-05-01,Turkey,93,2615,120204,"rgb(139, 224, 164)"
26720,2020-05-02,Turkey,84,2188,122392,"rgb(139, 224, 164)"
26721,2020-05-03,Turkey,78,1983,124375,"rgb(139, 224, 164)"
26722,2020-05-04,Turkey,61,1670,126045,"rgb(139, 224, 164)"
26723,2020-05-05,Turkey,64,1614,127659,"rgb(139, 224, 164)"
26724,2020-05-06,Turkey,59,1832,129491,"rgb(139, 224, 164)"
26725,2020-05-07,Turkey,64,2253,131744,"rgb(139, 224, 164)"
26726,2020-05-08,Turkey,57,1977,133721,"rgb(139, 224, 164)"
26727,2020-05-09,Turkey,48,1848,135569,"rgb(139, 224, 164)"
26728,2020-05-10,Turkey,50,1546,137115,"rgb(139, 224, 164)"
26729,2020-05-11,Turkey,47,1542,138657,"rgb(139, 224, 164)"
26730,2020-05-12,Turkey,55,1114,139771,"rgb(139, 224, 164)"
26731,2020-05-13,Turkey,53,1704,141475,"rgb(139, 224, 164)"
26732,2020-05-14,Turkey,58,1639,143114,"rgb(139, 224, 164)"
26733,2020-05-15,Turkey,55,1635,144749,"rgb(139, 224, 164)"
26734,2020-05-16,Turkey,48,1708,146457,"rgb(139, 224, 164)"
26735,2020-05-17,Turkey,41,1610,148067,"rgb(139, 224, 164)"
26736,2020-05-18,Turkey,44,1368,149435,"rgb(139, 224, 164)"
26737,2020-05-19,Turkey,31,1158,150593,"rgb(139, 224, 164)"
26738,2020-05-20,Turkey,28,1022,151615,"rgb(139, 224, 164)"
26739,2020-05-21,Turkey,23,972,152587,"rgb(139, 224, 164)"
26740,2020-05-22,Turkey,27,961,153548,"rgb(139, 224, 164)"
26741,2020-05-23,Turkey,27,952,154500,"rgb(139, 224, 164)"
26742,2020-05-24,Turkey,32,1186,155686,"rgb(139, 224, 164)"
26743,2020-05-25,Turkey,32,1141,156827,"rgb(139, 224, 164)"
26744,2020-05-26,Turkey,29,987,157814,"rgb(139, 224, 164)"
26745,2020-05-27,Turkey,28,948,158762,"rgb(139, 224, 164)"
26746,2020-05-28,Turkey,34,1035,159797,"rgb(139, 224, 164)"
26747,2020-05-29,Turkey,30,1182,160979,"rgb(139, 224, 164)"
26748,2020-05-30,Turkey,28,1141,162120,"rgb(139, 224, 164)"
26749,2020-05-31,Turkey,26,983,163103,"rgb(139, 224, 164)"
26750,2020-06-01,Turkey,25,839,163942,"rgb(139, 224, 164)"
26751,2020-06-02,Turkey,23,827,164769,"rgb(139, 224, 164)"
26752,2020-06-03,Turkey,22,786,165555,"rgb(139, 224, 164)"
26753,2020-06-04,Turkey,24,867,166422,"rgb(139, 224, 164)"
26754,2020-06-05,Turkey,21,988,167410,"rgb(139, 224, 164)"
26755,2020-06-06,Turkey,18,930,168340,"rgb(139, 224, 164)"
26756,2020-06-07,Turkey,21,878,169218,"rgb(139, 224, 164)"
26757,2020-06-08,Turkey,23,914,170132,"rgb(139, 224, 164)"
26758,2020-06-09,Turkey,19,989,171121,"rgb(139, 224, 164)"
26759,2020-06-10,Turkey,18,993,172114,"rgb(139, 224, 164)"
26760,2020-06-11,Turkey,17,922,173036,"rgb(139, 224, 164)"
26761,2020-06-12,Turkey,17,987,174023,"rgb(139, 224, 164)"
26762,2020-06-13,Turkey,15,1195,175218,"rgb(139, 224, 164)"
26763,2020-06-14,Turkey,14,1459,176677,"rgb(139, 224, 164)"
26764,2020-06-15,Turkey,15,1562,178239,"rgb(139, 224, 164)"
26765,2020-06-16,Turkey,18,1592,179831,"rgb(139, 224, 164)"
26766,2020-06-17,Turkey,17,1467,181298,"rgb(139, 224, 164)"
26767,2020-06-18,Turkey,19,1429,182727,"rgb(139, 224, 164)"
26768,2020-06-19,Turkey,21,1304,184031,"rgb(139, 224, 164)"
26769,2020-06-20,Turkey,23,1214,185245,"rgb(139, 224, 164)"
26770,2020-06-21,Turkey,22,1248,186493,"rgb(139, 224, 164)"
26771,2020-06-22,Turkey,23,1192,187685,"rgb(139, 224, 164)"
26772,2020-06-23,Turkey,24,1212,188897,"rgb(139, 224, 164)"
26773,2020-06-24,Turkey,27,1268,190165,"rgb(139, 224, 164)"
26774,2020-06-25,Turkey,24,1492,191657,"rgb(139, 224, 164)"
26775,2020-06-26,Turkey,21,1458,193115,"rgb(139, 224, 164)"
26776,2020-06-27,Turkey,19,1396,194511,"rgb(139, 224, 164)"
26777,2020-06-28,Turkey,17,1372,195883,"rgb(139, 224, 164)"
26778,2020-06-29,Turkey,15,1356,197239,"rgb(139, 224, 164)"
26779,2020-06-30,Turkey,18,1374,198613,"rgb(139, 224, 164)"
26780,2020-07-01,Turkey,16,1293,199906,"rgb(139, 224, 164)"
26781,2020-07-02,Turkey,19,1192,201098,"rgb(139, 224, 164)"
26782,2020-07-03,Turkey,17,1186,202284,"rgb(139, 224, 164)"
26783,2020-07-04,Turkey,19,1172,203456,"rgb(139, 224, 164)"
26784,2020-07-05,Turkey,20,1154,204610,"rgb(139, 224, 164)"
26785,2020-07-06,Turkey,19,1148,205758,"rgb(139, 224, 164)"
26786,2020-07-07,Turkey,16,1086,206844,"rgb(139, 224, 164)"
26787,2020-07-08,Turkey,19,1053,207897,"rgb(139, 224, 164)"
26788,2020-07-09,Turkey,22,1041,208938,"rgb(139, 224, 164)"
26789,2020-07-10,Turkey,18,1024,209962,"rgb(139, 224, 164)"
26790,2020-07-11,Turkey,23,1003,210965,"rgb(139, 224, 164)"
26791,2020-07-12,Turkey,21,1016,211981,"rgb(139, 224, 164)"
26792,2020-07-13,Turkey,19,1012,212993,"rgb(139, 224, 164)"
26793,2020-03-13,Trinidad and Tobago,0,1,1,"rgb(180, 151, 231)"
26794,2020-03-14,Trinidad and Tobago,0,1,2,"rgb(180, 151, 231)"
26795,2020-03-15,Trinidad and Tobago,0,0,2,"rgb(180, 151, 231)"
26796,2020-03-16,Trinidad and Tobago,0,2,4,"rgb(180, 151, 231)"
26797,2020-03-17,Trinidad and Tobago,0,1,5,"rgb(180, 151, 231)"
26798,2020-03-18,Trinidad and Tobago,0,2,7,"rgb(180, 151, 231)"
26799,2020-03-19,Trinidad and Tobago,0,2,9,"rgb(180, 151, 231)"
26800,2020-03-20,Trinidad and Tobago,0,0,9,"rgb(180, 151, 231)"
26801,2020-03-21,Trinidad and Tobago,0,0,9,"rgb(180, 151, 231)"
26802,2020-03-22,Trinidad and Tobago,0,40,49,"rgb(180, 151, 231)"
26803,2020-03-23,Trinidad and Tobago,0,1,50,"rgb(180, 151, 231)"
26804,2020-03-24,Trinidad and Tobago,0,1,51,"rgb(180, 151, 231)"
26805,2020-03-25,Trinidad and Tobago,0,6,57,"rgb(180, 151, 231)"
26806,2020-03-26,Trinidad and Tobago,1,3,60,"rgb(180, 151, 231)"
26807,2020-03-27,Trinidad and Tobago,0,5,65,"rgb(180, 151, 231)"
26808,2020-03-28,Trinidad and Tobago,1,1,66,"rgb(180, 151, 231)"
26809,2020-03-29,Trinidad and Tobago,0,8,74,"rgb(180, 151, 231)"
26810,2020-03-30,Trinidad and Tobago,1,4,78,"rgb(180, 151, 231)"
26811,2020-03-31,Trinidad and Tobago,0,7,85,"rgb(180, 151, 231)"
26812,2020-04-01,Trinidad and Tobago,0,2,87,"rgb(180, 151, 231)"
26813,2020-04-02,Trinidad and Tobago,2,2,89,"rgb(180, 151, 231)"
26814,2020-04-03,Trinidad and Tobago,1,8,97,"rgb(180, 151, 231)"
26815,2020-04-04,Trinidad and Tobago,0,3,100,"rgb(180, 151, 231)"
26816,2020-04-05,Trinidad and Tobago,0,3,103,"rgb(180, 151, 231)"
26817,2020-04-06,Trinidad and Tobago,1,1,104,"rgb(180, 151, 231)"
26818,2020-04-07,Trinidad and Tobago,1,1,105,"rgb(180, 151, 231)"
26819,2020-04-08,Trinidad and Tobago,0,2,107,"rgb(180, 151, 231)"
26820,2020-04-09,Trinidad and Tobago,0,0,107,"rgb(180, 151, 231)"
26821,2020-04-10,Trinidad and Tobago,0,2,109,"rgb(180, 151, 231)"
26822,2020-04-11,Trinidad and Tobago,0,0,109,"rgb(180, 151, 231)"
26823,2020-04-12,Trinidad and Tobago,0,3,112,"rgb(180, 151, 231)"
26824,2020-04-13,Trinidad and Tobago,0,1,113,"rgb(180, 151, 231)"
26825,2020-04-14,Trinidad and Tobago,0,0,113,"rgb(180, 151, 231)"
26826,2020-04-15,Trinidad and Tobago,0,0,113,"rgb(180, 151, 231)"
26827,2020-04-16,Trinidad and Tobago,0,1,114,"rgb(180, 151, 231)"
26828,2020-04-17,Trinidad and Tobago,0,0,114,"rgb(180, 151, 231)"
26829,2020-04-18,Trinidad and Tobago,0,0,114,"rgb(180, 151, 231)"
26830,2020-04-19,Trinidad and Tobago,0,0,114,"rgb(180, 151, 231)"
26831,2020-04-20,Trinidad and Tobago,0,0,114,"rgb(180, 151, 231)"
26832,2020-04-21,Trinidad and Tobago,0,0,114,"rgb(180, 151, 231)"
26833,2020-04-22,Trinidad and Tobago,0,1,115,"rgb(180, 151, 231)"
26834,2020-04-23,Trinidad and Tobago,0,0,115,"rgb(180, 151, 231)"
26835,2020-04-24,Trinidad and Tobago,0,0,115,"rgb(180, 151, 231)"
26836,2020-04-25,Trinidad and Tobago,0,0,115,"rgb(180, 151, 231)"
26837,2020-04-26,Trinidad and Tobago,0,0,115,"rgb(180, 151, 231)"
26838,2020-04-27,Trinidad and Tobago,0,1,116,"rgb(180, 151, 231)"
26839,2020-04-28,Trinidad and Tobago,0,0,116,"rgb(180, 151, 231)"
26840,2020-04-29,Trinidad and Tobago,0,0,116,"rgb(180, 151, 231)"
26841,2020-04-30,Trinidad and Tobago,0,0,116,"rgb(180, 151, 231)"
26842,2020-05-01,Trinidad and Tobago,0,0,116,"rgb(180, 151, 231)"
26843,2020-05-02,Trinidad and Tobago,0,0,116,"rgb(180, 151, 231)"
26844,2020-05-03,Trinidad and Tobago,0,0,116,"rgb(180, 151, 231)"
26845,2020-05-04,Trinidad and Tobago,0,0,116,"rgb(180, 151, 231)"
26846,2020-05-05,Trinidad and Tobago,0,0,116,"rgb(180, 151, 231)"
26847,2020-05-06,Trinidad and Tobago,0,0,116,"rgb(180, 151, 231)"
26848,2020-05-07,Trinidad and Tobago,0,0,116,"rgb(180, 151, 231)"
26849,2020-05-08,Trinidad and Tobago,0,0,116,"rgb(180, 151, 231)"
26850,2020-05-09,Trinidad and Tobago,0,0,116,"rgb(180, 151, 231)"
26851,2020-05-10,Trinidad and Tobago,0,0,116,"rgb(180, 151, 231)"
26852,2020-05-11,Trinidad and Tobago,0,0,116,"rgb(180, 151, 231)"
26853,2020-05-12,Trinidad and Tobago,0,0,116,"rgb(180, 151, 231)"
26854,2020-05-13,Trinidad and Tobago,0,0,116,"rgb(180, 151, 231)"
26855,2020-05-14,Trinidad and Tobago,0,0,116,"rgb(180, 151, 231)"
26856,2020-05-15,Trinidad and Tobago,0,0,116,"rgb(180, 151, 231)"
26857,2020-05-16,Trinidad and Tobago,0,0,116,"rgb(180, 151, 231)"
26858,2020-05-17,Trinidad and Tobago,0,0,116,"rgb(180, 151, 231)"
26859,2020-05-18,Trinidad and Tobago,0,0,116,"rgb(180, 151, 231)"
26860,2020-05-19,Trinidad and Tobago,0,0,116,"rgb(180, 151, 231)"
26861,2020-05-20,Trinidad and Tobago,0,0,116,"rgb(180, 151, 231)"
26862,2020-05-21,Trinidad and Tobago,0,0,116,"rgb(180, 151, 231)"
26863,2020-05-22,Trinidad and Tobago,0,0,116,"rgb(180, 151, 231)"
26864,2020-05-23,Trinidad and Tobago,0,0,116,"rgb(180, 151, 231)"
26865,2020-05-24,Trinidad and Tobago,0,0,116,"rgb(180, 151, 231)"
26866,2020-05-25,Trinidad and Tobago,0,0,116,"rgb(180, 151, 231)"
26867,2020-05-26,Trinidad and Tobago,0,0,116,"rgb(180, 151, 231)"
26868,2020-05-27,Trinidad and Tobago,0,0,116,"rgb(180, 151, 231)"
26869,2020-05-28,Trinidad and Tobago,0,0,116,"rgb(180, 151, 231)"
26870,2020-05-29,Trinidad and Tobago,0,0,116,"rgb(180, 151, 231)"
26871,2020-05-30,Trinidad and Tobago,0,0,116,"rgb(180, 151, 231)"
26872,2020-05-31,Trinidad and Tobago,0,1,117,"rgb(180, 151, 231)"
26873,2020-06-01,Trinidad and Tobago,0,0,117,"rgb(180, 151, 231)"
26874,2020-06-02,Trinidad and Tobago,0,0,117,"rgb(180, 151, 231)"
26875,2020-06-03,Trinidad and Tobago,0,0,117,"rgb(180, 151, 231)"
26876,2020-06-04,Trinidad and Tobago,0,0,117,"rgb(180, 151, 231)"
26877,2020-06-05,Trinidad and Tobago,0,0,117,"rgb(180, 151, 231)"
26878,2020-06-06,Trinidad and Tobago,0,0,117,"rgb(180, 151, 231)"
26879,2020-06-07,Trinidad and Tobago,0,0,117,"rgb(180, 151, 231)"
26880,2020-06-08,Trinidad and Tobago,0,0,117,"rgb(180, 151, 231)"
26881,2020-06-09,Trinidad and Tobago,0,0,117,"rgb(180, 151, 231)"
26882,2020-06-10,Trinidad and Tobago,0,0,117,"rgb(180, 151, 231)"
26883,2020-06-11,Trinidad and Tobago,0,0,117,"rgb(180, 151, 231)"
26884,2020-06-12,Trinidad and Tobago,0,0,117,"rgb(180, 151, 231)"
26885,2020-06-13,Trinidad and Tobago,0,0,117,"rgb(180, 151, 231)"
26886,2020-06-14,Trinidad and Tobago,0,0,117,"rgb(180, 151, 231)"
26887,2020-06-15,Trinidad and Tobago,0,6,123,"rgb(180, 151, 231)"
26888,2020-06-16,Trinidad and Tobago,0,0,123,"rgb(180, 151, 231)"
26889,2020-06-17,Trinidad and Tobago,0,0,123,"rgb(180, 151, 231)"
26890,2020-06-18,Trinidad and Tobago,0,0,123,"rgb(180, 151, 231)"
26891,2020-06-19,Trinidad and Tobago,0,0,123,"rgb(180, 151, 231)"
26892,2020-06-20,Trinidad and Tobago,0,0,123,"rgb(180, 151, 231)"
26893,2020-06-21,Trinidad and Tobago,0,0,123,"rgb(180, 151, 231)"
26894,2020-06-22,Trinidad and Tobago,0,0,123,"rgb(180, 151, 231)"
26895,2020-06-23,Trinidad and Tobago,0,0,123,"rgb(180, 151, 231)"
26896,2020-06-24,Trinidad and Tobago,0,0,123,"rgb(180, 151, 231)"
26897,2020-06-25,Trinidad and Tobago,0,0,123,"rgb(180, 151, 231)"
26898,2020-06-26,Trinidad and Tobago,0,0,123,"rgb(180, 151, 231)"
26899,2020-06-27,Trinidad and Tobago,0,1,124,"rgb(180, 151, 231)"
26900,2020-06-28,Trinidad and Tobago,0,0,124,"rgb(180, 151, 231)"
26901,2020-06-29,Trinidad and Tobago,0,2,126,"rgb(180, 151, 231)"
26902,2020-06-30,Trinidad and Tobago,0,0,126,"rgb(180, 151, 231)"
26903,2020-07-01,Trinidad and Tobago,0,4,130,"rgb(180, 151, 231)"
26904,2020-07-02,Trinidad and Tobago,0,0,130,"rgb(180, 151, 231)"
26905,2020-07-03,Trinidad and Tobago,0,0,130,"rgb(180, 151, 231)"
26906,2020-07-04,Trinidad and Tobago,0,0,130,"rgb(180, 151, 231)"
26907,2020-07-05,Trinidad and Tobago,0,0,130,"rgb(180, 151, 231)"
26908,2020-07-06,Trinidad and Tobago,0,3,133,"rgb(180, 151, 231)"
26909,2020-07-07,Trinidad and Tobago,0,0,133,"rgb(180, 151, 231)"
26910,2020-07-08,Trinidad and Tobago,0,0,133,"rgb(180, 151, 231)"
26911,2020-07-09,Trinidad and Tobago,0,0,133,"rgb(180, 151, 231)"
26912,2020-07-10,Trinidad and Tobago,0,0,133,"rgb(180, 151, 231)"
26913,2020-07-11,Trinidad and Tobago,0,0,133,"rgb(180, 151, 231)"
26914,2020-07-12,Trinidad and Tobago,0,0,133,"rgb(180, 151, 231)"
26915,2020-07-13,Trinidad and Tobago,0,0,133,"rgb(180, 151, 231)"
26916,2019-12-31,Taiwan,0,0,0,"rgb(179, 179, 179)"
26917,2020-01-01,Taiwan,0,0,0,"rgb(179, 179, 179)"
26918,2020-01-02,Taiwan,0,0,0,"rgb(179, 179, 179)"
26919,2020-01-03,Taiwan,0,0,0,"rgb(179, 179, 179)"
26920,2020-01-04,Taiwan,0,0,0,"rgb(179, 179, 179)"
26921,2020-01-05,Taiwan,0,0,0,"rgb(179, 179, 179)"
26922,2020-01-06,Taiwan,0,0,0,"rgb(179, 179, 179)"
26923,2020-01-07,Taiwan,0,0,0,"rgb(179, 179, 179)"
26924,2020-01-08,Taiwan,0,0,0,"rgb(179, 179, 179)"
26925,2020-01-09,Taiwan,0,0,0,"rgb(179, 179, 179)"
26926,2020-01-10,Taiwan,0,0,0,"rgb(179, 179, 179)"
26927,2020-01-11,Taiwan,0,0,0,"rgb(179, 179, 179)"
26928,2020-01-12,Taiwan,0,0,0,"rgb(179, 179, 179)"
26929,2020-01-13,Taiwan,0,0,0,"rgb(179, 179, 179)"
26930,2020-01-14,Taiwan,0,0,0,"rgb(179, 179, 179)"
26931,2020-01-15,Taiwan,0,0,0,"rgb(179, 179, 179)"
26932,2020-01-16,Taiwan,0,0,0,"rgb(179, 179, 179)"
26933,2020-01-17,Taiwan,0,0,0,"rgb(179, 179, 179)"
26934,2020-01-18,Taiwan,0,0,0,"rgb(179, 179, 179)"
26935,2020-01-19,Taiwan,0,0,0,"rgb(179, 179, 179)"
26936,2020-01-20,Taiwan,0,0,0,"rgb(179, 179, 179)"
26937,2020-01-21,Taiwan,0,1,1,"rgb(179, 179, 179)"
26938,2020-01-22,Taiwan,0,0,1,"rgb(179, 179, 179)"
26939,2020-01-23,Taiwan,0,0,1,"rgb(179, 179, 179)"
26940,2020-01-24,Taiwan,0,0,1,"rgb(179, 179, 179)"
26941,2020-01-25,Taiwan,0,2,3,"rgb(179, 179, 179)"
26942,2020-01-26,Taiwan,0,0,3,"rgb(179, 179, 179)"
26943,2020-01-27,Taiwan,0,2,5,"rgb(179, 179, 179)"
26944,2020-01-28,Taiwan,0,2,7,"rgb(179, 179, 179)"
26945,2020-01-29,Taiwan,0,1,8,"rgb(179, 179, 179)"
26946,2020-01-30,Taiwan,0,0,8,"rgb(179, 179, 179)"
26947,2020-01-31,Taiwan,0,1,9,"rgb(179, 179, 179)"
26948,2020-02-01,Taiwan,0,1,10,"rgb(179, 179, 179)"
26949,2020-02-02,Taiwan,0,0,10,"rgb(179, 179, 179)"
26950,2020-02-03,Taiwan,0,0,10,"rgb(179, 179, 179)"
26951,2020-02-04,Taiwan,0,0,10,"rgb(179, 179, 179)"
26952,2020-02-05,Taiwan,0,1,11,"rgb(179, 179, 179)"
26953,2020-02-06,Taiwan,0,0,11,"rgb(179, 179, 179)"
26954,2020-02-07,Taiwan,0,5,16,"rgb(179, 179, 179)"
26955,2020-02-08,Taiwan,0,1,17,"rgb(179, 179, 179)"
26956,2020-02-09,Taiwan,0,1,18,"rgb(179, 179, 179)"
26957,2020-02-10,Taiwan,0,0,18,"rgb(179, 179, 179)"
26958,2020-02-11,Taiwan,0,0,18,"rgb(179, 179, 179)"
26959,2020-02-12,Taiwan,0,0,18,"rgb(179, 179, 179)"
26960,2020-02-13,Taiwan,0,0,18,"rgb(179, 179, 179)"
26961,2020-02-14,Taiwan,0,0,18,"rgb(179, 179, 179)"
26962,2020-02-15,Taiwan,0,0,18,"rgb(179, 179, 179)"
26963,2020-02-16,Taiwan,0,0,18,"rgb(179, 179, 179)"
26964,2020-02-17,Taiwan,1,2,20,"rgb(179, 179, 179)"
26965,2020-02-18,Taiwan,0,2,22,"rgb(179, 179, 179)"
26966,2020-02-19,Taiwan,0,0,22,"rgb(179, 179, 179)"
26967,2020-02-20,Taiwan,0,2,24,"rgb(179, 179, 179)"
26968,2020-02-21,Taiwan,0,0,24,"rgb(179, 179, 179)"
26969,2020-02-22,Taiwan,0,2,26,"rgb(179, 179, 179)"
26970,2020-02-23,Taiwan,0,0,26,"rgb(179, 179, 179)"
26971,2020-02-24,Taiwan,0,2,28,"rgb(179, 179, 179)"
26972,2020-02-25,Taiwan,0,2,30,"rgb(179, 179, 179)"
26973,2020-02-26,Taiwan,0,1,31,"rgb(179, 179, 179)"
26974,2020-02-27,Taiwan,0,1,32,"rgb(179, 179, 179)"
26975,2020-02-28,Taiwan,0,2,34,"rgb(179, 179, 179)"
26976,2020-02-29,Taiwan,0,5,39,"rgb(179, 179, 179)"
26977,2020-03-01,Taiwan,0,1,40,"rgb(179, 179, 179)"
26978,2020-03-02,Taiwan,0,0,40,"rgb(179, 179, 179)"
26979,2020-03-03,Taiwan,0,1,41,"rgb(179, 179, 179)"
26980,2020-03-04,Taiwan,0,1,42,"rgb(179, 179, 179)"
26981,2020-03-06,Taiwan,0,2,44,"rgb(179, 179, 179)"
26982,2020-03-07,Taiwan,0,1,45,"rgb(179, 179, 179)"
26983,2020-03-08,Taiwan,0,0,45,"rgb(179, 179, 179)"
26984,2020-03-09,Taiwan,0,0,45,"rgb(179, 179, 179)"
26985,2020-03-11,Taiwan,0,3,48,"rgb(179, 179, 179)"
26986,2020-03-12,Taiwan,0,0,48,"rgb(179, 179, 179)"
26987,2020-03-13,Taiwan,0,1,49,"rgb(179, 179, 179)"
26988,2020-03-14,Taiwan,0,4,53,"rgb(179, 179, 179)"
26989,2020-03-15,Taiwan,0,6,59,"rgb(179, 179, 179)"
26990,2020-03-16,Taiwan,0,0,59,"rgb(179, 179, 179)"
26991,2020-03-17,Taiwan,0,8,67,"rgb(179, 179, 179)"
26992,2020-03-18,Taiwan,0,10,77,"rgb(179, 179, 179)"
26993,2020-03-19,Taiwan,0,31,108,"rgb(179, 179, 179)"
26994,2020-03-20,Taiwan,0,0,108,"rgb(179, 179, 179)"
26995,2020-03-21,Taiwan,1,27,135,"rgb(179, 179, 179)"
26996,2020-03-22,Taiwan,0,18,153,"rgb(179, 179, 179)"
26997,2020-03-23,Taiwan,0,12,165,"rgb(179, 179, 179)"
26998,2020-03-24,Taiwan,0,30,195,"rgb(179, 179, 179)"
26999,2020-03-25,Taiwan,0,21,216,"rgb(179, 179, 179)"
27000,2020-03-26,Taiwan,0,19,235,"rgb(179, 179, 179)"
27001,2020-03-27,Taiwan,0,17,252,"rgb(179, 179, 179)"
27002,2020-03-28,Taiwan,0,15,267,"rgb(179, 179, 179)"
27003,2020-03-29,Taiwan,0,16,283,"rgb(179, 179, 179)"
27004,2020-03-30,Taiwan,3,23,306,"rgb(179, 179, 179)"
27005,2020-03-31,Taiwan,0,0,306,"rgb(179, 179, 179)"
27006,2020-04-01,Taiwan,0,16,322,"rgb(179, 179, 179)"
27007,2020-04-02,Taiwan,0,17,339,"rgb(179, 179, 179)"
27008,2020-04-03,Taiwan,0,0,339,"rgb(179, 179, 179)"
27009,2020-04-04,Taiwan,0,16,355,"rgb(179, 179, 179)"
27010,2020-04-05,Taiwan,0,8,363,"rgb(179, 179, 179)"
27011,2020-04-06,Taiwan,0,0,363,"rgb(179, 179, 179)"
27012,2020-04-07,Taiwan,0,10,373,"rgb(179, 179, 179)"
27013,2020-04-08,Taiwan,0,3,376,"rgb(179, 179, 179)"
27014,2020-04-09,Taiwan,0,3,379,"rgb(179, 179, 179)"
27015,2020-04-10,Taiwan,0,1,380,"rgb(179, 179, 179)"
27016,2020-04-11,Taiwan,0,0,380,"rgb(179, 179, 179)"
27017,2020-04-12,Taiwan,1,5,385,"rgb(179, 179, 179)"
27018,2020-04-13,Taiwan,0,3,388,"rgb(179, 179, 179)"
27019,2020-04-14,Taiwan,0,5,393,"rgb(179, 179, 179)"
27020,2020-04-15,Taiwan,0,2,395,"rgb(179, 179, 179)"
27021,2020-04-16,Taiwan,0,0,395,"rgb(179, 179, 179)"
27022,2020-04-17,Taiwan,0,0,395,"rgb(179, 179, 179)"
27023,2020-04-18,Taiwan,0,0,395,"rgb(179, 179, 179)"
27024,2020-04-19,Taiwan,0,3,398,"rgb(179, 179, 179)"
27025,2020-04-20,Taiwan,0,22,420,"rgb(179, 179, 179)"
27026,2020-04-21,Taiwan,0,2,422,"rgb(179, 179, 179)"
27027,2020-04-22,Taiwan,0,3,425,"rgb(179, 179, 179)"
27028,2020-04-23,Taiwan,0,1,426,"rgb(179, 179, 179)"
27029,2020-04-24,Taiwan,0,1,427,"rgb(179, 179, 179)"
27030,2020-04-25,Taiwan,0,1,428,"rgb(179, 179, 179)"
27031,2020-04-26,Taiwan,0,1,429,"rgb(179, 179, 179)"
27032,2020-04-27,Taiwan,0,0,429,"rgb(179, 179, 179)"
27033,2020-04-28,Taiwan,0,0,429,"rgb(179, 179, 179)"
27034,2020-04-29,Taiwan,0,0,429,"rgb(179, 179, 179)"
27035,2020-04-30,Taiwan,0,0,429,"rgb(179, 179, 179)"
27036,2020-05-01,Taiwan,0,0,429,"rgb(179, 179, 179)"
27037,2020-05-02,Taiwan,0,0,429,"rgb(179, 179, 179)"
27038,2020-05-03,Taiwan,0,3,432,"rgb(179, 179, 179)"
27039,2020-05-04,Taiwan,0,4,436,"rgb(179, 179, 179)"
27040,2020-05-05,Taiwan,0,2,438,"rgb(179, 179, 179)"
27041,2020-05-06,Taiwan,0,0,438,"rgb(179, 179, 179)"
27042,2020-05-07,Taiwan,0,1,439,"rgb(179, 179, 179)"
27043,2020-05-08,Taiwan,0,1,440,"rgb(179, 179, 179)"
27044,2020-05-09,Taiwan,0,0,440,"rgb(179, 179, 179)"
27045,2020-05-10,Taiwan,0,0,440,"rgb(179, 179, 179)"
27046,2020-05-11,Taiwan,0,0,440,"rgb(179, 179, 179)"
27047,2020-05-12,Taiwan,1,0,440,"rgb(179, 179, 179)"
27048,2020-05-13,Taiwan,0,0,440,"rgb(179, 179, 179)"
27049,2020-05-14,Taiwan,0,0,440,"rgb(179, 179, 179)"
27050,2020-05-15,Taiwan,0,0,440,"rgb(179, 179, 179)"
27051,2020-05-16,Taiwan,0,0,440,"rgb(179, 179, 179)"
27052,2020-05-17,Taiwan,0,0,440,"rgb(179, 179, 179)"
27053,2020-05-18,Taiwan,0,0,440,"rgb(179, 179, 179)"
27054,2020-05-19,Taiwan,0,0,440,"rgb(179, 179, 179)"
27055,2020-05-20,Taiwan,0,0,440,"rgb(179, 179, 179)"
27056,2020-05-21,Taiwan,0,1,441,"rgb(179, 179, 179)"
27057,2020-05-22,Taiwan,0,0,441,"rgb(179, 179, 179)"
27058,2020-05-23,Taiwan,0,0,441,"rgb(179, 179, 179)"
27059,2020-05-24,Taiwan,0,0,441,"rgb(179, 179, 179)"
27060,2020-05-25,Taiwan,0,0,441,"rgb(179, 179, 179)"
27061,2020-05-26,Taiwan,0,0,441,"rgb(179, 179, 179)"
27062,2020-05-27,Taiwan,0,0,441,"rgb(179, 179, 179)"
27063,2020-05-28,Taiwan,0,0,441,"rgb(179, 179, 179)"
27064,2020-05-29,Taiwan,0,0,441,"rgb(179, 179, 179)"
27065,2020-05-30,Taiwan,0,1,442,"rgb(179, 179, 179)"
27066,2020-05-31,Taiwan,0,0,442,"rgb(179, 179, 179)"
27067,2020-06-01,Taiwan,0,0,442,"rgb(179, 179, 179)"
27068,2020-06-02,Taiwan,0,1,443,"rgb(179, 179, 179)"
27069,2020-06-03,Taiwan,0,0,443,"rgb(179, 179, 179)"
27070,2020-06-04,Taiwan,0,0,443,"rgb(179, 179, 179)"
27071,2020-06-05,Taiwan,0,0,443,"rgb(179, 179, 179)"
27072,2020-06-06,Taiwan,0,0,443,"rgb(179, 179, 179)"
27073,2020-06-07,Taiwan,0,0,443,"rgb(179, 179, 179)"
27074,2020-06-08,Taiwan,0,0,443,"rgb(179, 179, 179)"
27075,2020-06-09,Taiwan,0,0,443,"rgb(179, 179, 179)"
27076,2020-06-10,Taiwan,0,0,443,"rgb(179, 179, 179)"
27077,2020-06-11,Taiwan,0,0,443,"rgb(179, 179, 179)"
27078,2020-06-12,Taiwan,0,0,443,"rgb(179, 179, 179)"
27079,2020-06-13,Taiwan,0,0,443,"rgb(179, 179, 179)"
27080,2020-06-14,Taiwan,0,0,443,"rgb(179, 179, 179)"
27081,2020-06-15,Taiwan,0,0,443,"rgb(179, 179, 179)"
27082,2020-06-16,Taiwan,0,2,445,"rgb(179, 179, 179)"
27083,2020-06-17,Taiwan,0,0,445,"rgb(179, 179, 179)"
27084,2020-06-18,Taiwan,0,0,445,"rgb(179, 179, 179)"
27085,2020-06-19,Taiwan,0,1,446,"rgb(179, 179, 179)"
27086,2020-06-20,Taiwan,0,0,446,"rgb(179, 179, 179)"
27087,2020-06-21,Taiwan,0,0,446,"rgb(179, 179, 179)"
27088,2020-06-22,Taiwan,0,0,446,"rgb(179, 179, 179)"
27089,2020-06-23,Taiwan,0,0,446,"rgb(179, 179, 179)"
27090,2020-06-24,Taiwan,0,0,446,"rgb(179, 179, 179)"
27091,2020-06-25,Taiwan,0,0,446,"rgb(179, 179, 179)"
27092,2020-06-26,Taiwan,0,1,447,"rgb(179, 179, 179)"
27093,2020-06-27,Taiwan,0,0,447,"rgb(179, 179, 179)"
27094,2020-06-28,Taiwan,0,0,447,"rgb(179, 179, 179)"
27095,2020-06-29,Taiwan,0,0,447,"rgb(179, 179, 179)"
27096,2020-06-30,Taiwan,0,0,447,"rgb(179, 179, 179)"
27097,2020-07-01,Taiwan,0,0,447,"rgb(179, 179, 179)"
27098,2020-07-02,Taiwan,0,1,448,"rgb(179, 179, 179)"
27099,2020-07-03,Taiwan,0,1,449,"rgb(179, 179, 179)"
27100,2020-07-04,Taiwan,0,0,449,"rgb(179, 179, 179)"
27101,2020-07-05,Taiwan,0,0,449,"rgb(179, 179, 179)"
27102,2020-07-06,Taiwan,0,0,449,"rgb(179, 179, 179)"
27103,2020-07-07,Taiwan,0,0,449,"rgb(179, 179, 179)"
27104,2020-07-08,Taiwan,0,0,449,"rgb(179, 179, 179)"
27105,2020-07-09,Taiwan,0,0,449,"rgb(179, 179, 179)"
27106,2020-07-10,Taiwan,0,2,451,"rgb(179, 179, 179)"
27107,2020-07-11,Taiwan,0,0,451,"rgb(179, 179, 179)"
27108,2020-07-12,Taiwan,0,0,451,"rgb(179, 179, 179)"
27109,2020-07-13,Taiwan,0,0,451,"rgb(179, 179, 179)"
27110,2020-03-17,Tanzania,0,1,1,"rgb(229, 134, 6)"
27111,2020-03-18,Tanzania,0,0,1,"rgb(229, 134, 6)"
27112,2020-03-19,Tanzania,0,2,3,"rgb(229, 134, 6)"
27113,2020-03-20,Tanzania,0,0,3,"rgb(229, 134, 6)"
27114,2020-03-21,Tanzania,0,0,3,"rgb(229, 134, 6)"
27115,2020-03-22,Tanzania,0,3,6,"rgb(229, 134, 6)"
27116,2020-03-23,Tanzania,0,6,12,"rgb(229, 134, 6)"
27117,2020-03-24,Tanzania,0,0,12,"rgb(229, 134, 6)"
27118,2020-03-25,Tanzania,0,0,12,"rgb(229, 134, 6)"
27119,2020-03-26,Tanzania,0,0,12,"rgb(229, 134, 6)"
27120,2020-03-27,Tanzania,0,1,13,"rgb(229, 134, 6)"
27121,2020-03-28,Tanzania,0,0,13,"rgb(229, 134, 6)"
27122,2020-03-29,Tanzania,1,0,13,"rgb(229, 134, 6)"
27123,2020-03-30,Tanzania,0,1,14,"rgb(229, 134, 6)"
27124,2020-03-31,Tanzania,0,5,19,"rgb(229, 134, 6)"
27125,2020-04-01,Tanzania,0,0,19,"rgb(229, 134, 6)"
27126,2020-04-02,Tanzania,0,1,20,"rgb(229, 134, 6)"
27127,2020-04-03,Tanzania,0,1,21,"rgb(229, 134, 6)"
27128,2020-04-04,Tanzania,0,0,21,"rgb(229, 134, 6)"
27129,2020-04-05,Tanzania,0,0,21,"rgb(229, 134, 6)"
27130,2020-04-06,Tanzania,0,1,22,"rgb(229, 134, 6)"
27131,2020-04-07,Tanzania,0,2,24,"rgb(229, 134, 6)"
27132,2020-04-08,Tanzania,0,0,24,"rgb(229, 134, 6)"
27133,2020-04-09,Tanzania,0,1,25,"rgb(229, 134, 6)"
27134,2020-04-10,Tanzania,0,0,25,"rgb(229, 134, 6)"
27135,2020-04-11,Tanzania,2,7,32,"rgb(229, 134, 6)"
27136,2020-04-12,Tanzania,0,0,32,"rgb(229, 134, 6)"
27137,2020-04-13,Tanzania,0,0,32,"rgb(229, 134, 6)"
27138,2020-04-14,Tanzania,0,14,46,"rgb(229, 134, 6)"
27139,2020-04-15,Tanzania,0,7,53,"rgb(229, 134, 6)"
27140,2020-04-16,Tanzania,1,35,88,"rgb(229, 134, 6)"
27141,2020-04-17,Tanzania,0,6,94,"rgb(229, 134, 6)"
27142,2020-04-18,Tanzania,1,53,147,"rgb(229, 134, 6)"
27143,2020-04-19,Tanzania,0,1,148,"rgb(229, 134, 6)"
27144,2020-04-20,Tanzania,0,22,170,"rgb(229, 134, 6)"
27145,2020-04-21,Tanzania,0,0,170,"rgb(229, 134, 6)"
27146,2020-04-22,Tanzania,3,84,254,"rgb(229, 134, 6)"
27147,2020-04-23,Tanzania,2,31,285,"rgb(229, 134, 6)"
27148,2020-04-24,Tanzania,0,0,285,"rgb(229, 134, 6)"
27149,2020-04-25,Tanzania,0,15,300,"rgb(229, 134, 6)"
27150,2020-04-26,Tanzania,0,0,300,"rgb(229, 134, 6)"
27151,2020-04-27,Tanzania,0,0,300,"rgb(229, 134, 6)"
27152,2020-04-28,Tanzania,0,0,300,"rgb(229, 134, 6)"
27153,2020-04-29,Tanzania,0,6,306,"rgb(229, 134, 6)"
27154,2020-04-30,Tanzania,6,174,480,"rgb(229, 134, 6)"
27155,2020-05-01,Tanzania,0,0,480,"rgb(229, 134, 6)"
27156,2020-05-02,Tanzania,0,0,480,"rgb(229, 134, 6)"
27157,2020-05-03,Tanzania,0,0,480,"rgb(229, 134, 6)"
27158,2020-05-04,Tanzania,0,0,480,"rgb(229, 134, 6)"
27159,2020-05-05,Tanzania,2,0,480,"rgb(229, 134, 6)"
27160,2020-05-06,Tanzania,0,0,480,"rgb(229, 134, 6)"
27161,2020-05-07,Tanzania,0,0,480,"rgb(229, 134, 6)"
27162,2020-05-08,Tanzania,3,29,509,"rgb(229, 134, 6)"
27163,2020-05-09,Tanzania,0,0,509,"rgb(229, 134, 6)"
27164,2020-05-10,Tanzania,0,0,509,"rgb(229, 134, 6)"
27165,2020-05-11,Tanzania,0,0,509,"rgb(229, 134, 6)"
27166,2020-05-12,Tanzania,0,0,509,"rgb(229, 134, 6)"
27167,2020-05-13,Tanzania,0,0,509,"rgb(229, 134, 6)"
27168,2020-05-14,Tanzania,0,0,509,"rgb(229, 134, 6)"
27169,2020-05-15,Tanzania,0,0,509,"rgb(229, 134, 6)"
27170,2020-05-16,Tanzania,0,0,509,"rgb(229, 134, 6)"
27171,2020-05-17,Tanzania,0,0,509,"rgb(229, 134, 6)"
27172,2020-05-18,Tanzania,0,0,509,"rgb(229, 134, 6)"
27173,2020-05-19,Tanzania,0,0,509,"rgb(229, 134, 6)"
27174,2020-05-20,Tanzania,0,0,509,"rgb(229, 134, 6)"
27175,2020-05-21,Tanzania,0,0,509,"rgb(229, 134, 6)"
27176,2020-05-22,Tanzania,0,0,509,"rgb(229, 134, 6)"
27177,2020-05-23,Tanzania,0,0,509,"rgb(229, 134, 6)"
27178,2020-05-24,Tanzania,0,0,509,"rgb(229, 134, 6)"
27179,2020-05-25,Tanzania,0,0,509,"rgb(229, 134, 6)"
27180,2020-05-26,Tanzania,0,0,509,"rgb(229, 134, 6)"
27181,2020-05-27,Tanzania,0,0,509,"rgb(229, 134, 6)"
27182,2020-05-28,Tanzania,0,0,509,"rgb(229, 134, 6)"
27183,2020-05-29,Tanzania,0,0,509,"rgb(229, 134, 6)"
27184,2020-05-30,Tanzania,0,0,509,"rgb(229, 134, 6)"
27185,2020-05-31,Tanzania,0,0,509,"rgb(229, 134, 6)"
27186,2020-06-01,Tanzania,0,0,509,"rgb(229, 134, 6)"
27187,2020-06-02,Tanzania,0,0,509,"rgb(229, 134, 6)"
27188,2020-06-03,Tanzania,0,0,509,"rgb(229, 134, 6)"
27189,2020-06-04,Tanzania,0,0,509,"rgb(229, 134, 6)"
27190,2020-06-05,Tanzania,0,0,509,"rgb(229, 134, 6)"
27191,2020-06-06,Tanzania,0,0,509,"rgb(229, 134, 6)"
27192,2020-06-07,Tanzania,0,0,509,"rgb(229, 134, 6)"
27193,2020-06-08,Tanzania,0,0,509,"rgb(229, 134, 6)"
27194,2020-06-09,Tanzania,0,0,509,"rgb(229, 134, 6)"
27195,2020-06-10,Tanzania,0,0,509,"rgb(229, 134, 6)"
27196,2020-06-11,Tanzania,0,0,509,"rgb(229, 134, 6)"
27197,2020-06-12,Tanzania,0,0,509,"rgb(229, 134, 6)"
27198,2020-06-13,Tanzania,0,0,509,"rgb(229, 134, 6)"
27199,2020-06-14,Tanzania,0,0,509,"rgb(229, 134, 6)"
27200,2020-06-15,Tanzania,0,0,509,"rgb(229, 134, 6)"
27201,2020-06-16,Tanzania,0,0,509,"rgb(229, 134, 6)"
27202,2020-06-17,Tanzania,0,0,509,"rgb(229, 134, 6)"
27203,2020-06-18,Tanzania,0,0,509,"rgb(229, 134, 6)"
27204,2020-06-19,Tanzania,0,0,509,"rgb(229, 134, 6)"
27205,2020-06-20,Tanzania,0,0,509,"rgb(229, 134, 6)"
27206,2020-06-21,Tanzania,0,0,509,"rgb(229, 134, 6)"
27207,2020-06-22,Tanzania,0,0,509,"rgb(229, 134, 6)"
27208,2020-06-23,Tanzania,0,0,509,"rgb(229, 134, 6)"
27209,2020-06-24,Tanzania,0,0,509,"rgb(229, 134, 6)"
27210,2020-06-25,Tanzania,0,0,509,"rgb(229, 134, 6)"
27211,2020-06-26,Tanzania,0,0,509,"rgb(229, 134, 6)"
27212,2020-06-27,Tanzania,0,0,509,"rgb(229, 134, 6)"
27213,2020-06-28,Tanzania,0,0,509,"rgb(229, 134, 6)"
27214,2020-06-29,Tanzania,0,0,509,"rgb(229, 134, 6)"
27215,2020-06-30,Tanzania,0,0,509,"rgb(229, 134, 6)"
27216,2020-07-01,Tanzania,0,0,509,"rgb(229, 134, 6)"
27217,2020-07-02,Tanzania,0,0,509,"rgb(229, 134, 6)"
27218,2020-07-03,Tanzania,0,0,509,"rgb(229, 134, 6)"
27219,2020-07-04,Tanzania,0,0,509,"rgb(229, 134, 6)"
27220,2020-07-05,Tanzania,0,0,509,"rgb(229, 134, 6)"
27221,2020-07-06,Tanzania,0,0,509,"rgb(229, 134, 6)"
27222,2020-07-07,Tanzania,0,0,509,"rgb(229, 134, 6)"
27223,2020-07-08,Tanzania,0,0,509,"rgb(229, 134, 6)"
27224,2020-07-09,Tanzania,0,0,509,"rgb(229, 134, 6)"
27225,2020-07-10,Tanzania,0,0,509,"rgb(229, 134, 6)"
27226,2020-07-11,Tanzania,0,0,509,"rgb(229, 134, 6)"
27227,2020-07-12,Tanzania,0,0,509,"rgb(229, 134, 6)"
27228,2020-07-13,Tanzania,0,0,509,"rgb(229, 134, 6)"
27229,2020-03-04,Ukraine,0,1,1,"rgb(93, 105, 177)"
27230,2020-03-13,Ukraine,0,2,3,"rgb(93, 105, 177)"
27231,2020-03-16,Ukraine,0,0,3,"rgb(93, 105, 177)"
27232,2020-03-17,Ukraine,0,2,5,"rgb(93, 105, 177)"
27233,2020-03-18,Ukraine,0,9,14,"rgb(93, 105, 177)"
27234,2020-03-19,Ukraine,2,5,19,"rgb(93, 105, 177)"
27235,2020-03-20,Ukraine,0,7,26,"rgb(93, 105, 177)"
27236,2020-03-21,Ukraine,1,0,26,"rgb(93, 105, 177)"
27237,2020-03-22,Ukraine,0,15,41,"rgb(93, 105, 177)"
27238,2020-03-23,Ukraine,0,6,47,"rgb(93, 105, 177)"
27239,2020-03-24,Ukraine,0,26,73,"rgb(93, 105, 177)"
27240,2020-03-25,Ukraine,0,11,84,"rgb(93, 105, 177)"
27241,2020-03-26,Ukraine,1,29,113,"rgb(93, 105, 177)"
27242,2020-03-27,Ukraine,1,43,156,"rgb(93, 105, 177)"
27243,2020-03-28,Ukraine,0,62,218,"rgb(93, 105, 177)"
27244,2020-03-29,Ukraine,3,93,311,"rgb(93, 105, 177)"
27245,2020-03-30,Ukraine,1,107,418,"rgb(93, 105, 177)"
27246,2020-03-31,Ukraine,2,62,480,"rgb(93, 105, 177)"
27247,2020-04-01,Ukraine,2,69,549,"rgb(93, 105, 177)"
27248,2020-04-02,Ukraine,7,245,794,"rgb(93, 105, 177)"
27249,2020-04-03,Ukraine,0,10,804,"rgb(93, 105, 177)"
27250,2020-04-04,Ukraine,3,183,987,"rgb(93, 105, 177)"
27251,2020-04-05,Ukraine,5,109,1096,"rgb(93, 105, 177)"
27252,2020-04-06,Ukraine,4,155,1251,"rgb(93, 105, 177)"
27253,2020-04-07,Ukraine,6,68,1319,"rgb(93, 105, 177)"
27254,2020-04-08,Ukraine,7,143,1462,"rgb(93, 105, 177)"
27255,2020-04-09,Ukraine,7,206,1668,"rgb(93, 105, 177)"
27256,2020-04-10,Ukraine,5,224,1892,"rgb(93, 105, 177)"
27257,2020-04-11,Ukraine,12,311,2203,"rgb(93, 105, 177)"
27258,2020-04-12,Ukraine,4,308,2511,"rgb(93, 105, 177)"
27259,2020-04-13,Ukraine,10,266,2777,"rgb(93, 105, 177)"
27260,2020-04-14,Ukraine,10,325,3102,"rgb(93, 105, 177)"
27261,2020-04-15,Ukraine,5,270,3372,"rgb(93, 105, 177)"
27262,2020-04-16,Ukraine,18,789,4161,"rgb(93, 105, 177)"
27263,2020-04-17,Ukraine,9,301,4462,"rgb(93, 105, 177)"
27264,2020-04-18,Ukraine,8,644,5106,"rgb(93, 105, 177)"
27265,2020-04-19,Ukraine,8,343,5449,"rgb(93, 105, 177)"
27266,2020-04-20,Ukraine,10,261,5710,"rgb(93, 105, 177)"
27267,2020-04-21,Ukraine,10,415,6125,"rgb(93, 105, 177)"
27268,2020-04-22,Ukraine,13,467,6592,"rgb(93, 105, 177)"
27269,2020-04-23,Ukraine,13,578,7170,"rgb(93, 105, 177)"
27270,2020-04-24,Ukraine,6,477,7647,"rgb(93, 105, 177)"
27271,2020-04-25,Ukraine,8,478,8125,"rgb(93, 105, 177)"
27272,2020-04-26,Ukraine,8,492,8617,"rgb(93, 105, 177)"
27273,2020-04-27,Ukraine,11,392,9009,"rgb(93, 105, 177)"
27274,2020-04-28,Ukraine,0,0,9009,"rgb(93, 105, 177)"
27275,2020-04-29,Ukraine,19,401,9410,"rgb(93, 105, 177)"
27276,2020-04-30,Ukraine,11,456,9866,"rgb(93, 105, 177)"
27277,2020-05-01,Ukraine,0,540,10406,"rgb(93, 105, 177)"
27278,2020-05-02,Ukraine,29,455,10861,"rgb(93, 105, 177)"
27279,2020-05-03,Ukraine,0,550,11411,"rgb(93, 105, 177)"
27280,2020-05-04,Ukraine,9,502,11913,"rgb(93, 105, 177)"
27281,2020-05-05,Ukraine,15,418,12331,"rgb(93, 105, 177)"
27282,2020-05-06,Ukraine,13,366,12697,"rgb(93, 105, 177)"
27283,2020-05-07,Ukraine,11,487,13184,"rgb(93, 105, 177)"
27284,2020-05-08,Ukraine,13,507,13691,"rgb(93, 105, 177)"
27285,2020-05-09,Ukraine,21,504,14195,"rgb(93, 105, 177)"
27286,2020-05-10,Ukraine,15,515,14710,"rgb(93, 105, 177)"
27287,2020-05-11,Ukraine,15,522,15232,"rgb(93, 105, 177)"
27288,2020-05-12,Ukraine,17,416,15648,"rgb(93, 105, 177)"
27289,2020-05-13,Ukraine,17,375,16023,"rgb(93, 105, 177)"
27290,2020-05-14,Ukraine,14,402,16425,"rgb(93, 105, 177)"
27291,2020-05-15,Ukraine,17,422,16847,"rgb(93, 105, 177)"
27292,2020-05-16,Ukraine,27,483,17330,"rgb(93, 105, 177)"
27293,2020-05-17,Ukraine,14,528,17858,"rgb(93, 105, 177)"
27294,2020-05-18,Ukraine,17,433,18291,"rgb(93, 105, 177)"
27295,2020-05-19,Ukraine,21,325,18616,"rgb(93, 105, 177)"
27296,2020-05-20,Ukraine,13,260,18876,"rgb(93, 105, 177)"
27297,2020-05-21,Ukraine,16,354,19230,"rgb(93, 105, 177)"
27298,2020-05-22,Ukraine,15,476,19706,"rgb(93, 105, 177)"
27299,2020-05-23,Ukraine,9,442,20148,"rgb(93, 105, 177)"
27300,2020-05-24,Ukraine,17,432,20580,"rgb(93, 105, 177)"
27301,2020-05-25,Ukraine,12,406,20986,"rgb(93, 105, 177)"
27302,2020-05-26,Ukraine,6,259,21245,"rgb(93, 105, 177)"
27303,2020-05-27,Ukraine,21,339,21584,"rgb(93, 105, 177)"
27304,2020-05-28,Ukraine,0,0,21584,"rgb(93, 105, 177)"
27305,2020-05-29,Ukraine,25,798,22382,"rgb(93, 105, 177)"
27306,2020-05-30,Ukraine,27,822,23204,"rgb(93, 105, 177)"
27307,2020-05-31,Ukraine,0,0,23204,"rgb(93, 105, 177)"
27308,2020-06-01,Ukraine,12,468,23672,"rgb(93, 105, 177)"
27309,2020-06-02,Ukraine,19,668,24340,"rgb(93, 105, 177)"
27310,2020-06-03,Ukraine,8,483,24823,"rgb(93, 105, 177)"
27311,2020-06-04,Ukraine,12,588,25411,"rgb(93, 105, 177)"
27312,2020-06-05,Ukraine,15,553,25964,"rgb(93, 105, 177)"
27313,2020-06-06,Ukraine,15,550,26514,"rgb(93, 105, 177)"
27314,2020-06-07,Ukraine,0,0,26514,"rgb(93, 105, 177)"
27315,2020-06-08,Ukraine,11,485,26999,"rgb(93, 105, 177)"
27316,2020-06-09,Ukraine,9,463,27462,"rgb(93, 105, 177)"
27317,2020-06-10,Ukraine,13,394,27856,"rgb(93, 105, 177)"
27318,2020-06-11,Ukraine,23,525,28381,"rgb(93, 105, 177)"
27319,2020-06-12,Ukraine,21,689,29070,"rgb(93, 105, 177)"
27320,2020-06-13,Ukraine,16,683,29753,"rgb(93, 105, 177)"
27321,2020-06-14,Ukraine,10,753,30506,"rgb(93, 105, 177)"
27322,2020-06-15,Ukraine,9,648,31154,"rgb(93, 105, 177)"
27323,2020-06-16,Ukraine,12,656,31810,"rgb(93, 105, 177)"
27324,2020-06-17,Ukraine,11,666,32476,"rgb(93, 105, 177)"
27325,2020-06-18,Ukraine,31,758,33234,"rgb(93, 105, 177)"
27326,2020-06-19,Ukraine,23,829,34063,"rgb(93, 105, 177)"
27327,2020-06-20,Ukraine,19,921,34984,"rgb(93, 105, 177)"
27328,2020-06-21,Ukraine,9,841,35825,"rgb(93, 105, 177)"
27329,2020-06-22,Ukraine,8,735,36560,"rgb(93, 105, 177)"
27330,2020-06-23,Ukraine,10,681,37241,"rgb(93, 105, 177)"
27331,2020-06-24,Ukraine,39,1773,39014,"rgb(93, 105, 177)"
27332,2020-06-25,Ukraine,0,0,39014,"rgb(93, 105, 177)"
27333,2020-06-26,Ukraine,16,994,40008,"rgb(93, 105, 177)"
27334,2020-06-27,Ukraine,19,1109,41117,"rgb(93, 105, 177)"
27335,2020-06-28,Ukraine,24,948,42065,"rgb(93, 105, 177)"
27336,2020-06-29,Ukraine,19,917,42982,"rgb(93, 105, 177)"
27337,2020-06-30,Ukraine,18,646,43628,"rgb(93, 105, 177)"
27338,2020-07-01,Ukraine,26,1370,44998,"rgb(93, 105, 177)"
27339,2020-07-02,Ukraine,0,0,44998,"rgb(93, 105, 177)"
27340,2020-07-03,Ukraine,12,889,45887,"rgb(93, 105, 177)"
27341,2020-07-04,Ukraine,42,1790,47677,"rgb(93, 105, 177)"
27342,2020-07-05,Ukraine,0,0,47677,"rgb(93, 105, 177)"
27343,2020-07-06,Ukraine,35,1366,49043,"rgb(93, 105, 177)"
27344,2020-07-07,Ukraine,21,564,49607,"rgb(93, 105, 177)"
27345,2020-07-08,Ukraine,23,807,50414,"rgb(93, 105, 177)"
27346,2020-07-09,Ukraine,21,810,51224,"rgb(93, 105, 177)"
27347,2020-07-10,Ukraine,18,819,52043,"rgb(93, 105, 177)"
27348,2020-07-11,Ukraine,0,0,52043,"rgb(93, 105, 177)"
27349,2020-07-12,Ukraine,27,800,52843,"rgb(93, 105, 177)"
27350,2020-07-13,Ukraine,26,1290,54133,"rgb(93, 105, 177)"
27351,2020-03-22,Uganda,0,1,1,"rgb(82, 188, 163)"
27352,2020-03-23,Uganda,0,0,1,"rgb(82, 188, 163)"
27353,2020-03-24,Uganda,0,8,9,"rgb(82, 188, 163)"
27354,2020-03-25,Uganda,0,0,9,"rgb(82, 188, 163)"
27355,2020-03-26,Uganda,0,5,14,"rgb(82, 188, 163)"
27356,2020-03-27,Uganda,0,0,14,"rgb(82, 188, 163)"
27357,2020-03-28,Uganda,0,0,14,"rgb(82, 188, 163)"
27358,2020-03-29,Uganda,0,16,30,"rgb(82, 188, 163)"
27359,2020-03-30,Uganda,0,3,33,"rgb(82, 188, 163)"
27360,2020-03-31,Uganda,0,0,33,"rgb(82, 188, 163)"
27361,2020-04-01,Uganda,0,11,44,"rgb(82, 188, 163)"
27362,2020-04-02,Uganda,0,0,44,"rgb(82, 188, 163)"
27363,2020-04-03,Uganda,0,1,45,"rgb(82, 188, 163)"
27364,2020-04-04,Uganda,0,3,48,"rgb(82, 188, 163)"
27365,2020-04-05,Uganda,0,0,48,"rgb(82, 188, 163)"
27366,2020-04-06,Uganda,0,4,52,"rgb(82, 188, 163)"
27367,2020-04-07,Uganda,0,0,52,"rgb(82, 188, 163)"
27368,2020-04-08,Uganda,0,0,52,"rgb(82, 188, 163)"
27369,2020-04-09,Uganda,0,1,53,"rgb(82, 188, 163)"
27370,2020-04-10,Uganda,0,0,53,"rgb(82, 188, 163)"
27371,2020-04-11,Uganda,0,0,53,"rgb(82, 188, 163)"
27372,2020-04-12,Uganda,0,0,53,"rgb(82, 188, 163)"
27373,2020-04-13,Uganda,0,1,54,"rgb(82, 188, 163)"
27374,2020-04-14,Uganda,0,0,54,"rgb(82, 188, 163)"
27375,2020-04-15,Uganda,0,1,55,"rgb(82, 188, 163)"
27376,2020-04-16,Uganda,0,0,55,"rgb(82, 188, 163)"
27377,2020-04-17,Uganda,0,0,55,"rgb(82, 188, 163)"
27378,2020-04-18,Uganda,0,0,55,"rgb(82, 188, 163)"
27379,2020-04-19,Uganda,0,0,55,"rgb(82, 188, 163)"
27380,2020-04-20,Uganda,0,0,55,"rgb(82, 188, 163)"
27381,2020-04-21,Uganda,0,1,56,"rgb(82, 188, 163)"
27382,2020-04-22,Uganda,0,2,58,"rgb(82, 188, 163)"
27383,2020-04-23,Uganda,0,3,61,"rgb(82, 188, 163)"
27384,2020-04-24,Uganda,0,13,74,"rgb(82, 188, 163)"
27385,2020-04-25,Uganda,0,1,75,"rgb(82, 188, 163)"
27386,2020-04-26,Uganda,0,0,75,"rgb(82, 188, 163)"
27387,2020-04-27,Uganda,0,4,79,"rgb(82, 188, 163)"
27388,2020-04-28,Uganda,0,0,79,"rgb(82, 188, 163)"
27389,2020-04-29,Uganda,0,0,79,"rgb(82, 188, 163)"
27390,2020-04-30,Uganda,0,2,81,"rgb(82, 188, 163)"
27391,2020-05-01,Uganda,0,2,83,"rgb(82, 188, 163)"
27392,2020-05-02,Uganda,0,2,85,"rgb(82, 188, 163)"
27393,2020-05-03,Uganda,0,3,88,"rgb(82, 188, 163)"
27394,2020-05-04,Uganda,0,1,89,"rgb(82, 188, 163)"
27395,2020-05-05,Uganda,0,8,97,"rgb(82, 188, 163)"
27396,2020-05-06,Uganda,0,1,98,"rgb(82, 188, 163)"
27397,2020-05-07,Uganda,0,0,98,"rgb(82, 188, 163)"
27398,2020-05-08,Uganda,0,3,101,"rgb(82, 188, 163)"
27399,2020-05-09,Uganda,0,0,101,"rgb(82, 188, 163)"
27400,2020-05-10,Uganda,0,15,116,"rgb(82, 188, 163)"
27401,2020-05-11,Uganda,0,5,121,"rgb(82, 188, 163)"
27402,2020-05-12,Uganda,0,1,122,"rgb(82, 188, 163)"
27403,2020-05-13,Uganda,0,4,126,"rgb(82, 188, 163)"
27404,2020-05-14,Uganda,0,13,139,"rgb(82, 188, 163)"
27405,2020-05-15,Uganda,0,21,160,"rgb(82, 188, 163)"
27406,2020-05-16,Uganda,0,43,203,"rgb(82, 188, 163)"
27407,2020-05-17,Uganda,0,24,227,"rgb(82, 188, 163)"
27408,2020-05-18,Uganda,0,0,227,"rgb(82, 188, 163)"
27409,2020-05-19,Uganda,0,33,260,"rgb(82, 188, 163)"
27410,2020-05-20,Uganda,0,0,260,"rgb(82, 188, 163)"
27411,2020-05-21,Uganda,0,-115,145,"rgb(82, 188, 163)"
27412,2020-05-22,Uganda,0,15,160,"rgb(82, 188, 163)"
27413,2020-05-23,Uganda,0,15,175,"rgb(82, 188, 163)"
27414,2020-05-24,Uganda,0,23,198,"rgb(82, 188, 163)"
27415,2020-05-25,Uganda,0,14,212,"rgb(82, 188, 163)"
27416,2020-05-26,Uganda,0,10,222,"rgb(82, 188, 163)"
27417,2020-05-27,Uganda,0,31,253,"rgb(82, 188, 163)"
27418,2020-05-28,Uganda,0,28,281,"rgb(82, 188, 163)"
27419,2020-05-29,Uganda,0,36,317,"rgb(82, 188, 163)"
27420,2020-05-30,Uganda,0,12,329,"rgb(82, 188, 163)"
27421,2020-05-31,Uganda,0,84,413,"rgb(82, 188, 163)"
27422,2020-06-01,Uganda,0,45,458,"rgb(82, 188, 163)"
27423,2020-06-02,Uganda,0,-1,457,"rgb(82, 188, 163)"
27424,2020-06-03,Uganda,0,32,489,"rgb(82, 188, 163)"
27425,2020-06-04,Uganda,0,18,507,"rgb(82, 188, 163)"
27426,2020-06-05,Uganda,0,15,522,"rgb(82, 188, 163)"
27427,2020-06-06,Uganda,0,35,557,"rgb(82, 188, 163)"
27428,2020-06-07,Uganda,0,36,593,"rgb(82, 188, 163)"
27429,2020-06-08,Uganda,0,23,616,"rgb(82, 188, 163)"
27430,2020-06-09,Uganda,0,30,646,"rgb(82, 188, 163)"
27431,2020-06-10,Uganda,0,11,657,"rgb(82, 188, 163)"
27432,2020-06-11,Uganda,0,8,665,"rgb(82, 188, 163)"
27433,2020-06-12,Uganda,0,14,679,"rgb(82, 188, 163)"
27434,2020-06-13,Uganda,0,6,685,"rgb(82, 188, 163)"
27435,2020-06-14,Uganda,0,0,685,"rgb(82, 188, 163)"
27436,2020-06-15,Uganda,0,11,696,"rgb(82, 188, 163)"
27437,2020-06-16,Uganda,0,9,705,"rgb(82, 188, 163)"
27438,2020-06-17,Uganda,0,19,724,"rgb(82, 188, 163)"
27439,2020-06-18,Uganda,0,8,732,"rgb(82, 188, 163)"
27440,2020-06-19,Uganda,0,9,741,"rgb(82, 188, 163)"
27441,2020-06-20,Uganda,0,14,755,"rgb(82, 188, 163)"
27442,2020-06-21,Uganda,0,0,755,"rgb(82, 188, 163)"
27443,2020-06-22,Uganda,0,15,770,"rgb(82, 188, 163)"
27444,2020-06-23,Uganda,0,4,774,"rgb(82, 188, 163)"
27445,2020-06-24,Uganda,0,23,797,"rgb(82, 188, 163)"
27446,2020-06-25,Uganda,0,8,805,"rgb(82, 188, 163)"
27447,2020-06-26,Uganda,0,16,821,"rgb(82, 188, 163)"
27448,2020-06-27,Uganda,0,12,833,"rgb(82, 188, 163)"
27449,2020-06-28,Uganda,0,15,848,"rgb(82, 188, 163)"
27450,2020-06-29,Uganda,0,11,859,"rgb(82, 188, 163)"
27451,2020-06-30,Uganda,0,11,870,"rgb(82, 188, 163)"
27452,2020-07-01,Uganda,0,19,889,"rgb(82, 188, 163)"
27453,2020-07-02,Uganda,0,4,893,"rgb(82, 188, 163)"
27454,2020-07-03,Uganda,0,9,902,"rgb(82, 188, 163)"
27455,2020-07-04,Uganda,0,9,911,"rgb(82, 188, 163)"
27456,2020-07-05,Uganda,0,16,927,"rgb(82, 188, 163)"
27457,2020-07-06,Uganda,0,12,939,"rgb(82, 188, 163)"
27458,2020-07-07,Uganda,0,14,953,"rgb(82, 188, 163)"
27459,2020-07-08,Uganda,0,18,971,"rgb(82, 188, 163)"
27460,2020-07-09,Uganda,0,6,977,"rgb(82, 188, 163)"
27461,2020-07-10,Uganda,0,23,1000,"rgb(82, 188, 163)"
27462,2020-07-11,Uganda,0,6,1006,"rgb(82, 188, 163)"
27463,2020-07-12,Uganda,0,7,1013,"rgb(82, 188, 163)"
27464,2020-07-13,Uganda,0,12,1025,"rgb(82, 188, 163)"
27465,2019-12-31,United Kingdom,0,0,0,"rgb(153, 201, 69)"
27466,2020-01-01,United Kingdom,0,0,0,"rgb(153, 201, 69)"
27467,2020-01-02,United Kingdom,0,0,0,"rgb(153, 201, 69)"
27468,2020-01-03,United Kingdom,0,0,0,"rgb(153, 201, 69)"
27469,2020-01-04,United Kingdom,0,0,0,"rgb(153, 201, 69)"
27470,2020-01-05,United Kingdom,0,0,0,"rgb(153, 201, 69)"
27471,2020-01-06,United Kingdom,0,0,0,"rgb(153, 201, 69)"
27472,2020-01-07,United Kingdom,0,0,0,"rgb(153, 201, 69)"
27473,2020-01-08,United Kingdom,0,0,0,"rgb(153, 201, 69)"
27474,2020-01-09,United Kingdom,0,0,0,"rgb(153, 201, 69)"
27475,2020-01-10,United Kingdom,0,0,0,"rgb(153, 201, 69)"
27476,2020-01-11,United Kingdom,0,0,0,"rgb(153, 201, 69)"
27477,2020-01-12,United Kingdom,0,0,0,"rgb(153, 201, 69)"
27478,2020-01-13,United Kingdom,0,0,0,"rgb(153, 201, 69)"
27479,2020-01-14,United Kingdom,0,0,0,"rgb(153, 201, 69)"
27480,2020-01-15,United Kingdom,0,0,0,"rgb(153, 201, 69)"
27481,2020-01-16,United Kingdom,0,0,0,"rgb(153, 201, 69)"
27482,2020-01-17,United Kingdom,0,0,0,"rgb(153, 201, 69)"
27483,2020-01-18,United Kingdom,0,0,0,"rgb(153, 201, 69)"
27484,2020-01-19,United Kingdom,0,0,0,"rgb(153, 201, 69)"
27485,2020-01-20,United Kingdom,0,0,0,"rgb(153, 201, 69)"
27486,2020-01-21,United Kingdom,0,0,0,"rgb(153, 201, 69)"
27487,2020-01-22,United Kingdom,0,0,0,"rgb(153, 201, 69)"
27488,2020-01-23,United Kingdom,0,0,0,"rgb(153, 201, 69)"
27489,2020-01-24,United Kingdom,0,0,0,"rgb(153, 201, 69)"
27490,2020-01-25,United Kingdom,0,0,0,"rgb(153, 201, 69)"
27491,2020-01-26,United Kingdom,0,0,0,"rgb(153, 201, 69)"
27492,2020-01-27,United Kingdom,0,0,0,"rgb(153, 201, 69)"
27493,2020-01-28,United Kingdom,0,0,0,"rgb(153, 201, 69)"
27494,2020-01-29,United Kingdom,0,0,0,"rgb(153, 201, 69)"
27495,2020-01-30,United Kingdom,0,0,0,"rgb(153, 201, 69)"
27496,2020-01-31,United Kingdom,0,2,2,"rgb(153, 201, 69)"
27497,2020-02-01,United Kingdom,0,0,2,"rgb(153, 201, 69)"
27498,2020-02-02,United Kingdom,0,0,2,"rgb(153, 201, 69)"
27499,2020-02-03,United Kingdom,0,0,2,"rgb(153, 201, 69)"
27500,2020-02-04,United Kingdom,0,0,2,"rgb(153, 201, 69)"
27501,2020-02-05,United Kingdom,0,0,2,"rgb(153, 201, 69)"
27502,2020-02-06,United Kingdom,0,0,2,"rgb(153, 201, 69)"
27503,2020-02-07,United Kingdom,0,1,3,"rgb(153, 201, 69)"
27504,2020-02-08,United Kingdom,0,0,3,"rgb(153, 201, 69)"
27505,2020-02-09,United Kingdom,0,1,4,"rgb(153, 201, 69)"
27506,2020-02-10,United Kingdom,0,0,4,"rgb(153, 201, 69)"
27507,2020-02-11,United Kingdom,0,4,8,"rgb(153, 201, 69)"
27508,2020-02-12,United Kingdom,0,0,8,"rgb(153, 201, 69)"
27509,2020-02-13,United Kingdom,0,1,9,"rgb(153, 201, 69)"
27510,2020-02-14,United Kingdom,0,0,9,"rgb(153, 201, 69)"
27511,2020-02-15,United Kingdom,0,0,9,"rgb(153, 201, 69)"
27512,2020-02-16,United Kingdom,0,0,9,"rgb(153, 201, 69)"
27513,2020-02-17,United Kingdom,0,0,9,"rgb(153, 201, 69)"
27514,2020-02-18,United Kingdom,0,0,9,"rgb(153, 201, 69)"
27515,2020-02-19,United Kingdom,0,0,9,"rgb(153, 201, 69)"
27516,2020-02-20,United Kingdom,0,0,9,"rgb(153, 201, 69)"
27517,2020-02-21,United Kingdom,0,0,9,"rgb(153, 201, 69)"
27518,2020-02-22,United Kingdom,0,0,9,"rgb(153, 201, 69)"
27519,2020-02-23,United Kingdom,0,0,9,"rgb(153, 201, 69)"
27520,2020-02-24,United Kingdom,0,4,13,"rgb(153, 201, 69)"
27521,2020-02-25,United Kingdom,0,0,13,"rgb(153, 201, 69)"
27522,2020-02-26,United Kingdom,0,0,13,"rgb(153, 201, 69)"
27523,2020-02-27,United Kingdom,0,0,13,"rgb(153, 201, 69)"
27524,2020-02-28,United Kingdom,0,3,16,"rgb(153, 201, 69)"
27525,2020-02-29,United Kingdom,0,2,18,"rgb(153, 201, 69)"
27526,2020-03-01,United Kingdom,0,5,23,"rgb(153, 201, 69)"
27527,2020-03-02,United Kingdom,0,13,36,"rgb(153, 201, 69)"
27528,2020-03-03,United Kingdom,0,4,40,"rgb(153, 201, 69)"
27529,2020-03-04,United Kingdom,0,11,51,"rgb(153, 201, 69)"
27530,2020-03-05,United Kingdom,0,34,85,"rgb(153, 201, 69)"
27531,2020-03-06,United Kingdom,0,30,115,"rgb(153, 201, 69)"
27532,2020-03-07,United Kingdom,1,48,163,"rgb(153, 201, 69)"
27533,2020-03-08,United Kingdom,1,43,206,"rgb(153, 201, 69)"
27534,2020-03-09,United Kingdom,0,67,273,"rgb(153, 201, 69)"
27535,2020-03-10,United Kingdom,1,48,321,"rgb(153, 201, 69)"
27536,2020-03-11,United Kingdom,4,52,373,"rgb(153, 201, 69)"
27537,2020-03-12,United Kingdom,0,83,456,"rgb(153, 201, 69)"
27538,2020-03-13,United Kingdom,2,134,590,"rgb(153, 201, 69)"
27539,2020-03-14,United Kingdom,1,117,707,"rgb(153, 201, 69)"
27540,2020-03-15,United Kingdom,18,433,1140,"rgb(153, 201, 69)"
27541,2020-03-16,United Kingdom,15,251,1391,"rgb(153, 201, 69)"
27542,2020-03-17,United Kingdom,22,152,1543,"rgb(153, 201, 69)"
27543,2020-03-18,United Kingdom,16,407,1950,"rgb(153, 201, 69)"
27544,2020-03-19,United Kingdom,34,680,2630,"rgb(153, 201, 69)"
27545,2020-03-20,United Kingdom,43,647,3277,"rgb(153, 201, 69)"
27546,2020-03-21,United Kingdom,36,706,3983,"rgb(153, 201, 69)"
27547,2020-03-22,United Kingdom,56,1035,5018,"rgb(153, 201, 69)"
27548,2020-03-23,United Kingdom,35,665,5683,"rgb(153, 201, 69)"
27549,2020-03-24,United Kingdom,74,967,6650,"rgb(153, 201, 69)"
27550,2020-03-25,United Kingdom,149,1427,8077,"rgb(153, 201, 69)"
27551,2020-03-26,United Kingdom,186,1452,9529,"rgb(153, 201, 69)"
27552,2020-03-27,United Kingdom,183,2129,11658,"rgb(153, 201, 69)"
27553,2020-03-28,United Kingdom,284,2885,14543,"rgb(153, 201, 69)"
27554,2020-03-29,United Kingdom,294,2546,17089,"rgb(153, 201, 69)"
27555,2020-03-30,United Kingdom,214,2433,19522,"rgb(153, 201, 69)"
27556,2020-03-31,United Kingdom,374,2619,22141,"rgb(153, 201, 69)"
27557,2020-04-01,United Kingdom,382,3009,25150,"rgb(153, 201, 69)"
27558,2020-04-02,United Kingdom,670,4324,29474,"rgb(153, 201, 69)"
27559,2020-04-03,United Kingdom,652,4244,33718,"rgb(153, 201, 69)"
27560,2020-04-04,United Kingdom,714,4450,38168,"rgb(153, 201, 69)"
27561,2020-04-05,United Kingdom,760,3735,41903,"rgb(153, 201, 69)"
27562,2020-04-06,United Kingdom,644,5903,47806,"rgb(153, 201, 69)"
27563,2020-04-07,United Kingdom,568,3802,51608,"rgb(153, 201, 69)"
27564,2020-04-08,United Kingdom,1038,3634,55242,"rgb(153, 201, 69)"
27565,2020-04-09,United Kingdom,1034,5491,60733,"rgb(153, 201, 69)"
27566,2020-04-10,United Kingdom,1103,4344,65077,"rgb(153, 201, 69)"
27567,2020-04-11,United Kingdom,1152,5195,70272,"rgb(153, 201, 69)"
27568,2020-04-12,United Kingdom,839,8719,78991,"rgb(153, 201, 69)"
27569,2020-04-13,United Kingdom,686,5288,84279,"rgb(153, 201, 69)"
27570,2020-04-14,United Kingdom,744,4342,88621,"rgb(153, 201, 69)"
27571,2020-04-15,United Kingdom,1044,5252,93873,"rgb(153, 201, 69)"
27572,2020-04-16,United Kingdom,842,4603,98476,"rgb(153, 201, 69)"
27573,2020-04-17,United Kingdom,1029,4617,103093,"rgb(153, 201, 69)"
27574,2020-04-18,United Kingdom,935,5599,108692,"rgb(153, 201, 69)"
27575,2020-04-19,United Kingdom,1115,5525,114217,"rgb(153, 201, 69)"
27576,2020-04-20,United Kingdom,498,5850,120067,"rgb(153, 201, 69)"
27577,2020-04-21,United Kingdom,559,4676,124743,"rgb(153, 201, 69)"
27578,2020-04-22,United Kingdom,1172,4301,129044,"rgb(153, 201, 69)"
27579,2020-04-23,United Kingdom,837,4451,133495,"rgb(153, 201, 69)"
27580,2020-04-24,United Kingdom,727,4583,138078,"rgb(153, 201, 69)"
27581,2020-04-25,United Kingdom,1005,5386,143464,"rgb(153, 201, 69)"
27582,2020-04-26,United Kingdom,843,4913,148377,"rgb(153, 201, 69)"
27583,2020-04-27,United Kingdom,420,4463,152840,"rgb(153, 201, 69)"
27584,2020-04-28,United Kingdom,338,4309,157149,"rgb(153, 201, 69)"
27585,2020-04-29,United Kingdom,909,3996,161145,"rgb(153, 201, 69)"
27586,2020-04-30,United Kingdom,795,4076,165221,"rgb(153, 201, 69)"
27587,2020-05-01,United Kingdom,674,6032,171253,"rgb(153, 201, 69)"
27588,2020-05-02,United Kingdom,739,6201,177454,"rgb(153, 201, 69)"
27589,2020-05-03,United Kingdom,621,4806,182260,"rgb(153, 201, 69)"
27590,2020-05-04,United Kingdom,315,4339,186599,"rgb(153, 201, 69)"
27591,2020-05-05,United Kingdom,288,3985,190584,"rgb(153, 201, 69)"
27592,2020-05-06,United Kingdom,693,4406,194990,"rgb(153, 201, 69)"
27593,2020-05-07,United Kingdom,649,6211,201201,"rgb(153, 201, 69)"
27594,2020-05-08,United Kingdom,539,5514,206715,"rgb(153, 201, 69)"
27595,2020-05-09,United Kingdom,626,4649,211364,"rgb(153, 201, 69)"
27596,2020-05-10,United Kingdom,346,3896,215260,"rgb(153, 201, 69)"
27597,2020-05-11,United Kingdom,268,3923,219183,"rgb(153, 201, 69)"
27598,2020-05-12,United Kingdom,210,3877,223060,"rgb(153, 201, 69)"
27599,2020-05-13,United Kingdom,627,3403,226463,"rgb(153, 201, 69)"
27600,2020-05-14,United Kingdom,494,3242,229705,"rgb(153, 201, 69)"
27601,2020-05-15,United Kingdom,428,3446,233151,"rgb(153, 201, 69)"
27602,2020-05-16,United Kingdom,384,3560,236711,"rgb(153, 201, 69)"
27603,2020-05-17,United Kingdom,468,3450,240161,"rgb(153, 201, 69)"
27604,2020-05-18,United Kingdom,170,3534,243695,"rgb(153, 201, 69)"
27605,2020-05-19,United Kingdom,160,2711,246406,"rgb(153, 201, 69)"
27606,2020-05-20,United Kingdom,545,2412,248818,"rgb(153, 201, 69)"
27607,2020-05-21,United Kingdom,363,-525,248293,"rgb(153, 201, 69)"
27608,2020-05-22,United Kingdom,338,2615,250908,"rgb(153, 201, 69)"
27609,2020-05-23,United Kingdom,351,3287,254195,"rgb(153, 201, 69)"
27610,2020-05-24,United Kingdom,282,2959,257154,"rgb(153, 201, 69)"
27611,2020-05-25,United Kingdom,118,2405,259559,"rgb(153, 201, 69)"
27612,2020-05-26,United Kingdom,121,1625,261184,"rgb(153, 201, 69)"
27613,2020-05-27,United Kingdom,134,4043,265227,"rgb(153, 201, 69)"
27614,2020-05-28,United Kingdom,412,2013,267240,"rgb(153, 201, 69)"
27615,2020-05-29,United Kingdom,377,1887,269127,"rgb(153, 201, 69)"
27616,2020-05-30,United Kingdom,324,2095,271222,"rgb(153, 201, 69)"
27617,2020-05-31,United Kingdom,215,1604,272826,"rgb(153, 201, 69)"
27618,2020-06-01,United Kingdom,113,1936,274762,"rgb(153, 201, 69)"
27619,2020-06-02,United Kingdom,556,1570,276332,"rgb(153, 201, 69)"
27620,2020-06-03,United Kingdom,324,1653,277985,"rgb(153, 201, 69)"
27621,2020-06-04,United Kingdom,359,1871,279856,"rgb(153, 201, 69)"
27622,2020-06-05,United Kingdom,176,1805,281661,"rgb(153, 201, 69)"
27623,2020-06-06,United Kingdom,357,1650,283311,"rgb(153, 201, 69)"
27624,2020-06-07,United Kingdom,204,1557,284868,"rgb(153, 201, 69)"
27625,2020-06-08,United Kingdom,77,1326,286194,"rgb(153, 201, 69)"
27626,2020-06-09,United Kingdom,55,1205,287399,"rgb(153, 201, 69)"
27627,2020-06-10,United Kingdom,286,1741,289140,"rgb(153, 201, 69)"
27628,2020-06-11,United Kingdom,245,1003,290143,"rgb(153, 201, 69)"
27629,2020-06-12,United Kingdom,151,1266,291409,"rgb(153, 201, 69)"
27630,2020-06-13,United Kingdom,202,1541,292950,"rgb(153, 201, 69)"
27631,2020-06-14,United Kingdom,181,1425,294375,"rgb(153, 201, 69)"
27632,2020-06-15,United Kingdom,36,1514,295889,"rgb(153, 201, 69)"
27633,2020-06-16,United Kingdom,38,968,296857,"rgb(153, 201, 69)"
27634,2020-06-17,United Kingdom,233,1279,298136,"rgb(153, 201, 69)"
27635,2020-06-18,United Kingdom,184,1115,299251,"rgb(153, 201, 69)"
27636,2020-06-19,United Kingdom,135,1218,300469,"rgb(153, 201, 69)"
27637,2020-06-20,United Kingdom,173,1346,301815,"rgb(153, 201, 69)"
27638,2020-06-21,United Kingdom,128,1295,303110,"rgb(153, 201, 69)"
27639,2020-06-22,United Kingdom,43,1221,304331,"rgb(153, 201, 69)"
27640,2020-06-23,United Kingdom,15,958,305289,"rgb(153, 201, 69)"
27641,2020-06-24,United Kingdom,280,921,306210,"rgb(153, 201, 69)"
27642,2020-06-25,United Kingdom,154,652,306862,"rgb(153, 201, 69)"
27643,2020-06-26,United Kingdom,149,1118,307980,"rgb(153, 201, 69)"
27644,2020-06-27,United Kingdom,184,1380,309360,"rgb(153, 201, 69)"
27645,2020-06-28,United Kingdom,100,890,310250,"rgb(153, 201, 69)"
27646,2020-06-29,United Kingdom,36,901,311151,"rgb(153, 201, 69)"
27647,2020-06-30,United Kingdom,25,814,311965,"rgb(153, 201, 69)"
27648,2020-07-01,United Kingdom,155,689,312654,"rgb(153, 201, 69)"
27649,2020-07-02,United Kingdom,176,829,313483,"rgb(153, 201, 69)"
27650,2020-07-03,United Kingdom,89,-29726,283757,"rgb(153, 201, 69)"
27651,2020-07-04,United Kingdom,136,519,284276,"rgb(153, 201, 69)"
27652,2020-07-05,United Kingdom,67,624,284900,"rgb(153, 201, 69)"
27653,2020-07-06,United Kingdom,22,516,285416,"rgb(153, 201, 69)"
27654,2020-07-07,United Kingdom,16,352,285768,"rgb(153, 201, 69)"
27655,2020-07-08,United Kingdom,155,581,286349,"rgb(153, 201, 69)"
27656,2020-07-09,United Kingdom,126,630,286979,"rgb(153, 201, 69)"
27657,2020-07-10,United Kingdom,85,642,287621,"rgb(153, 201, 69)"
27658,2020-07-11,United Kingdom,48,512,288133,"rgb(153, 201, 69)"
27659,2020-07-12,United Kingdom,148,820,288953,"rgb(153, 201, 69)"
27660,2020-07-13,United Kingdom,21,650,289603,"rgb(153, 201, 69)"
27661,2019-12-31,United States of America,0,0,0,"rgb(204, 97, 176)"
27662,2020-01-01,United States of America,0,0,0,"rgb(204, 97, 176)"
27663,2020-01-02,United States of America,0,0,0,"rgb(204, 97, 176)"
27664,2020-01-03,United States of America,0,0,0,"rgb(204, 97, 176)"
27665,2020-01-04,United States of America,0,0,0,"rgb(204, 97, 176)"
27666,2020-01-05,United States of America,0,0,0,"rgb(204, 97, 176)"
27667,2020-01-06,United States of America,0,0,0,"rgb(204, 97, 176)"
27668,2020-01-07,United States of America,0,0,0,"rgb(204, 97, 176)"
27669,2020-01-08,United States of America,0,0,0,"rgb(204, 97, 176)"
27670,2020-01-09,United States of America,0,0,0,"rgb(204, 97, 176)"
27671,2020-01-10,United States of America,0,0,0,"rgb(204, 97, 176)"
27672,2020-01-11,United States of America,0,0,0,"rgb(204, 97, 176)"
27673,2020-01-12,United States of America,0,0,0,"rgb(204, 97, 176)"
27674,2020-01-13,United States of America,0,0,0,"rgb(204, 97, 176)"
27675,2020-01-14,United States of America,0,0,0,"rgb(204, 97, 176)"
27676,2020-01-15,United States of America,0,0,0,"rgb(204, 97, 176)"
27677,2020-01-16,United States of America,0,0,0,"rgb(204, 97, 176)"
27678,2020-01-17,United States of America,0,0,0,"rgb(204, 97, 176)"
27679,2020-01-18,United States of America,0,0,0,"rgb(204, 97, 176)"
27680,2020-01-19,United States of America,0,0,0,"rgb(204, 97, 176)"
27681,2020-01-20,United States of America,0,0,0,"rgb(204, 97, 176)"
27682,2020-01-21,United States of America,0,1,1,"rgb(204, 97, 176)"
27683,2020-01-22,United States of America,0,0,1,"rgb(204, 97, 176)"
27684,2020-01-23,United States of America,0,0,1,"rgb(204, 97, 176)"
27685,2020-01-24,United States of America,0,0,1,"rgb(204, 97, 176)"
27686,2020-01-25,United States of America,0,1,2,"rgb(204, 97, 176)"
27687,2020-01-26,United States of America,0,0,2,"rgb(204, 97, 176)"
27688,2020-01-27,United States of America,0,3,5,"rgb(204, 97, 176)"
27689,2020-01-28,United States of America,0,0,5,"rgb(204, 97, 176)"
27690,2020-01-29,United States of America,0,0,5,"rgb(204, 97, 176)"
27691,2020-01-30,United States of America,0,0,5,"rgb(204, 97, 176)"
27692,2020-01-31,United States of America,0,1,6,"rgb(204, 97, 176)"
27693,2020-02-01,United States of America,0,1,7,"rgb(204, 97, 176)"
27694,2020-02-02,United States of America,0,1,8,"rgb(204, 97, 176)"
27695,2020-02-03,United States of America,0,3,11,"rgb(204, 97, 176)"
27696,2020-02-04,United States of America,0,0,11,"rgb(204, 97, 176)"
27697,2020-02-05,United States of America,0,0,11,"rgb(204, 97, 176)"
27698,2020-02-06,United States of America,0,1,12,"rgb(204, 97, 176)"
27699,2020-02-07,United States of America,0,0,12,"rgb(204, 97, 176)"
27700,2020-02-08,United States of America,0,0,12,"rgb(204, 97, 176)"
27701,2020-02-09,United States of America,0,0,12,"rgb(204, 97, 176)"
27702,2020-02-10,United States of America,0,0,12,"rgb(204, 97, 176)"
27703,2020-02-11,United States of America,0,1,13,"rgb(204, 97, 176)"
27704,2020-02-12,United States of America,0,0,13,"rgb(204, 97, 176)"
27705,2020-02-13,United States of America,0,1,14,"rgb(204, 97, 176)"
27706,2020-02-14,United States of America,0,1,15,"rgb(204, 97, 176)"
27707,2020-02-15,United States of America,0,0,15,"rgb(204, 97, 176)"
27708,2020-02-16,United States of America,0,0,15,"rgb(204, 97, 176)"
27709,2020-02-17,United States of America,0,0,15,"rgb(204, 97, 176)"
27710,2020-02-18,United States of America,0,0,15,"rgb(204, 97, 176)"
27711,2020-02-19,United States of America,0,0,15,"rgb(204, 97, 176)"
27712,2020-02-20,United States of America,0,0,15,"rgb(204, 97, 176)"
27713,2020-02-21,United States of America,0,1,16,"rgb(204, 97, 176)"
27714,2020-02-22,United States of America,0,19,35,"rgb(204, 97, 176)"
27715,2020-02-23,United States of America,0,0,35,"rgb(204, 97, 176)"
27716,2020-02-24,United States of America,0,0,35,"rgb(204, 97, 176)"
27717,2020-02-25,United States of America,0,18,53,"rgb(204, 97, 176)"
27718,2020-02-26,United States of America,0,0,53,"rgb(204, 97, 176)"
27719,2020-02-27,United States of America,0,6,59,"rgb(204, 97, 176)"
27720,2020-02-28,United States of America,0,1,60,"rgb(204, 97, 176)"
27721,2020-02-29,United States of America,0,6,66,"rgb(204, 97, 176)"
27722,2020-03-01,United States of America,1,3,69,"rgb(204, 97, 176)"
27723,2020-03-02,United States of America,1,20,89,"rgb(204, 97, 176)"
27724,2020-03-03,United States of America,4,14,103,"rgb(204, 97, 176)"
27725,2020-03-04,United States of America,3,22,125,"rgb(204, 97, 176)"
27726,2020-03-05,United States of America,2,34,159,"rgb(204, 97, 176)"
27727,2020-03-06,United States of America,1,74,233,"rgb(204, 97, 176)"
27728,2020-03-07,United States of America,2,105,338,"rgb(204, 97, 176)"
27729,2020-03-08,United States of America,3,95,433,"rgb(204, 97, 176)"
27730,2020-03-09,United States of America,4,121,554,"rgb(204, 97, 176)"
27731,2020-03-10,United States of America,5,200,754,"rgb(204, 97, 176)"
27732,2020-03-11,United States of America,2,271,1025,"rgb(204, 97, 176)"
27733,2020-03-12,United States of America,2,287,1312,"rgb(204, 97, 176)"
27734,2020-03-13,United States of America,10,351,1663,"rgb(204, 97, 176)"
27735,2020-03-14,United States of America,7,511,2174,"rgb(204, 97, 176)"
27736,2020-03-15,United States of America,10,777,2951,"rgb(204, 97, 176)"
27737,2020-03-16,United States of America,12,823,3774,"rgb(204, 97, 176)"
27738,2020-03-17,United States of America,16,887,4661,"rgb(204, 97, 176)"
27739,2020-03-18,United States of America,23,1766,6427,"rgb(204, 97, 176)"
27740,2020-03-19,United States of America,42,2988,9415,"rgb(204, 97, 176)"
27741,2020-03-20,United States of America,0,4835,14250,"rgb(204, 97, 176)"
27742,2020-03-21,United States of America,110,5374,19624,"rgb(204, 97, 176)"
27743,2020-03-22,United States of America,80,7123,26747,"rgb(204, 97, 176)"
27744,2020-03-23,United States of America,131,8459,35206,"rgb(204, 97, 176)"
27745,2020-03-24,United States of America,119,11236,46442,"rgb(204, 97, 176)"
27746,2020-03-25,United States of America,211,8789,55231,"rgb(204, 97, 176)"
27747,2020-03-26,United States of America,249,13963,69194,"rgb(204, 97, 176)"
27748,2020-03-27,United States of America,246,16797,85991,"rgb(204, 97, 176)"
27749,2020-03-28,United States of America,411,18695,104686,"rgb(204, 97, 176)"
27750,2020-03-29,United States of America,484,19979,124665,"rgb(204, 97, 176)"
27751,2020-03-30,United States of America,318,18360,143025,"rgb(204, 97, 176)"
27752,2020-03-31,United States of America,661,21595,164620,"rgb(204, 97, 176)"
27753,2020-04-01,United States of America,909,24998,189618,"rgb(204, 97, 176)"
27754,2020-04-02,United States of America,1059,27103,216721,"rgb(204, 97, 176)"
27755,2020-04-03,United States of America,915,28819,245540,"rgb(204, 97, 176)"
27756,2020-04-04,United States of America,1104,32425,277965,"rgb(204, 97, 176)"
27757,2020-04-05,United States of America,1344,34272,312237,"rgb(204, 97, 176)"
27758,2020-04-06,United States of America,1146,25398,337635,"rgb(204, 97, 176)"
27759,2020-04-07,United States of America,1342,30561,368196,"rgb(204, 97, 176)"
27760,2020-04-08,United States of America,1906,30613,398809,"rgb(204, 97, 176)"
27761,2020-04-09,United States of America,1922,33323,432132,"rgb(204, 97, 176)"
27762,2020-04-10,United States of America,1873,33901,466033,"rgb(204, 97, 176)"
27763,2020-04-11,United States of America,2087,35527,501560,"rgb(204, 97, 176)"
27764,2020-04-12,United States of America,1831,28391,529951,"rgb(204, 97, 176)"
27765,2020-04-13,United States of America,1500,27620,557571,"rgb(204, 97, 176)"
27766,2020-04-14,United States of America,1541,25023,582594,"rgb(204, 97, 176)"
27767,2020-04-15,United States of America,2408,26922,609516,"rgb(204, 97, 176)"
27768,2020-04-16,United States of America,4928,30148,639664,"rgb(204, 97, 176)"
27769,2020-04-17,United States of America,2299,31667,671331,"rgb(204, 97, 176)"
27770,2020-04-18,United States of America,3770,30833,702164,"rgb(204, 97, 176)"
27771,2020-04-19,United States of America,1856,32922,735086,"rgb(204, 97, 176)"
27772,2020-04-20,United States of America,1772,24601,759687,"rgb(204, 97, 176)"
27773,2020-04-21,United States of America,1857,28065,787752,"rgb(204, 97, 176)"
27774,2020-04-22,United States of America,2524,37289,825041,"rgb(204, 97, 176)"
27775,2020-04-23,United States of America,1721,17588,842629,"rgb(204, 97, 176)"
27776,2020-04-24,United States of America,3179,26543,869172,"rgb(204, 97, 176)"
27777,2020-04-25,United States of America,1054,21352,890524,"rgb(204, 97, 176)"
27778,2020-04-26,United States of America,2172,48529,939053,"rgb(204, 97, 176)"
27779,2020-04-27,United States of America,1687,26857,965910,"rgb(204, 97, 176)"
27780,2020-04-28,United States of America,1369,22541,988451,"rgb(204, 97, 176)"
27781,2020-04-29,United States of America,2110,24132,1012583,"rgb(204, 97, 176)"
27782,2020-04-30,United States of America,2611,27326,1039909,"rgb(204, 97, 176)"
27783,2020-05-01,United States of America,2040,29917,1069826,"rgb(204, 97, 176)"
27784,2020-05-02,United States of America,2062,33955,1103781,"rgb(204, 97, 176)"
27785,2020-05-03,United States of America,1317,29288,1133069,"rgb(204, 97, 176)"
27786,2020-05-04,United States of America,1297,24972,1158041,"rgb(204, 97, 176)"
27787,2020-05-05,United States of America,1252,22593,1180634,"rgb(204, 97, 176)"
27788,2020-05-06,United States of America,2144,23841,1204475,"rgb(204, 97, 176)"
27789,2020-05-07,United States of America,2353,24128,1228603,"rgb(204, 97, 176)"
27790,2020-05-08,United States of America,2239,28369,1256972,"rgb(204, 97, 176)"
27791,2020-05-09,United States of America,1510,26957,1283929,"rgb(204, 97, 176)"
27792,2020-05-10,United States of America,1614,25612,1309541,"rgb(204, 97, 176)"
27793,2020-05-11,United States of America,734,20258,1329799,"rgb(204, 97, 176)"
27794,2020-05-12,United States of America,1156,18117,1347916,"rgb(204, 97, 176)"
27795,2020-05-13,United States of America,1703,22048,1369964,"rgb(204, 97, 176)"
27796,2020-05-14,United States of America,1746,20782,1390746,"rgb(204, 97, 176)"
27797,2020-05-15,United States of America,1773,27143,1417889,"rgb(204, 97, 176)"
27798,2020-05-16,United States of America,1662,25508,1443397,"rgb(204, 97, 176)"
27799,2020-05-17,United States of America,1186,24487,1467884,"rgb(204, 97, 176)"
27800,2020-05-18,United States of America,808,18873,1486757,"rgb(204, 97, 176)"
27801,2020-05-19,United States of America,791,21841,1508598,"rgb(204, 97, 176)"
27802,2020-05-20,United States of America,1568,19970,1528568,"rgb(204, 97, 176)"
27803,2020-05-21,United States of America,1518,23285,1551853,"rgb(204, 97, 176)"
27804,2020-05-22,United States of America,1263,25434,1577287,"rgb(204, 97, 176)"
27805,2020-05-23,United States of America,1305,24147,1601434,"rgb(204, 97, 176)"
27806,2020-05-24,United States of America,1080,21236,1622670,"rgb(204, 97, 176)"
27807,2020-05-25,United States of America,633,20568,1643238,"rgb(204, 97, 176)"
27808,2020-05-26,United States of America,500,19064,1662302,"rgb(204, 97, 176)"
27809,2020-05-27,United States of America,696,18910,1681212,"rgb(204, 97, 176)"
27810,2020-05-28,United States of America,1526,18721,1699933,"rgb(204, 97, 176)"
27811,2020-05-29,United States of America,1175,21817,1721750,"rgb(204, 97, 176)"
27812,2020-05-30,United States of America,1219,25337,1747087,"rgb(204, 97, 176)"
27813,2020-05-31,United States of America,945,23297,1770384,"rgb(204, 97, 176)"
27814,2020-06-01,United States of America,602,19807,1790191,"rgb(204, 97, 176)"
27815,2020-06-02,United States of America,764,21086,1811277,"rgb(204, 97, 176)"
27816,2020-06-03,United States of America,1034,20544,1831821,"rgb(204, 97, 176)"
27817,2020-06-04,United States of America,994,19699,1851520,"rgb(204, 97, 176)"
27818,2020-06-05,United States of America,1036,21140,1872660,"rgb(204, 97, 176)"
27819,2020-06-06,United States of America,932,25178,1897838,"rgb(204, 97, 176)"
27820,2020-06-07,United States of America,659,22223,1920061,"rgb(204, 97, 176)"
27821,2020-06-08,United States of America,712,22302,1942363,"rgb(204, 97, 176)"
27822,2020-06-09,United States of America,493,18822,1961185,"rgb(204, 97, 176)"
27823,2020-06-10,United States of America,999,18665,1979850,"rgb(204, 97, 176)"
27824,2020-06-11,United States of America,918,20614,2000464,"rgb(204, 97, 176)"
27825,2020-06-12,United States of America,896,22883,2023347,"rgb(204, 97, 176)"
27826,2020-06-13,United States of America,849,25639,2048986,"rgb(204, 97, 176)"
27827,2020-06-14,United States of America,767,25540,2074526,"rgb(204, 97, 176)"
27828,2020-06-15,United States of America,296,19543,2094069,"rgb(204, 97, 176)"
27829,2020-06-16,United States of America,395,19957,2114026,"rgb(204, 97, 176)"
27830,2020-06-17,United States of America,836,23705,2137731,"rgb(204, 97, 176)"
27831,2020-06-18,United States of America,754,25559,2163290,"rgb(204, 97, 176)"
27832,2020-06-19,United States of America,717,27762,2191052,"rgb(204, 97, 176)"
27833,2020-06-20,United States of America,678,29909,2220961,"rgb(204, 97, 176)"
27834,2020-06-21,United States of America,607,34158,2255119,"rgb(204, 97, 176)"
27835,2020-06-22,United States of America,256,25793,2280912,"rgb(204, 97, 176)"
27836,2020-06-23,United States of America,427,31390,2312302,"rgb(204, 97, 176)"
27837,2020-06-24,United States of America,826,34720,2347022,"rgb(204, 97, 176)"
27838,2020-06-25,United States of America,751,34339,2381361,"rgb(204, 97, 176)"
27839,2020-06-26,United States of America,2437,40949,2422310,"rgb(204, 97, 176)"
27840,2020-06-27,United States of America,623,45527,2467837,"rgb(204, 97, 176)"
27841,2020-06-28,United States of America,500,42486,2510323,"rgb(204, 97, 176)"
27842,2020-06-29,United States of America,265,38673,2548996,"rgb(204, 97, 176)"
27843,2020-06-30,United States of America,336,41556,2590552,"rgb(204, 97, 176)"
27844,2020-07-01,United States of America,1270,43880,2634432,"rgb(204, 97, 176)"
27845,2020-07-02,United States of America,652,52048,2686480,"rgb(204, 97, 176)"
27846,2020-07-03,United States of America,678,53399,2739879,"rgb(204, 97, 176)"
27847,2020-07-04,United States of America,694,54442,2794321,"rgb(204, 97, 176)"
27848,2020-07-05,United States of America,242,45221,2839542,"rgb(204, 97, 176)"
27849,2020-07-06,United States of America,271,49093,2888635,"rgb(204, 97, 176)"
27850,2020-07-07,United States of America,359,49990,2938625,"rgb(204, 97, 176)"
27851,2020-07-08,United States of America,1174,57473,2996098,"rgb(204, 97, 176)"
27852,2020-07-09,United States of America,829,58906,3055004,"rgb(204, 97, 176)"
27853,2020-07-10,United States of America,982,63004,3118008,"rgb(204, 97, 176)"
27854,2020-07-11,United States of America,806,66625,3184633,"rgb(204, 97, 176)"
27855,2020-07-12,United States of America,717,63051,3247684,"rgb(204, 97, 176)"
27856,2020-07-13,United States of America,391,57258,3304942,"rgb(204, 97, 176)"
27857,2020-03-15,Uruguay,0,6,6,"rgb(36, 121, 108)"
27858,2020-03-16,Uruguay,0,2,8,"rgb(36, 121, 108)"
27859,2020-03-17,Uruguay,0,21,29,"rgb(36, 121, 108)"
27860,2020-03-18,Uruguay,0,21,50,"rgb(36, 121, 108)"
27861,2020-03-19,Uruguay,0,29,79,"rgb(36, 121, 108)"
27862,2020-03-20,Uruguay,0,15,94,"rgb(36, 121, 108)"
27863,2020-03-21,Uruguay,0,16,110,"rgb(36, 121, 108)"
27864,2020-03-22,Uruguay,0,25,135,"rgb(36, 121, 108)"
27865,2020-03-23,Uruguay,0,23,158,"rgb(36, 121, 108)"
27866,2020-03-24,Uruguay,0,4,162,"rgb(36, 121, 108)"
27867,2020-03-25,Uruguay,0,27,189,"rgb(36, 121, 108)"
27868,2020-03-26,Uruguay,0,28,217,"rgb(36, 121, 108)"
27869,2020-03-27,Uruguay,0,21,238,"rgb(36, 121, 108)"
27870,2020-03-28,Uruguay,0,0,238,"rgb(36, 121, 108)"
27871,2020-03-29,Uruguay,0,21,259,"rgb(36, 121, 108)"
27872,2020-03-30,Uruguay,1,36,295,"rgb(36, 121, 108)"
27873,2020-03-31,Uruguay,0,29,324,"rgb(36, 121, 108)"
27874,2020-04-01,Uruguay,0,6,330,"rgb(36, 121, 108)"
27875,2020-04-02,Uruguay,1,11,341,"rgb(36, 121, 108)"
27876,2020-04-03,Uruguay,2,18,359,"rgb(36, 121, 108)"
27877,2020-04-04,Uruguay,0,12,371,"rgb(36, 121, 108)"
27878,2020-04-05,Uruguay,1,19,390,"rgb(36, 121, 108)"
27879,2020-04-06,Uruguay,1,17,407,"rgb(36, 121, 108)"
27880,2020-04-07,Uruguay,0,4,411,"rgb(36, 121, 108)"
27881,2020-04-08,Uruguay,1,6,417,"rgb(36, 121, 108)"
27882,2020-04-09,Uruguay,0,9,426,"rgb(36, 121, 108)"
27883,2020-04-10,Uruguay,0,7,433,"rgb(36, 121, 108)"
27884,2020-04-11,Uruguay,0,13,446,"rgb(36, 121, 108)"
27885,2020-04-12,Uruguay,0,7,453,"rgb(36, 121, 108)"
27886,2020-04-13,Uruguay,1,12,465,"rgb(36, 121, 108)"
27887,2020-04-14,Uruguay,0,7,472,"rgb(36, 121, 108)"
27888,2020-04-15,Uruguay,0,11,483,"rgb(36, 121, 108)"
27889,2020-04-16,Uruguay,1,10,493,"rgb(36, 121, 108)"
27890,2020-04-17,Uruguay,0,9,502,"rgb(36, 121, 108)"
27891,2020-04-18,Uruguay,0,6,508,"rgb(36, 121, 108)"
27892,2020-04-19,Uruguay,0,9,517,"rgb(36, 121, 108)"
27893,2020-04-20,Uruguay,1,11,528,"rgb(36, 121, 108)"
27894,2020-04-21,Uruguay,0,7,535,"rgb(36, 121, 108)"
27895,2020-04-22,Uruguay,2,8,543,"rgb(36, 121, 108)"
27896,2020-04-23,Uruguay,0,6,549,"rgb(36, 121, 108)"
27897,2020-04-24,Uruguay,0,8,557,"rgb(36, 121, 108)"
27898,2020-04-25,Uruguay,0,6,563,"rgb(36, 121, 108)"
27899,2020-04-26,Uruguay,2,33,596,"rgb(36, 121, 108)"
27900,2020-04-27,Uruguay,1,10,606,"rgb(36, 121, 108)"
27901,2020-04-28,Uruguay,0,14,620,"rgb(36, 121, 108)"
27902,2020-04-29,Uruguay,0,5,625,"rgb(36, 121, 108)"
27903,2020-04-30,Uruguay,0,5,630,"rgb(36, 121, 108)"
27904,2020-05-01,Uruguay,2,13,643,"rgb(36, 121, 108)"
27905,2020-05-02,Uruguay,0,5,648,"rgb(36, 121, 108)"
27906,2020-05-03,Uruguay,0,4,652,"rgb(36, 121, 108)"
27907,2020-05-04,Uruguay,0,3,655,"rgb(36, 121, 108)"
27908,2020-05-05,Uruguay,0,2,657,"rgb(36, 121, 108)"
27909,2020-05-06,Uruguay,0,13,670,"rgb(36, 121, 108)"
27910,2020-05-07,Uruguay,0,3,673,"rgb(36, 121, 108)"
27911,2020-05-08,Uruguay,0,11,684,"rgb(36, 121, 108)"
27912,2020-05-09,Uruguay,1,10,694,"rgb(36, 121, 108)"
27913,2020-05-10,Uruguay,0,8,702,"rgb(36, 121, 108)"
27914,2020-05-11,Uruguay,1,5,707,"rgb(36, 121, 108)"
27915,2020-05-12,Uruguay,0,4,711,"rgb(36, 121, 108)"
27916,2020-05-13,Uruguay,0,6,717,"rgb(36, 121, 108)"
27917,2020-05-14,Uruguay,0,2,719,"rgb(36, 121, 108)"
27918,2020-05-15,Uruguay,0,5,724,"rgb(36, 121, 108)"
27919,2020-05-16,Uruguay,0,8,732,"rgb(36, 121, 108)"
27920,2020-05-17,Uruguay,0,1,733,"rgb(36, 121, 108)"
27921,2020-05-18,Uruguay,1,1,734,"rgb(36, 121, 108)"
27922,2020-05-19,Uruguay,0,3,737,"rgb(36, 121, 108)"
27923,2020-05-20,Uruguay,0,1,738,"rgb(36, 121, 108)"
27924,2020-05-21,Uruguay,0,8,746,"rgb(36, 121, 108)"
27925,2020-05-22,Uruguay,0,3,749,"rgb(36, 121, 108)"
27926,2020-05-23,Uruguay,0,4,753,"rgb(36, 121, 108)"
27927,2020-05-24,Uruguay,2,11,764,"rgb(36, 121, 108)"
27928,2020-05-25,Uruguay,0,5,769,"rgb(36, 121, 108)"
27929,2020-05-26,Uruguay,0,18,787,"rgb(36, 121, 108)"
27930,2020-05-27,Uruguay,0,2,789,"rgb(36, 121, 108)"
27931,2020-05-28,Uruguay,0,14,803,"rgb(36, 121, 108)"
27932,2020-05-29,Uruguay,0,8,811,"rgb(36, 121, 108)"
27933,2020-05-30,Uruguay,0,5,816,"rgb(36, 121, 108)"
27934,2020-05-31,Uruguay,0,5,821,"rgb(36, 121, 108)"
27935,2020-06-01,Uruguay,0,2,823,"rgb(36, 121, 108)"
27936,2020-06-02,Uruguay,1,2,825,"rgb(36, 121, 108)"
27937,2020-06-03,Uruguay,0,1,826,"rgb(36, 121, 108)"
27938,2020-06-04,Uruguay,0,2,828,"rgb(36, 121, 108)"
27939,2020-06-05,Uruguay,0,4,832,"rgb(36, 121, 108)"
27940,2020-06-06,Uruguay,0,2,834,"rgb(36, 121, 108)"
27941,2020-06-07,Uruguay,0,11,845,"rgb(36, 121, 108)"
27942,2020-06-08,Uruguay,0,0,845,"rgb(36, 121, 108)"
27943,2020-06-09,Uruguay,0,0,845,"rgb(36, 121, 108)"
27944,2020-06-10,Uruguay,0,1,846,"rgb(36, 121, 108)"
27945,2020-06-11,Uruguay,0,1,847,"rgb(36, 121, 108)"
27946,2020-06-12,Uruguay,0,0,847,"rgb(36, 121, 108)"
27947,2020-06-13,Uruguay,0,0,847,"rgb(36, 121, 108)"
27948,2020-06-14,Uruguay,0,0,847,"rgb(36, 121, 108)"
27949,2020-06-15,Uruguay,0,1,848,"rgb(36, 121, 108)"
27950,2020-06-16,Uruguay,0,0,848,"rgb(36, 121, 108)"
27951,2020-06-17,Uruguay,1,1,849,"rgb(36, 121, 108)"
27952,2020-06-18,Uruguay,0,0,849,"rgb(36, 121, 108)"
27953,2020-06-19,Uruguay,0,1,850,"rgb(36, 121, 108)"
27954,2020-06-20,Uruguay,0,3,853,"rgb(36, 121, 108)"
27955,2020-06-21,Uruguay,1,6,859,"rgb(36, 121, 108)"
27956,2020-06-22,Uruguay,0,17,876,"rgb(36, 121, 108)"
27957,2020-06-23,Uruguay,0,6,882,"rgb(36, 121, 108)"
27958,2020-06-24,Uruguay,0,3,885,"rgb(36, 121, 108)"
27959,2020-06-25,Uruguay,1,17,902,"rgb(36, 121, 108)"
27960,2020-06-26,Uruguay,0,5,907,"rgb(36, 121, 108)"
27961,2020-06-27,Uruguay,0,12,919,"rgb(36, 121, 108)"
27962,2020-06-28,Uruguay,0,5,924,"rgb(36, 121, 108)"
27963,2020-06-29,Uruguay,1,5,929,"rgb(36, 121, 108)"
27964,2020-06-30,Uruguay,0,3,932,"rgb(36, 121, 108)"
27965,2020-07-01,Uruguay,0,4,936,"rgb(36, 121, 108)"
27966,2020-07-02,Uruguay,1,7,943,"rgb(36, 121, 108)"
27967,2020-07-03,Uruguay,0,4,947,"rgb(36, 121, 108)"
27968,2020-07-04,Uruguay,0,5,952,"rgb(36, 121, 108)"
27969,2020-07-05,Uruguay,0,3,955,"rgb(36, 121, 108)"
27970,2020-07-06,Uruguay,0,1,956,"rgb(36, 121, 108)"
27971,2020-07-07,Uruguay,1,4,960,"rgb(36, 121, 108)"
27972,2020-07-08,Uruguay,0,5,965,"rgb(36, 121, 108)"
27973,2020-07-09,Uruguay,0,9,974,"rgb(36, 121, 108)"
27974,2020-07-10,Uruguay,0,3,977,"rgb(36, 121, 108)"
27975,2020-07-11,Uruguay,0,8,985,"rgb(36, 121, 108)"
27976,2020-07-12,Uruguay,1,1,986,"rgb(36, 121, 108)"
27977,2020-07-13,Uruguay,1,1,987,"rgb(36, 121, 108)"
27978,2020-03-16,Uzbekistan,0,6,6,"rgb(218, 165, 27)"
27979,2020-03-17,Uzbekistan,0,2,8,"rgb(218, 165, 27)"
27980,2020-03-18,Uzbekistan,0,8,16,"rgb(218, 165, 27)"
27981,2020-03-19,Uzbekistan,0,7,23,"rgb(218, 165, 27)"
27982,2020-03-20,Uzbekistan,0,0,23,"rgb(218, 165, 27)"
27983,2020-03-21,Uzbekistan,0,10,33,"rgb(218, 165, 27)"
27984,2020-03-22,Uzbekistan,0,0,33,"rgb(218, 165, 27)"
27985,2020-03-23,Uzbekistan,0,13,46,"rgb(218, 165, 27)"
27986,2020-03-24,Uzbekistan,0,3,49,"rgb(218, 165, 27)"
27987,2020-03-25,Uzbekistan,0,6,55,"rgb(218, 165, 27)"
27988,2020-03-26,Uzbekistan,0,10,65,"rgb(218, 165, 27)"
27989,2020-03-27,Uzbekistan,0,18,83,"rgb(218, 165, 27)"
27990,2020-03-28,Uzbekistan,0,21,104,"rgb(218, 165, 27)"
27991,2020-03-29,Uzbekistan,1,29,133,"rgb(218, 165, 27)"
27992,2020-03-30,Uzbekistan,0,12,145,"rgb(218, 165, 27)"
27993,2020-03-31,Uzbekistan,1,4,149,"rgb(218, 165, 27)"
27994,2020-04-01,Uzbekistan,0,24,173,"rgb(218, 165, 27)"
27995,2020-04-02,Uzbekistan,0,14,187,"rgb(218, 165, 27)"
27996,2020-04-03,Uzbekistan,0,3,190,"rgb(218, 165, 27)"
27997,2020-04-04,Uzbekistan,0,37,227,"rgb(218, 165, 27)"
27998,2020-04-05,Uzbekistan,0,39,266,"rgb(218, 165, 27)"
27999,2020-04-06,Uzbekistan,0,76,342,"rgb(218, 165, 27)"
28000,2020-04-07,Uzbekistan,0,55,397,"rgb(218, 165, 27)"
28001,2020-04-08,Uzbekistan,0,107,504,"rgb(218, 165, 27)"
28002,2020-04-09,Uzbekistan,1,51,555,"rgb(218, 165, 27)"
28003,2020-04-10,Uzbekistan,0,27,582,"rgb(218, 165, 27)"
28004,2020-04-11,Uzbekistan,0,42,624,"rgb(218, 165, 27)"
28005,2020-04-12,Uzbekistan,1,172,796,"rgb(218, 165, 27)"
28006,2020-04-13,Uzbekistan,0,69,865,"rgb(218, 165, 27)"
28007,2020-04-14,Uzbekistan,0,133,998,"rgb(218, 165, 27)"
28008,2020-04-15,Uzbekistan,0,167,1165,"rgb(218, 165, 27)"
28009,2020-04-16,Uzbekistan,0,137,1302,"rgb(218, 165, 27)"
28010,2020-04-17,Uzbekistan,0,78,1380,"rgb(218, 165, 27)"
28011,2020-04-18,Uzbekistan,0,70,1450,"rgb(218, 165, 27)"
28012,2020-04-19,Uzbekistan,1,45,1495,"rgb(218, 165, 27)"
28013,2020-04-20,Uzbekistan,0,70,1565,"rgb(218, 165, 27)"
28014,2020-04-21,Uzbekistan,0,92,1657,"rgb(218, 165, 27)"
28015,2020-04-22,Uzbekistan,1,35,1692,"rgb(218, 165, 27)"
28016,2020-04-23,Uzbekistan,1,24,1716,"rgb(218, 165, 27)"
28017,2020-04-24,Uzbekistan,0,62,1778,"rgb(218, 165, 27)"
28018,2020-04-25,Uzbekistan,1,58,1836,"rgb(218, 165, 27)"
28019,2020-04-26,Uzbekistan,0,29,1865,"rgb(218, 165, 27)"
28020,2020-04-27,Uzbekistan,0,22,1887,"rgb(218, 165, 27)"
28021,2020-04-28,Uzbekistan,0,17,1904,"rgb(218, 165, 27)"
28022,2020-04-29,Uzbekistan,0,35,1939,"rgb(218, 165, 27)"
28023,2020-04-30,Uzbekistan,1,63,2002,"rgb(218, 165, 27)"
28024,2020-05-01,Uzbekistan,0,44,2046,"rgb(218, 165, 27)"
28025,2020-05-02,Uzbekistan,0,48,2094,"rgb(218, 165, 27)"
28026,2020-05-03,Uzbekistan,0,33,2127,"rgb(218, 165, 27)"
28027,2020-05-04,Uzbekistan,1,22,2149,"rgb(218, 165, 27)"
28028,2020-05-05,Uzbekistan,0,40,2189,"rgb(218, 165, 27)"
28029,2020-05-06,Uzbekistan,0,18,2207,"rgb(218, 165, 27)"
28030,2020-05-07,Uzbekistan,0,26,2233,"rgb(218, 165, 27)"
28031,2020-05-08,Uzbekistan,0,65,2298,"rgb(218, 165, 27)"
28032,2020-05-09,Uzbekistan,0,38,2336,"rgb(218, 165, 27)"
28033,2020-05-10,Uzbekistan,0,51,2387,"rgb(218, 165, 27)"
28034,2020-05-11,Uzbekistan,0,31,2418,"rgb(218, 165, 27)"
28035,2020-05-12,Uzbekistan,0,91,2509,"rgb(218, 165, 27)"
28036,2020-05-13,Uzbekistan,0,38,2547,"rgb(218, 165, 27)"
28037,2020-05-14,Uzbekistan,1,65,2612,"rgb(218, 165, 27)"
28038,2020-05-15,Uzbekistan,0,33,2645,"rgb(218, 165, 27)"
28039,2020-05-16,Uzbekistan,0,46,2691,"rgb(218, 165, 27)"
28040,2020-05-17,Uzbekistan,0,50,2741,"rgb(218, 165, 27)"
28041,2020-05-18,Uzbekistan,1,12,2753,"rgb(218, 165, 27)"
28042,2020-05-19,Uzbekistan,1,49,2802,"rgb(218, 165, 27)"
28043,2020-05-20,Uzbekistan,0,78,2880,"rgb(218, 165, 27)"
28044,2020-05-21,Uzbekistan,0,70,2950,"rgb(218, 165, 27)"
28045,2020-05-22,Uzbekistan,0,56,3006,"rgb(218, 165, 27)"
28046,2020-05-23,Uzbekistan,0,72,3078,"rgb(218, 165, 27)"
28047,2020-05-24,Uzbekistan,0,54,3132,"rgb(218, 165, 27)"
28048,2020-05-25,Uzbekistan,0,32,3164,"rgb(218, 165, 27)"
28049,2020-05-26,Uzbekistan,0,97,3261,"rgb(218, 165, 27)"
28050,2020-05-27,Uzbekistan,1,72,3333,"rgb(218, 165, 27)"
28051,2020-05-28,Uzbekistan,0,0,3333,"rgb(218, 165, 27)"
28052,2020-05-29,Uzbekistan,0,111,3444,"rgb(218, 165, 27)"
28053,2020-05-30,Uzbekistan,0,69,3513,"rgb(218, 165, 27)"
28054,2020-05-31,Uzbekistan,0,41,3554,"rgb(218, 165, 27)"
28055,2020-06-01,Uzbekistan,1,108,3662,"rgb(218, 165, 27)"
28056,2020-06-02,Uzbekistan,0,56,3718,"rgb(218, 165, 27)"
28057,2020-06-03,Uzbekistan,0,51,3769,"rgb(218, 165, 27)"
28058,2020-06-04,Uzbekistan,1,105,3874,"rgb(218, 165, 27)"
28059,2020-06-05,Uzbekistan,0,91,3965,"rgb(218, 165, 27)"
28060,2020-06-06,Uzbekistan,0,57,4022,"rgb(218, 165, 27)"
28061,2020-06-07,Uzbekistan,1,159,4181,"rgb(218, 165, 27)"
28062,2020-06-08,Uzbekistan,0,171,4352,"rgb(218, 165, 27)"
28063,2020-06-09,Uzbekistan,1,96,4448,"rgb(218, 165, 27)"
28064,2020-06-10,Uzbekistan,0,99,4547,"rgb(218, 165, 27)"
28065,2020-06-11,Uzbekistan,1,148,4695,"rgb(218, 165, 27)"
28066,2020-06-12,Uzbekistan,0,124,4819,"rgb(218, 165, 27)"
28067,2020-06-13,Uzbekistan,0,82,4901,"rgb(218, 165, 27)"
28068,2020-06-14,Uzbekistan,0,93,4994,"rgb(218, 165, 27)"
28069,2020-06-15,Uzbekistan,0,109,5103,"rgb(218, 165, 27)"
28070,2020-06-16,Uzbekistan,0,190,5293,"rgb(218, 165, 27)"
28071,2020-06-17,Uzbekistan,0,268,5561,"rgb(218, 165, 27)"
28072,2020-06-18,Uzbekistan,0,136,5697,"rgb(218, 165, 27)"
28073,2020-06-19,Uzbekistan,0,158,5855,"rgb(218, 165, 27)"
28074,2020-06-20,Uzbekistan,0,170,6025,"rgb(218, 165, 27)"
28075,2020-06-21,Uzbekistan,0,191,6216,"rgb(218, 165, 27)"
28076,2020-06-22,Uzbekistan,0,142,6358,"rgb(218, 165, 27)"
28077,2020-06-23,Uzbekistan,0,142,6500,"rgb(218, 165, 27)"
28078,2020-06-24,Uzbekistan,0,255,6755,"rgb(218, 165, 27)"
28079,2020-06-25,Uzbekistan,0,235,6990,"rgb(218, 165, 27)"
28080,2020-06-26,Uzbekistan,1,238,7228,"rgb(218, 165, 27)"
28081,2020-06-27,Uzbekistan,0,262,7490,"rgb(218, 165, 27)"
28082,2020-06-28,Uzbekistan,0,235,7725,"rgb(218, 165, 27)"
28083,2020-06-29,Uzbekistan,2,306,8031,"rgb(218, 165, 27)"
28084,2020-06-30,Uzbekistan,2,267,8298,"rgb(218, 165, 27)"
28085,2020-07-01,Uzbekistan,2,329,8627,"rgb(218, 165, 27)"
28086,2020-07-02,Uzbekistan,0,277,8904,"rgb(218, 165, 27)"
28087,2020-07-03,Uzbekistan,1,295,9199,"rgb(218, 165, 27)"
28088,2020-07-04,Uzbekistan,2,301,9500,"rgb(218, 165, 27)"
28089,2020-07-05,Uzbekistan,2,329,9829,"rgb(218, 165, 27)"
28090,2020-07-06,Uzbekistan,4,314,10143,"rgb(218, 165, 27)"
28091,2020-07-07,Uzbekistan,3,316,10459,"rgb(218, 165, 27)"
28092,2020-07-08,Uzbekistan,3,379,10838,"rgb(218, 165, 27)"
28093,2020-07-09,Uzbekistan,6,421,11259,"rgb(218, 165, 27)"
28094,2020-07-10,Uzbekistan,5,464,11723,"rgb(218, 165, 27)"
28095,2020-07-11,Uzbekistan,3,483,12206,"rgb(218, 165, 27)"
28096,2020-07-12,Uzbekistan,2,307,12513,"rgb(218, 165, 27)"
28097,2020-07-13,Uzbekistan,4,680,13193,"rgb(218, 165, 27)"
28098,2020-03-07,Holy See,0,1,1,"rgb(47, 138, 196)"
28099,2020-03-16,Holy See,0,0,1,"rgb(47, 138, 196)"
28100,2020-03-17,Holy See,0,0,1,"rgb(47, 138, 196)"
28101,2020-03-18,Holy See,0,0,1,"rgb(47, 138, 196)"
28102,2020-03-19,Holy See,0,0,1,"rgb(47, 138, 196)"
28103,2020-03-20,Holy See,0,0,1,"rgb(47, 138, 196)"
28104,2020-03-21,Holy See,0,0,1,"rgb(47, 138, 196)"
28105,2020-03-22,Holy See,0,0,1,"rgb(47, 138, 196)"
28106,2020-03-23,Holy See,0,0,1,"rgb(47, 138, 196)"
28107,2020-03-24,Holy See,0,0,1,"rgb(47, 138, 196)"
28108,2020-03-25,Holy See,0,0,1,"rgb(47, 138, 196)"
28109,2020-03-26,Holy See,0,0,1,"rgb(47, 138, 196)"
28110,2020-03-27,Holy See,0,4,5,"rgb(47, 138, 196)"
28111,2020-03-28,Holy See,0,0,5,"rgb(47, 138, 196)"
28112,2020-03-29,Holy See,0,1,6,"rgb(47, 138, 196)"
28113,2020-03-30,Holy See,0,0,6,"rgb(47, 138, 196)"
28114,2020-03-31,Holy See,0,0,6,"rgb(47, 138, 196)"
28115,2020-04-01,Holy See,0,0,6,"rgb(47, 138, 196)"
28116,2020-04-02,Holy See,0,0,6,"rgb(47, 138, 196)"
28117,2020-04-03,Holy See,0,0,6,"rgb(47, 138, 196)"
28118,2020-04-04,Holy See,0,1,7,"rgb(47, 138, 196)"
28119,2020-04-05,Holy See,0,0,7,"rgb(47, 138, 196)"
28120,2020-04-06,Holy See,0,0,7,"rgb(47, 138, 196)"
28121,2020-04-07,Holy See,0,0,7,"rgb(47, 138, 196)"
28122,2020-04-08,Holy See,0,0,7,"rgb(47, 138, 196)"
28123,2020-04-09,Holy See,0,1,8,"rgb(47, 138, 196)"
28124,2020-04-10,Holy See,0,0,8,"rgb(47, 138, 196)"
28125,2020-04-11,Holy See,0,0,8,"rgb(47, 138, 196)"
28126,2020-04-12,Holy See,0,0,8,"rgb(47, 138, 196)"
28127,2020-04-13,Holy See,0,0,8,"rgb(47, 138, 196)"
28128,2020-04-14,Holy See,0,0,8,"rgb(47, 138, 196)"
28129,2020-04-15,Holy See,0,0,8,"rgb(47, 138, 196)"
28130,2020-04-16,Holy See,0,0,8,"rgb(47, 138, 196)"
28131,2020-04-17,Holy See,0,0,8,"rgb(47, 138, 196)"
28132,2020-04-18,Holy See,0,0,8,"rgb(47, 138, 196)"
28133,2020-04-19,Holy See,0,0,8,"rgb(47, 138, 196)"
28134,2020-04-20,Holy See,0,0,8,"rgb(47, 138, 196)"
28135,2020-04-21,Holy See,0,1,9,"rgb(47, 138, 196)"
28136,2020-04-22,Holy See,0,0,9,"rgb(47, 138, 196)"
28137,2020-04-23,Holy See,0,0,9,"rgb(47, 138, 196)"
28138,2020-04-24,Holy See,0,0,9,"rgb(47, 138, 196)"
28139,2020-04-25,Holy See,0,0,9,"rgb(47, 138, 196)"
28140,2020-04-26,Holy See,0,0,9,"rgb(47, 138, 196)"
28141,2020-04-27,Holy See,0,0,9,"rgb(47, 138, 196)"
28142,2020-04-28,Holy See,0,0,9,"rgb(47, 138, 196)"
28143,2020-04-29,Holy See,0,0,9,"rgb(47, 138, 196)"
28144,2020-04-30,Holy See,0,1,10,"rgb(47, 138, 196)"
28145,2020-05-01,Holy See,0,1,11,"rgb(47, 138, 196)"
28146,2020-05-02,Holy See,0,0,11,"rgb(47, 138, 196)"
28147,2020-05-03,Holy See,0,0,11,"rgb(47, 138, 196)"
28148,2020-05-04,Holy See,0,0,11,"rgb(47, 138, 196)"
28149,2020-05-05,Holy See,0,0,11,"rgb(47, 138, 196)"
28150,2020-05-06,Holy See,0,0,11,"rgb(47, 138, 196)"
28151,2020-05-07,Holy See,0,1,12,"rgb(47, 138, 196)"
28152,2020-05-08,Holy See,0,0,12,"rgb(47, 138, 196)"
28153,2020-05-09,Holy See,0,0,12,"rgb(47, 138, 196)"
28154,2020-05-10,Holy See,0,0,12,"rgb(47, 138, 196)"
28155,2020-05-11,Holy See,0,0,12,"rgb(47, 138, 196)"
28156,2020-05-12,Holy See,0,0,12,"rgb(47, 138, 196)"
28157,2020-05-13,Holy See,0,0,12,"rgb(47, 138, 196)"
28158,2020-05-14,Holy See,0,0,12,"rgb(47, 138, 196)"
28159,2020-05-15,Holy See,0,0,12,"rgb(47, 138, 196)"
28160,2020-05-16,Holy See,0,0,12,"rgb(47, 138, 196)"
28161,2020-05-17,Holy See,0,0,12,"rgb(47, 138, 196)"
28162,2020-05-18,Holy See,0,0,12,"rgb(47, 138, 196)"
28163,2020-05-19,Holy See,0,0,12,"rgb(47, 138, 196)"
28164,2020-05-20,Holy See,0,0,12,"rgb(47, 138, 196)"
28165,2020-05-21,Holy See,0,0,12,"rgb(47, 138, 196)"
28166,2020-05-22,Holy See,0,0,12,"rgb(47, 138, 196)"
28167,2020-05-23,Holy See,0,0,12,"rgb(47, 138, 196)"
28168,2020-05-24,Holy See,0,0,12,"rgb(47, 138, 196)"
28169,2020-05-25,Holy See,0,0,12,"rgb(47, 138, 196)"
28170,2020-05-26,Holy See,0,0,12,"rgb(47, 138, 196)"
28171,2020-05-27,Holy See,0,0,12,"rgb(47, 138, 196)"
28172,2020-05-28,Holy See,0,0,12,"rgb(47, 138, 196)"
28173,2020-05-29,Holy See,0,0,12,"rgb(47, 138, 196)"
28174,2020-05-30,Holy See,0,0,12,"rgb(47, 138, 196)"
28175,2020-05-31,Holy See,0,0,12,"rgb(47, 138, 196)"
28176,2020-06-01,Holy See,0,0,12,"rgb(47, 138, 196)"
28177,2020-06-02,Holy See,0,0,12,"rgb(47, 138, 196)"
28178,2020-06-03,Holy See,0,0,12,"rgb(47, 138, 196)"
28179,2020-06-04,Holy See,0,0,12,"rgb(47, 138, 196)"
28180,2020-06-05,Holy See,0,0,12,"rgb(47, 138, 196)"
28181,2020-06-06,Holy See,0,0,12,"rgb(47, 138, 196)"
28182,2020-06-07,Holy See,0,0,12,"rgb(47, 138, 196)"
28183,2020-06-08,Holy See,0,0,12,"rgb(47, 138, 196)"
28184,2020-06-09,Holy See,0,0,12,"rgb(47, 138, 196)"
28185,2020-06-10,Holy See,0,0,12,"rgb(47, 138, 196)"
28186,2020-06-11,Holy See,0,0,12,"rgb(47, 138, 196)"
28187,2020-06-12,Holy See,0,0,12,"rgb(47, 138, 196)"
28188,2020-06-13,Holy See,0,0,12,"rgb(47, 138, 196)"
28189,2020-06-14,Holy See,0,0,12,"rgb(47, 138, 196)"
28190,2020-06-15,Holy See,0,0,12,"rgb(47, 138, 196)"
28191,2020-06-16,Holy See,0,0,12,"rgb(47, 138, 196)"
28192,2020-06-17,Holy See,0,0,12,"rgb(47, 138, 196)"
28193,2020-06-18,Holy See,0,0,12,"rgb(47, 138, 196)"
28194,2020-06-19,Holy See,0,0,12,"rgb(47, 138, 196)"
28195,2020-06-20,Holy See,0,0,12,"rgb(47, 138, 196)"
28196,2020-06-21,Holy See,0,0,12,"rgb(47, 138, 196)"
28197,2020-06-22,Holy See,0,0,12,"rgb(47, 138, 196)"
28198,2020-06-23,Holy See,0,0,12,"rgb(47, 138, 196)"
28199,2020-06-24,Holy See,0,0,12,"rgb(47, 138, 196)"
28200,2020-06-25,Holy See,0,0,12,"rgb(47, 138, 196)"
28201,2020-06-26,Holy See,0,0,12,"rgb(47, 138, 196)"
28202,2020-06-27,Holy See,0,0,12,"rgb(47, 138, 196)"
28203,2020-06-28,Holy See,0,0,12,"rgb(47, 138, 196)"
28204,2020-06-29,Holy See,0,0,12,"rgb(47, 138, 196)"
28205,2020-06-30,Holy See,0,0,12,"rgb(47, 138, 196)"
28206,2020-07-01,Holy See,0,0,12,"rgb(47, 138, 196)"
28207,2020-07-02,Holy See,0,0,12,"rgb(47, 138, 196)"
28208,2020-07-03,Holy See,0,0,12,"rgb(47, 138, 196)"
28209,2020-07-04,Holy See,0,0,12,"rgb(47, 138, 196)"
28210,2020-07-05,Holy See,0,0,12,"rgb(47, 138, 196)"
28211,2020-07-06,Holy See,0,0,12,"rgb(47, 138, 196)"
28212,2020-07-07,Holy See,0,0,12,"rgb(47, 138, 196)"
28213,2020-07-08,Holy See,0,0,12,"rgb(47, 138, 196)"
28214,2020-07-09,Holy See,0,0,12,"rgb(47, 138, 196)"
28215,2020-07-10,Holy See,0,0,12,"rgb(47, 138, 196)"
28216,2020-07-11,Holy See,0,0,12,"rgb(47, 138, 196)"
28217,2020-07-12,Holy See,0,0,12,"rgb(47, 138, 196)"
28218,2020-07-13,Holy See,0,0,12,"rgb(47, 138, 196)"
28219,2020-03-13,Saint Vincent and the Grenadines,0,1,1,"rgb(118, 78, 159)"
28220,2020-03-25,Saint Vincent and the Grenadines,0,0,1,"rgb(118, 78, 159)"
28221,2020-03-26,Saint Vincent and the Grenadines,0,0,1,"rgb(118, 78, 159)"
28222,2020-03-27,Saint Vincent and the Grenadines,0,0,1,"rgb(118, 78, 159)"
28223,2020-03-28,Saint Vincent and the Grenadines,0,0,1,"rgb(118, 78, 159)"
28224,2020-03-29,Saint Vincent and the Grenadines,0,0,1,"rgb(118, 78, 159)"
28225,2020-03-30,Saint Vincent and the Grenadines,0,0,1,"rgb(118, 78, 159)"
28226,2020-03-31,Saint Vincent and the Grenadines,0,0,1,"rgb(118, 78, 159)"
28227,2020-04-01,Saint Vincent and the Grenadines,0,0,1,"rgb(118, 78, 159)"
28228,2020-04-02,Saint Vincent and the Grenadines,0,1,2,"rgb(118, 78, 159)"
28229,2020-04-03,Saint Vincent and the Grenadines,0,0,2,"rgb(118, 78, 159)"
28230,2020-04-04,Saint Vincent and the Grenadines,0,5,7,"rgb(118, 78, 159)"
28231,2020-04-05,Saint Vincent and the Grenadines,0,0,7,"rgb(118, 78, 159)"
28232,2020-04-06,Saint Vincent and the Grenadines,0,0,7,"rgb(118, 78, 159)"
28233,2020-04-07,Saint Vincent and the Grenadines,0,0,7,"rgb(118, 78, 159)"
28234,2020-04-08,Saint Vincent and the Grenadines,0,1,8,"rgb(118, 78, 159)"
28235,2020-04-09,Saint Vincent and the Grenadines,0,0,8,"rgb(118, 78, 159)"
28236,2020-04-10,Saint Vincent and the Grenadines,0,4,12,"rgb(118, 78, 159)"
28237,2020-04-11,Saint Vincent and the Grenadines,0,0,12,"rgb(118, 78, 159)"
28238,2020-04-12,Saint Vincent and the Grenadines,0,0,12,"rgb(118, 78, 159)"
28239,2020-04-13,Saint Vincent and the Grenadines,0,0,12,"rgb(118, 78, 159)"
28240,2020-04-14,Saint Vincent and the Grenadines,0,0,12,"rgb(118, 78, 159)"
28241,2020-04-15,Saint Vincent and the Grenadines,0,0,12,"rgb(118, 78, 159)"
28242,2020-04-16,Saint Vincent and the Grenadines,0,0,12,"rgb(118, 78, 159)"
28243,2020-04-17,Saint Vincent and the Grenadines,0,0,12,"rgb(118, 78, 159)"
28244,2020-04-18,Saint Vincent and the Grenadines,0,0,12,"rgb(118, 78, 159)"
28245,2020-04-19,Saint Vincent and the Grenadines,0,0,12,"rgb(118, 78, 159)"
28246,2020-04-20,Saint Vincent and the Grenadines,0,0,12,"rgb(118, 78, 159)"
28247,2020-04-21,Saint Vincent and the Grenadines,0,0,12,"rgb(118, 78, 159)"
28248,2020-04-22,Saint Vincent and the Grenadines,0,0,12,"rgb(118, 78, 159)"
28249,2020-04-23,Saint Vincent and the Grenadines,0,1,13,"rgb(118, 78, 159)"
28250,2020-04-24,Saint Vincent and the Grenadines,0,0,13,"rgb(118, 78, 159)"
28251,2020-04-25,Saint Vincent and the Grenadines,0,1,14,"rgb(118, 78, 159)"
28252,2020-04-26,Saint Vincent and the Grenadines,0,0,14,"rgb(118, 78, 159)"
28253,2020-04-27,Saint Vincent and the Grenadines,0,0,14,"rgb(118, 78, 159)"
28254,2020-04-28,Saint Vincent and the Grenadines,0,1,15,"rgb(118, 78, 159)"
28255,2020-04-29,Saint Vincent and the Grenadines,0,1,16,"rgb(118, 78, 159)"
28256,2020-04-30,Saint Vincent and the Grenadines,0,0,16,"rgb(118, 78, 159)"
28257,2020-05-01,Saint Vincent and the Grenadines,0,0,16,"rgb(118, 78, 159)"
28258,2020-05-02,Saint Vincent and the Grenadines,0,0,16,"rgb(118, 78, 159)"
28259,2020-05-03,Saint Vincent and the Grenadines,0,0,16,"rgb(118, 78, 159)"
28260,2020-05-04,Saint Vincent and the Grenadines,0,1,17,"rgb(118, 78, 159)"
28261,2020-05-05,Saint Vincent and the Grenadines,0,0,17,"rgb(118, 78, 159)"
28262,2020-05-06,Saint Vincent and the Grenadines,0,0,17,"rgb(118, 78, 159)"
28263,2020-05-07,Saint Vincent and the Grenadines,0,0,17,"rgb(118, 78, 159)"
28264,2020-05-08,Saint Vincent and the Grenadines,0,0,17,"rgb(118, 78, 159)"
28265,2020-05-09,Saint Vincent and the Grenadines,0,0,17,"rgb(118, 78, 159)"
28266,2020-05-10,Saint Vincent and the Grenadines,0,0,17,"rgb(118, 78, 159)"
28267,2020-05-11,Saint Vincent and the Grenadines,0,0,17,"rgb(118, 78, 159)"
28268,2020-05-12,Saint Vincent and the Grenadines,0,0,17,"rgb(118, 78, 159)"
28269,2020-05-13,Saint Vincent and the Grenadines,0,0,17,"rgb(118, 78, 159)"
28270,2020-05-14,Saint Vincent and the Grenadines,0,0,17,"rgb(118, 78, 159)"
28271,2020-05-15,Saint Vincent and the Grenadines,0,0,17,"rgb(118, 78, 159)"
28272,2020-05-16,Saint Vincent and the Grenadines,0,0,17,"rgb(118, 78, 159)"
28273,2020-05-17,Saint Vincent and the Grenadines,0,0,17,"rgb(118, 78, 159)"
28274,2020-05-18,Saint Vincent and the Grenadines,0,0,17,"rgb(118, 78, 159)"
28275,2020-05-19,Saint Vincent and the Grenadines,0,0,17,"rgb(118, 78, 159)"
28276,2020-05-20,Saint Vincent and the Grenadines,0,0,17,"rgb(118, 78, 159)"
28277,2020-05-21,Saint Vincent and the Grenadines,0,1,18,"rgb(118, 78, 159)"
28278,2020-05-22,Saint Vincent and the Grenadines,0,0,18,"rgb(118, 78, 159)"
28279,2020-05-23,Saint Vincent and the Grenadines,0,0,18,"rgb(118, 78, 159)"
28280,2020-05-24,Saint Vincent and the Grenadines,0,0,18,"rgb(118, 78, 159)"
28281,2020-05-25,Saint Vincent and the Grenadines,0,0,18,"rgb(118, 78, 159)"
28282,2020-05-26,Saint Vincent and the Grenadines,0,0,18,"rgb(118, 78, 159)"
28283,2020-05-27,Saint Vincent and the Grenadines,0,0,18,"rgb(118, 78, 159)"
28284,2020-05-28,Saint Vincent and the Grenadines,0,0,18,"rgb(118, 78, 159)"
28285,2020-05-29,Saint Vincent and the Grenadines,0,7,25,"rgb(118, 78, 159)"
28286,2020-05-30,Saint Vincent and the Grenadines,0,1,26,"rgb(118, 78, 159)"
28287,2020-05-31,Saint Vincent and the Grenadines,0,0,26,"rgb(118, 78, 159)"
28288,2020-06-01,Saint Vincent and the Grenadines,0,0,26,"rgb(118, 78, 159)"
28289,2020-06-02,Saint Vincent and the Grenadines,0,0,26,"rgb(118, 78, 159)"
28290,2020-06-03,Saint Vincent and the Grenadines,0,0,26,"rgb(118, 78, 159)"
28291,2020-06-04,Saint Vincent and the Grenadines,0,0,26,"rgb(118, 78, 159)"
28292,2020-06-05,Saint Vincent and the Grenadines,0,0,26,"rgb(118, 78, 159)"
28293,2020-06-06,Saint Vincent and the Grenadines,0,0,26,"rgb(118, 78, 159)"
28294,2020-06-07,Saint Vincent and the Grenadines,0,0,26,"rgb(118, 78, 159)"
28295,2020-06-08,Saint Vincent and the Grenadines,0,0,26,"rgb(118, 78, 159)"
28296,2020-06-09,Saint Vincent and the Grenadines,0,1,27,"rgb(118, 78, 159)"
28297,2020-06-10,Saint Vincent and the Grenadines,0,0,27,"rgb(118, 78, 159)"
28298,2020-06-11,Saint Vincent and the Grenadines,0,0,27,"rgb(118, 78, 159)"
28299,2020-06-12,Saint Vincent and the Grenadines,0,0,27,"rgb(118, 78, 159)"
28300,2020-06-13,Saint Vincent and the Grenadines,0,0,27,"rgb(118, 78, 159)"
28301,2020-06-14,Saint Vincent and the Grenadines,0,0,27,"rgb(118, 78, 159)"
28302,2020-06-15,Saint Vincent and the Grenadines,0,0,27,"rgb(118, 78, 159)"
28303,2020-06-16,Saint Vincent and the Grenadines,0,0,27,"rgb(118, 78, 159)"
28304,2020-06-17,Saint Vincent and the Grenadines,0,2,29,"rgb(118, 78, 159)"
28305,2020-06-18,Saint Vincent and the Grenadines,0,0,29,"rgb(118, 78, 159)"
28306,2020-06-19,Saint Vincent and the Grenadines,0,0,29,"rgb(118, 78, 159)"
28307,2020-06-20,Saint Vincent and the Grenadines,0,0,29,"rgb(118, 78, 159)"
28308,2020-06-21,Saint Vincent and the Grenadines,0,0,29,"rgb(118, 78, 159)"
28309,2020-06-22,Saint Vincent and the Grenadines,0,0,29,"rgb(118, 78, 159)"
28310,2020-06-23,Saint Vincent and the Grenadines,0,0,29,"rgb(118, 78, 159)"
28311,2020-06-24,Saint Vincent and the Grenadines,0,0,29,"rgb(118, 78, 159)"
28312,2020-06-25,Saint Vincent and the Grenadines,0,0,29,"rgb(118, 78, 159)"
28313,2020-06-26,Saint Vincent and the Grenadines,0,0,29,"rgb(118, 78, 159)"
28314,2020-06-27,Saint Vincent and the Grenadines,0,0,29,"rgb(118, 78, 159)"
28315,2020-06-28,Saint Vincent and the Grenadines,0,0,29,"rgb(118, 78, 159)"
28316,2020-06-29,Saint Vincent and the Grenadines,0,0,29,"rgb(118, 78, 159)"
28317,2020-06-30,Saint Vincent and the Grenadines,0,0,29,"rgb(118, 78, 159)"
28318,2020-07-01,Saint Vincent and the Grenadines,0,0,29,"rgb(118, 78, 159)"
28319,2020-07-02,Saint Vincent and the Grenadines,0,0,29,"rgb(118, 78, 159)"
28320,2020-07-03,Saint Vincent and the Grenadines,0,0,29,"rgb(118, 78, 159)"
28321,2020-07-04,Saint Vincent and the Grenadines,0,0,29,"rgb(118, 78, 159)"
28322,2020-07-05,Saint Vincent and the Grenadines,0,0,29,"rgb(118, 78, 159)"
28323,2020-07-06,Saint Vincent and the Grenadines,0,0,29,"rgb(118, 78, 159)"
28324,2020-07-07,Saint Vincent and the Grenadines,0,0,29,"rgb(118, 78, 159)"
28325,2020-07-08,Saint Vincent and the Grenadines,0,0,29,"rgb(118, 78, 159)"
28326,2020-07-09,Saint Vincent and the Grenadines,0,0,29,"rgb(118, 78, 159)"
28327,2020-07-10,Saint Vincent and the Grenadines,0,0,29,"rgb(118, 78, 159)"
28328,2020-07-11,Saint Vincent and the Grenadines,0,0,29,"rgb(118, 78, 159)"
28329,2020-07-12,Saint Vincent and the Grenadines,0,0,29,"rgb(118, 78, 159)"
28330,2020-07-13,Saint Vincent and the Grenadines,0,6,35,"rgb(118, 78, 159)"
28331,2020-03-15,Venezuela,0,10,10,"rgb(237, 100, 90)"
28332,2020-03-16,Venezuela,0,5,15,"rgb(237, 100, 90)"
28333,2020-03-17,Venezuela,0,18,33,"rgb(237, 100, 90)"
28334,2020-03-18,Venezuela,0,0,33,"rgb(237, 100, 90)"
28335,2020-03-19,Venezuela,0,0,33,"rgb(237, 100, 90)"
28336,2020-03-20,Venezuela,0,0,33,"rgb(237, 100, 90)"
28337,2020-03-21,Venezuela,0,3,36,"rgb(237, 100, 90)"
28338,2020-03-22,Venezuela,0,0,36,"rgb(237, 100, 90)"
28339,2020-03-23,Venezuela,0,0,36,"rgb(237, 100, 90)"
28340,2020-03-24,Venezuela,0,48,84,"rgb(237, 100, 90)"
28341,2020-03-25,Venezuela,0,7,91,"rgb(237, 100, 90)"
28342,2020-03-26,Venezuela,0,15,106,"rgb(237, 100, 90)"
28343,2020-03-27,Venezuela,1,1,107,"rgb(237, 100, 90)"
28344,2020-03-28,Venezuela,0,12,119,"rgb(237, 100, 90)"
28345,2020-03-29,Venezuela,0,0,119,"rgb(237, 100, 90)"
28346,2020-03-30,Venezuela,0,0,119,"rgb(237, 100, 90)"
28347,2020-03-31,Venezuela,2,16,135,"rgb(237, 100, 90)"
28348,2020-04-01,Venezuela,0,0,135,"rgb(237, 100, 90)"
28349,2020-04-02,Venezuela,0,8,143,"rgb(237, 100, 90)"
28350,2020-04-03,Venezuela,0,1,144,"rgb(237, 100, 90)"
28351,2020-04-04,Venezuela,0,0,144,"rgb(237, 100, 90)"
28352,2020-04-05,Venezuela,2,0,144,"rgb(237, 100, 90)"
28353,2020-04-06,Venezuela,0,4,148,"rgb(237, 100, 90)"
28354,2020-04-07,Venezuela,0,11,159,"rgb(237, 100, 90)"
28355,2020-04-08,Venezuela,2,7,166,"rgb(237, 100, 90)"
28356,2020-04-09,Venezuela,1,1,167,"rgb(237, 100, 90)"
28357,2020-04-10,Venezuela,1,4,171,"rgb(237, 100, 90)"
28358,2020-04-11,Venezuela,0,4,175,"rgb(237, 100, 90)"
28359,2020-04-12,Venezuela,0,0,175,"rgb(237, 100, 90)"
28360,2020-04-13,Venezuela,0,6,181,"rgb(237, 100, 90)"
28361,2020-04-14,Venezuela,0,8,189,"rgb(237, 100, 90)"
28362,2020-04-15,Venezuela,0,4,193,"rgb(237, 100, 90)"
28363,2020-04-16,Venezuela,0,4,197,"rgb(237, 100, 90)"
28364,2020-04-17,Venezuela,0,7,204,"rgb(237, 100, 90)"
28365,2020-04-18,Venezuela,0,23,227,"rgb(237, 100, 90)"
28366,2020-04-19,Venezuela,0,0,227,"rgb(237, 100, 90)"
28367,2020-04-20,Venezuela,0,29,256,"rgb(237, 100, 90)"
28368,2020-04-21,Venezuela,0,0,256,"rgb(237, 100, 90)"
28369,2020-04-22,Venezuela,1,29,285,"rgb(237, 100, 90)"
28370,2020-04-23,Venezuela,0,3,288,"rgb(237, 100, 90)"
28371,2020-04-24,Venezuela,0,10,298,"rgb(237, 100, 90)"
28372,2020-04-25,Venezuela,0,20,318,"rgb(237, 100, 90)"
28373,2020-04-26,Venezuela,0,5,323,"rgb(237, 100, 90)"
28374,2020-04-27,Venezuela,0,2,325,"rgb(237, 100, 90)"
28375,2020-04-28,Venezuela,0,4,329,"rgb(237, 100, 90)"
28376,2020-04-29,Venezuela,0,0,329,"rgb(237, 100, 90)"
28377,2020-04-30,Venezuela,0,2,331,"rgb(237, 100, 90)"
28378,2020-05-01,Venezuela,0,2,333,"rgb(237, 100, 90)"
28379,2020-05-02,Venezuela,0,2,335,"rgb(237, 100, 90)"
28380,2020-05-03,Venezuela,0,10,345,"rgb(237, 100, 90)"
28381,2020-05-04,Venezuela,0,12,357,"rgb(237, 100, 90)"
28382,2020-05-05,Venezuela,0,4,361,"rgb(237, 100, 90)"
28383,2020-05-06,Venezuela,0,6,367,"rgb(237, 100, 90)"
28384,2020-05-07,Venezuela,0,12,379,"rgb(237, 100, 90)"
28385,2020-05-08,Venezuela,0,2,381,"rgb(237, 100, 90)"
28386,2020-05-09,Venezuela,0,7,388,"rgb(237, 100, 90)"
28387,2020-05-10,Venezuela,0,14,402,"rgb(237, 100, 90)"
28388,2020-05-11,Venezuela,0,12,414,"rgb(237, 100, 90)"
28389,2020-05-12,Venezuela,0,8,422,"rgb(237, 100, 90)"
28390,2020-05-13,Venezuela,0,1,423,"rgb(237, 100, 90)"
28391,2020-05-14,Venezuela,0,17,440,"rgb(237, 100, 90)"
28392,2020-05-15,Venezuela,0,15,455,"rgb(237, 100, 90)"
28393,2020-05-16,Venezuela,0,4,459,"rgb(237, 100, 90)"
28394,2020-05-17,Venezuela,0,45,504,"rgb(237, 100, 90)"
28395,2020-05-18,Venezuela,0,37,541,"rgb(237, 100, 90)"
28396,2020-05-19,Venezuela,0,77,618,"rgb(237, 100, 90)"
28397,2020-05-20,Venezuela,0,131,749,"rgb(237, 100, 90)"
28398,2020-05-21,Venezuela,0,75,824,"rgb(237, 100, 90)"
28399,2020-05-22,Venezuela,0,58,882,"rgb(237, 100, 90)"
28400,2020-05-23,Venezuela,0,62,944,"rgb(237, 100, 90)"
28401,2020-05-24,Venezuela,0,0,944,"rgb(237, 100, 90)"
28402,2020-05-25,Venezuela,0,177,1121,"rgb(237, 100, 90)"
28403,2020-05-26,Venezuela,0,56,1177,"rgb(237, 100, 90)"
28404,2020-05-27,Venezuela,1,34,1211,"rgb(237, 100, 90)"
28405,2020-05-28,Venezuela,0,34,1245,"rgb(237, 100, 90)"
28406,2020-05-29,Venezuela,0,82,1327,"rgb(237, 100, 90)"
28407,2020-05-30,Venezuela,3,42,1369,"rgb(237, 100, 90)"
28408,2020-05-31,Venezuela,0,90,1459,"rgb(237, 100, 90)"
28409,2020-06-01,Venezuela,0,51,1510,"rgb(237, 100, 90)"
28410,2020-06-02,Venezuela,3,152,1662,"rgb(237, 100, 90)"
28411,2020-06-03,Venezuela,1,157,1819,"rgb(237, 100, 90)"
28412,2020-06-04,Venezuela,2,133,1952,"rgb(237, 100, 90)"
28413,2020-06-05,Venezuela,0,135,2087,"rgb(237, 100, 90)"
28414,2020-06-06,Venezuela,0,58,2145,"rgb(237, 100, 90)"
28415,2020-06-07,Venezuela,2,171,2316,"rgb(237, 100, 90)"
28416,2020-06-08,Venezuela,0,61,2377,"rgb(237, 100, 90)"
28417,2020-06-09,Venezuela,0,96,2473,"rgb(237, 100, 90)"
28418,2020-06-10,Venezuela,1,159,2632,"rgb(237, 100, 90)"
28419,2020-06-11,Venezuela,0,106,2738,"rgb(237, 100, 90)"
28420,2020-06-12,Venezuela,0,76,2814,"rgb(237, 100, 90)"
28421,2020-06-13,Venezuela,0,65,2879,"rgb(237, 100, 90)"
28422,2020-06-14,Venezuela,1,25,2904,"rgb(237, 100, 90)"
28423,2020-06-15,Venezuela,1,74,2978,"rgb(237, 100, 90)"
28424,2020-06-16,Venezuela,1,84,3062,"rgb(237, 100, 90)"
28425,2020-06-17,Venezuela,1,88,3150,"rgb(237, 100, 90)"
28426,2020-06-19,Venezuela,1,334,3484,"rgb(237, 100, 90)"
28427,2020-06-20,Venezuela,2,107,3591,"rgb(237, 100, 90)"
28428,2020-06-21,Venezuela,3,199,3790,"rgb(237, 100, 90)"
28429,2020-06-22,Venezuela,0,128,3918,"rgb(237, 100, 90)"
28430,2020-06-23,Venezuela,2,130,4048,"rgb(237, 100, 90)"
28431,2020-06-24,Venezuela,0,138,4186,"rgb(237, 100, 90)"
28432,2020-06-25,Venezuela,3,179,4365,"rgb(237, 100, 90)"
28433,2020-06-26,Venezuela,1,198,4563,"rgb(237, 100, 90)"
28434,2020-06-27,Venezuela,2,216,4779,"rgb(237, 100, 90)"
28435,2020-06-28,Venezuela,1,351,5130,"rgb(237, 100, 90)"
28436,2020-06-29,Venezuela,2,167,5297,"rgb(237, 100, 90)"
28437,2020-06-30,Venezuela,4,233,5530,"rgb(237, 100, 90)"
28438,2020-07-01,Venezuela,3,302,5832,"rgb(237, 100, 90)"
28439,2020-07-02,Venezuela,3,230,6062,"rgb(237, 100, 90)"
28440,2020-07-03,Venezuela,3,211,6273,"rgb(237, 100, 90)"
28441,2020-07-04,Venezuela,2,264,6537,"rgb(237, 100, 90)"
28442,2020-07-05,Venezuela,3,213,6750,"rgb(237, 100, 90)"
28443,2020-07-06,Venezuela,2,419,7169,"rgb(237, 100, 90)"
28444,2020-07-07,Venezuela,4,242,7411,"rgb(237, 100, 90)"
28445,2020-07-08,Venezuela,3,282,7693,"rgb(237, 100, 90)"
28446,2020-07-09,Venezuela,4,317,8010,"rgb(237, 100, 90)"
28447,2020-07-10,Venezuela,5,362,8372,"rgb(237, 100, 90)"
28448,2020-07-11,Venezuela,3,431,8803,"rgb(237, 100, 90)"
28449,2020-07-12,Venezuela,2,375,9178,"rgb(237, 100, 90)"
28450,2020-07-13,Venezuela,4,287,9465,"rgb(237, 100, 90)"
28451,2020-03-27,British Virgin Islands,0,2,2,"rgb(165, 170, 153)"
28452,2020-03-28,British Virgin Islands,0,0,2,"rgb(165, 170, 153)"
28453,2020-03-29,British Virgin Islands,0,0,2,"rgb(165, 170, 153)"
28454,2020-03-30,British Virgin Islands,0,0,2,"rgb(165, 170, 153)"
28455,2020-03-31,British Virgin Islands,0,1,3,"rgb(165, 170, 153)"
28456,2020-04-01,British Virgin Islands,0,0,3,"rgb(165, 170, 153)"
28457,2020-04-02,British Virgin Islands,0,0,3,"rgb(165, 170, 153)"
28458,2020-04-03,British Virgin Islands,0,0,3,"rgb(165, 170, 153)"
28459,2020-04-04,British Virgin Islands,0,0,3,"rgb(165, 170, 153)"
28460,2020-04-05,British Virgin Islands,0,0,3,"rgb(165, 170, 153)"
28461,2020-04-06,British Virgin Islands,0,0,3,"rgb(165, 170, 153)"
28462,2020-04-07,British Virgin Islands,0,0,3,"rgb(165, 170, 153)"
28463,2020-04-08,British Virgin Islands,0,0,3,"rgb(165, 170, 153)"
28464,2020-04-09,British Virgin Islands,0,0,3,"rgb(165, 170, 153)"
28465,2020-04-10,British Virgin Islands,0,0,3,"rgb(165, 170, 153)"
28466,2020-04-11,British Virgin Islands,0,0,3,"rgb(165, 170, 153)"
28467,2020-04-12,British Virgin Islands,0,0,3,"rgb(165, 170, 153)"
28468,2020-04-13,British Virgin Islands,0,0,3,"rgb(165, 170, 153)"
28469,2020-04-14,British Virgin Islands,0,0,3,"rgb(165, 170, 153)"
28470,2020-04-15,British Virgin Islands,0,0,3,"rgb(165, 170, 153)"
28471,2020-04-16,British Virgin Islands,0,0,3,"rgb(165, 170, 153)"
28472,2020-04-17,British Virgin Islands,0,0,3,"rgb(165, 170, 153)"
28473,2020-04-18,British Virgin Islands,0,0,3,"rgb(165, 170, 153)"
28474,2020-04-19,British Virgin Islands,0,0,3,"rgb(165, 170, 153)"
28475,2020-04-20,British Virgin Islands,1,1,4,"rgb(165, 170, 153)"
28476,2020-04-21,British Virgin Islands,0,1,5,"rgb(165, 170, 153)"
28477,2020-04-22,British Virgin Islands,0,0,5,"rgb(165, 170, 153)"
28478,2020-04-23,British Virgin Islands,0,0,5,"rgb(165, 170, 153)"
28479,2020-04-24,British Virgin Islands,0,0,5,"rgb(165, 170, 153)"
28480,2020-04-25,British Virgin Islands,0,1,6,"rgb(165, 170, 153)"
28481,2020-04-26,British Virgin Islands,0,0,6,"rgb(165, 170, 153)"
28482,2020-04-27,British Virgin Islands,0,0,6,"rgb(165, 170, 153)"
28483,2020-04-28,British Virgin Islands,0,0,6,"rgb(165, 170, 153)"
28484,2020-04-29,British Virgin Islands,0,0,6,"rgb(165, 170, 153)"
28485,2020-04-30,British Virgin Islands,0,0,6,"rgb(165, 170, 153)"
28486,2020-05-01,British Virgin Islands,0,0,6,"rgb(165, 170, 153)"
28487,2020-05-02,British Virgin Islands,0,0,6,"rgb(165, 170, 153)"
28488,2020-05-03,British Virgin Islands,0,0,6,"rgb(165, 170, 153)"
28489,2020-05-04,British Virgin Islands,0,0,6,"rgb(165, 170, 153)"
28490,2020-05-05,British Virgin Islands,0,1,7,"rgb(165, 170, 153)"
28491,2020-05-06,British Virgin Islands,0,0,7,"rgb(165, 170, 153)"
28492,2020-05-07,British Virgin Islands,0,0,7,"rgb(165, 170, 153)"
28493,2020-05-08,British Virgin Islands,0,0,7,"rgb(165, 170, 153)"
28494,2020-05-09,British Virgin Islands,0,0,7,"rgb(165, 170, 153)"
28495,2020-05-10,British Virgin Islands,0,0,7,"rgb(165, 170, 153)"
28496,2020-05-11,British Virgin Islands,0,0,7,"rgb(165, 170, 153)"
28497,2020-05-12,British Virgin Islands,0,0,7,"rgb(165, 170, 153)"
28498,2020-05-13,British Virgin Islands,0,0,7,"rgb(165, 170, 153)"
28499,2020-05-14,British Virgin Islands,0,0,7,"rgb(165, 170, 153)"
28500,2020-05-15,British Virgin Islands,0,1,8,"rgb(165, 170, 153)"
28501,2020-05-16,British Virgin Islands,0,0,8,"rgb(165, 170, 153)"
28502,2020-05-17,British Virgin Islands,0,0,8,"rgb(165, 170, 153)"
28503,2020-05-18,British Virgin Islands,0,0,8,"rgb(165, 170, 153)"
28504,2020-05-19,British Virgin Islands,0,0,8,"rgb(165, 170, 153)"
28505,2020-05-20,British Virgin Islands,0,0,8,"rgb(165, 170, 153)"
28506,2020-05-21,British Virgin Islands,0,0,8,"rgb(165, 170, 153)"
28507,2020-05-22,British Virgin Islands,0,0,8,"rgb(165, 170, 153)"
28508,2020-05-23,British Virgin Islands,0,0,8,"rgb(165, 170, 153)"
28509,2020-05-24,British Virgin Islands,0,0,8,"rgb(165, 170, 153)"
28510,2020-05-25,British Virgin Islands,0,0,8,"rgb(165, 170, 153)"
28511,2020-05-26,British Virgin Islands,0,0,8,"rgb(165, 170, 153)"
28512,2020-05-27,British Virgin Islands,0,0,8,"rgb(165, 170, 153)"
28513,2020-05-28,British Virgin Islands,0,0,8,"rgb(165, 170, 153)"
28514,2020-05-29,British Virgin Islands,0,0,8,"rgb(165, 170, 153)"
28515,2020-05-30,British Virgin Islands,0,0,8,"rgb(165, 170, 153)"
28516,2020-05-31,British Virgin Islands,0,0,8,"rgb(165, 170, 153)"
28517,2020-06-01,British Virgin Islands,0,0,8,"rgb(165, 170, 153)"
28518,2020-06-02,British Virgin Islands,0,0,8,"rgb(165, 170, 153)"
28519,2020-06-03,British Virgin Islands,0,0,8,"rgb(165, 170, 153)"
28520,2020-06-04,British Virgin Islands,0,0,8,"rgb(165, 170, 153)"
28521,2020-06-05,British Virgin Islands,0,0,8,"rgb(165, 170, 153)"
28522,2020-06-06,British Virgin Islands,0,0,8,"rgb(165, 170, 153)"
28523,2020-06-07,British Virgin Islands,0,0,8,"rgb(165, 170, 153)"
28524,2020-06-08,British Virgin Islands,0,0,8,"rgb(165, 170, 153)"
28525,2020-06-09,British Virgin Islands,0,0,8,"rgb(165, 170, 153)"
28526,2020-06-10,British Virgin Islands,0,0,8,"rgb(165, 170, 153)"
28527,2020-06-11,British Virgin Islands,0,0,8,"rgb(165, 170, 153)"
28528,2020-06-12,British Virgin Islands,0,0,8,"rgb(165, 170, 153)"
28529,2020-06-13,British Virgin Islands,0,0,8,"rgb(165, 170, 153)"
28530,2020-06-14,British Virgin Islands,0,0,8,"rgb(165, 170, 153)"
28531,2020-06-15,British Virgin Islands,0,0,8,"rgb(165, 170, 153)"
28532,2020-06-16,British Virgin Islands,0,0,8,"rgb(165, 170, 153)"
28533,2020-06-17,British Virgin Islands,0,0,8,"rgb(165, 170, 153)"
28534,2020-06-18,British Virgin Islands,0,0,8,"rgb(165, 170, 153)"
28535,2020-06-19,British Virgin Islands,0,0,8,"rgb(165, 170, 153)"
28536,2020-06-20,British Virgin Islands,0,0,8,"rgb(165, 170, 153)"
28537,2020-06-21,British Virgin Islands,0,0,8,"rgb(165, 170, 153)"
28538,2020-06-22,British Virgin Islands,0,0,8,"rgb(165, 170, 153)"
28539,2020-06-23,British Virgin Islands,0,0,8,"rgb(165, 170, 153)"
28540,2020-06-24,British Virgin Islands,0,0,8,"rgb(165, 170, 153)"
28541,2020-06-25,British Virgin Islands,0,0,8,"rgb(165, 170, 153)"
28542,2020-06-26,British Virgin Islands,0,0,8,"rgb(165, 170, 153)"
28543,2020-06-27,British Virgin Islands,0,0,8,"rgb(165, 170, 153)"
28544,2020-06-28,British Virgin Islands,0,0,8,"rgb(165, 170, 153)"
28545,2020-06-29,British Virgin Islands,0,0,8,"rgb(165, 170, 153)"
28546,2020-06-30,British Virgin Islands,0,0,8,"rgb(165, 170, 153)"
28547,2020-07-01,British Virgin Islands,0,0,8,"rgb(165, 170, 153)"
28548,2020-07-02,British Virgin Islands,0,0,8,"rgb(165, 170, 153)"
28549,2020-07-03,British Virgin Islands,0,0,8,"rgb(165, 170, 153)"
28550,2020-07-04,British Virgin Islands,0,0,8,"rgb(165, 170, 153)"
28551,2020-07-05,British Virgin Islands,0,0,8,"rgb(165, 170, 153)"
28552,2020-07-06,British Virgin Islands,0,0,8,"rgb(165, 170, 153)"
28553,2020-07-07,British Virgin Islands,0,0,8,"rgb(165, 170, 153)"
28554,2020-07-08,British Virgin Islands,0,0,8,"rgb(165, 170, 153)"
28555,2020-07-09,British Virgin Islands,0,0,8,"rgb(165, 170, 153)"
28556,2020-07-10,British Virgin Islands,0,0,8,"rgb(165, 170, 153)"
28557,2020-07-11,British Virgin Islands,0,0,8,"rgb(165, 170, 153)"
28558,2020-07-12,British Virgin Islands,0,0,8,"rgb(165, 170, 153)"
28559,2020-07-13,British Virgin Islands,0,0,8,"rgb(165, 170, 153)"
28560,2020-03-24,U.S. Virgin Islands,0,17,17,"rgb(27,158,119)"
28561,2020-03-25,U.S. Virgin Islands,0,0,17,"rgb(27,158,119)"
28562,2020-03-26,U.S. Virgin Islands,0,0,17,"rgb(27,158,119)"
28563,2020-03-27,U.S. Virgin Islands,0,0,17,"rgb(27,158,119)"
28564,2020-03-28,U.S. Virgin Islands,0,2,19,"rgb(27,158,119)"
28565,2020-03-29,U.S. Virgin Islands,0,3,22,"rgb(27,158,119)"
28566,2020-03-30,U.S. Virgin Islands,0,8,30,"rgb(27,158,119)"
28567,2020-04-01,U.S. Virgin Islands,0,0,30,"rgb(27,158,119)"
28568,2020-04-02,U.S. Virgin Islands,0,0,30,"rgb(27,158,119)"
28569,2020-04-03,U.S. Virgin Islands,0,3,33,"rgb(27,158,119)"
28570,2020-04-04,U.S. Virgin Islands,0,7,40,"rgb(27,158,119)"
28571,2020-04-05,U.S. Virgin Islands,0,0,40,"rgb(27,158,119)"
28572,2020-04-06,U.S. Virgin Islands,1,2,42,"rgb(27,158,119)"
28573,2020-04-07,U.S. Virgin Islands,0,0,42,"rgb(27,158,119)"
28574,2020-04-08,U.S. Virgin Islands,0,3,45,"rgb(27,158,119)"
28575,2020-04-09,U.S. Virgin Islands,0,0,45,"rgb(27,158,119)"
28576,2020-04-10,U.S. Virgin Islands,0,5,50,"rgb(27,158,119)"
28577,2020-04-11,U.S. Virgin Islands,0,0,50,"rgb(27,158,119)"
28578,2020-04-12,U.S. Virgin Islands,0,1,51,"rgb(27,158,119)"
28579,2020-04-13,U.S. Virgin Islands,0,0,51,"rgb(27,158,119)"
28580,2020-04-14,U.S. Virgin Islands,0,0,51,"rgb(27,158,119)"
28581,2020-04-15,U.S. Virgin Islands,0,0,51,"rgb(27,158,119)"
28582,2020-04-16,U.S. Virgin Islands,0,0,51,"rgb(27,158,119)"
28583,2020-04-17,U.S. Virgin Islands,0,0,51,"rgb(27,158,119)"
28584,2020-04-18,U.S. Virgin Islands,1,0,51,"rgb(27,158,119)"
28585,2020-04-19,U.S. Virgin Islands,1,2,53,"rgb(27,158,119)"
28586,2020-04-20,U.S. Virgin Islands,0,0,53,"rgb(27,158,119)"
28587,2020-04-21,U.S. Virgin Islands,0,1,54,"rgb(27,158,119)"
28588,2020-04-22,U.S. Virgin Islands,0,0,54,"rgb(27,158,119)"
28589,2020-04-23,U.S. Virgin Islands,0,0,54,"rgb(27,158,119)"
28590,2020-04-24,U.S. Virgin Islands,0,0,54,"rgb(27,158,119)"
28591,2020-04-25,U.S. Virgin Islands,0,0,54,"rgb(27,158,119)"
28592,2020-04-26,U.S. Virgin Islands,0,1,55,"rgb(27,158,119)"
28593,2020-04-27,U.S. Virgin Islands,0,0,55,"rgb(27,158,119)"
28594,2020-04-28,U.S. Virgin Islands,1,4,59,"rgb(27,158,119)"
28595,2020-04-29,U.S. Virgin Islands,0,0,59,"rgb(27,158,119)"
28596,2020-04-30,U.S. Virgin Islands,0,7,66,"rgb(27,158,119)"
28597,2020-05-01,U.S. Virgin Islands,0,0,66,"rgb(27,158,119)"
28598,2020-05-02,U.S. Virgin Islands,0,0,66,"rgb(27,158,119)"
28599,2020-05-03,U.S. Virgin Islands,0,0,66,"rgb(27,158,119)"
28600,2020-05-04,U.S. Virgin Islands,0,0,66,"rgb(27,158,119)"
28601,2020-05-05,U.S. Virgin Islands,0,0,66,"rgb(27,158,119)"
28602,2020-05-06,U.S. Virgin Islands,0,0,66,"rgb(27,158,119)"
28603,2020-05-07,U.S. Virgin Islands,0,0,66,"rgb(27,158,119)"
28604,2020-05-08,U.S. Virgin Islands,0,0,66,"rgb(27,158,119)"
28605,2020-05-09,U.S. Virgin Islands,0,2,68,"rgb(27,158,119)"
28606,2020-05-10,U.S. Virgin Islands,0,1,69,"rgb(27,158,119)"
28607,2020-05-11,U.S. Virgin Islands,0,0,69,"rgb(27,158,119)"
28608,2020-05-12,U.S. Virgin Islands,1,0,69,"rgb(27,158,119)"
28609,2020-05-13,U.S. Virgin Islands,0,0,69,"rgb(27,158,119)"
28610,2020-05-14,U.S. Virgin Islands,1,0,69,"rgb(27,158,119)"
28611,2020-05-15,U.S. Virgin Islands,0,0,69,"rgb(27,158,119)"
28612,2020-05-16,U.S. Virgin Islands,0,0,69,"rgb(27,158,119)"
28613,2020-05-17,U.S. Virgin Islands,0,0,69,"rgb(27,158,119)"
28614,2020-05-18,U.S. Virgin Islands,0,0,69,"rgb(27,158,119)"
28615,2020-05-19,U.S. Virgin Islands,0,0,69,"rgb(27,158,119)"
28616,2020-05-20,U.S. Virgin Islands,0,0,69,"rgb(27,158,119)"
28617,2020-05-21,U.S. Virgin Islands,0,0,69,"rgb(27,158,119)"
28618,2020-05-22,U.S. Virgin Islands,0,0,69,"rgb(27,158,119)"
28619,2020-05-23,U.S. Virgin Islands,0,0,69,"rgb(27,158,119)"
28620,2020-05-24,U.S. Virgin Islands,0,0,69,"rgb(27,158,119)"
28621,2020-05-25,U.S. Virgin Islands,0,0,69,"rgb(27,158,119)"
28622,2020-05-26,U.S. Virgin Islands,0,0,69,"rgb(27,158,119)"
28623,2020-05-27,U.S. Virgin Islands,0,0,69,"rgb(27,158,119)"
28624,2020-05-28,U.S. Virgin Islands,0,0,69,"rgb(27,158,119)"
28625,2020-05-29,U.S. Virgin Islands,0,0,69,"rgb(27,158,119)"
28626,2020-05-30,U.S. Virgin Islands,0,0,69,"rgb(27,158,119)"
28627,2020-05-31,U.S. Virgin Islands,0,0,69,"rgb(27,158,119)"
28628,2020-06-01,U.S. Virgin Islands,0,0,69,"rgb(27,158,119)"
28629,2020-06-02,U.S. Virgin Islands,0,1,70,"rgb(27,158,119)"
28630,2020-06-03,U.S. Virgin Islands,0,0,70,"rgb(27,158,119)"
28631,2020-06-04,U.S. Virgin Islands,0,0,70,"rgb(27,158,119)"
28632,2020-06-05,U.S. Virgin Islands,0,1,71,"rgb(27,158,119)"
28633,2020-06-06,U.S. Virgin Islands,0,0,71,"rgb(27,158,119)"
28634,2020-06-07,U.S. Virgin Islands,0,0,71,"rgb(27,158,119)"
28635,2020-06-08,U.S. Virgin Islands,0,0,71,"rgb(27,158,119)"
28636,2020-06-09,U.S. Virgin Islands,0,0,71,"rgb(27,158,119)"
28637,2020-06-10,U.S. Virgin Islands,0,0,71,"rgb(27,158,119)"
28638,2020-06-11,U.S. Virgin Islands,0,1,72,"rgb(27,158,119)"
28639,2020-06-12,U.S. Virgin Islands,0,0,72,"rgb(27,158,119)"
28640,2020-06-13,U.S. Virgin Islands,0,0,72,"rgb(27,158,119)"
28641,2020-06-14,U.S. Virgin Islands,0,0,72,"rgb(27,158,119)"
28642,2020-06-15,U.S. Virgin Islands,0,1,73,"rgb(27,158,119)"
28643,2020-06-16,U.S. Virgin Islands,0,0,73,"rgb(27,158,119)"
28644,2020-06-17,U.S. Virgin Islands,0,0,73,"rgb(27,158,119)"
28645,2020-06-18,U.S. Virgin Islands,0,0,73,"rgb(27,158,119)"
28646,2020-06-19,U.S. Virgin Islands,0,0,73,"rgb(27,158,119)"
28647,2020-06-20,U.S. Virgin Islands,0,1,74,"rgb(27,158,119)"
28648,2020-06-21,U.S. Virgin Islands,0,0,74,"rgb(27,158,119)"
28649,2020-06-22,U.S. Virgin Islands,0,2,76,"rgb(27,158,119)"
28650,2020-06-23,U.S. Virgin Islands,0,0,76,"rgb(27,158,119)"
28651,2020-06-24,U.S. Virgin Islands,0,0,76,"rgb(27,158,119)"
28652,2020-06-25,U.S. Virgin Islands,0,4,80,"rgb(27,158,119)"
28653,2020-06-26,U.S. Virgin Islands,0,1,81,"rgb(27,158,119)"
28654,2020-06-27,U.S. Virgin Islands,0,0,81,"rgb(27,158,119)"
28655,2020-06-28,U.S. Virgin Islands,0,0,81,"rgb(27,158,119)"
28656,2020-06-29,U.S. Virgin Islands,0,0,81,"rgb(27,158,119)"
28657,2020-06-30,U.S. Virgin Islands,0,3,84,"rgb(27,158,119)"
28658,2020-07-01,U.S. Virgin Islands,0,0,84,"rgb(27,158,119)"
28659,2020-07-02,U.S. Virgin Islands,0,8,92,"rgb(27,158,119)"
28660,2020-07-03,U.S. Virgin Islands,0,6,98,"rgb(27,158,119)"
28661,2020-07-04,U.S. Virgin Islands,0,13,111,"rgb(27,158,119)"
28662,2020-07-05,U.S. Virgin Islands,0,0,111,"rgb(27,158,119)"
28663,2020-07-06,U.S. Virgin Islands,0,1,112,"rgb(27,158,119)"
28664,2020-07-07,U.S. Virgin Islands,0,4,116,"rgb(27,158,119)"
28665,2020-07-08,U.S. Virgin Islands,0,6,122,"rgb(27,158,119)"
28666,2020-07-09,U.S. Virgin Islands,0,22,144,"rgb(27,158,119)"
28667,2020-07-10,U.S. Virgin Islands,0,9,153,"rgb(27,158,119)"
28668,2020-07-11,U.S. Virgin Islands,0,14,167,"rgb(27,158,119)"
28669,2020-07-12,U.S. Virgin Islands,0,14,181,"rgb(27,158,119)"
28670,2020-07-13,U.S. Virgin Islands,0,0,181,"rgb(27,158,119)"
28671,2019-12-31,Vietnam,0,0,0,"rgb(217,95,2)"
28672,2020-01-01,Vietnam,0,0,0,"rgb(217,95,2)"
28673,2020-01-02,Vietnam,0,0,0,"rgb(217,95,2)"
28674,2020-01-03,Vietnam,0,0,0,"rgb(217,95,2)"
28675,2020-01-04,Vietnam,0,0,0,"rgb(217,95,2)"
28676,2020-01-05,Vietnam,0,0,0,"rgb(217,95,2)"
28677,2020-01-06,Vietnam,0,0,0,"rgb(217,95,2)"
28678,2020-01-07,Vietnam,0,0,0,"rgb(217,95,2)"
28679,2020-01-08,Vietnam,0,0,0,"rgb(217,95,2)"
28680,2020-01-09,Vietnam,0,0,0,"rgb(217,95,2)"
28681,2020-01-10,Vietnam,0,0,0,"rgb(217,95,2)"
28682,2020-01-11,Vietnam,0,0,0,"rgb(217,95,2)"
28683,2020-01-12,Vietnam,0,0,0,"rgb(217,95,2)"
28684,2020-01-13,Vietnam,0,0,0,"rgb(217,95,2)"
28685,2020-01-14,Vietnam,0,0,0,"rgb(217,95,2)"
28686,2020-01-15,Vietnam,0,0,0,"rgb(217,95,2)"
28687,2020-01-16,Vietnam,0,0,0,"rgb(217,95,2)"
28688,2020-01-17,Vietnam,0,0,0,"rgb(217,95,2)"
28689,2020-01-18,Vietnam,0,0,0,"rgb(217,95,2)"
28690,2020-01-19,Vietnam,0,0,0,"rgb(217,95,2)"
28691,2020-01-20,Vietnam,0,0,0,"rgb(217,95,2)"
28692,2020-01-21,Vietnam,0,0,0,"rgb(217,95,2)"
28693,2020-01-22,Vietnam,0,0,0,"rgb(217,95,2)"
28694,2020-01-23,Vietnam,0,0,0,"rgb(217,95,2)"
28695,2020-01-24,Vietnam,0,2,2,"rgb(217,95,2)"
28696,2020-01-25,Vietnam,0,0,2,"rgb(217,95,2)"
28697,2020-01-26,Vietnam,0,0,2,"rgb(217,95,2)"
28698,2020-01-27,Vietnam,0,0,2,"rgb(217,95,2)"
28699,2020-01-28,Vietnam,0,0,2,"rgb(217,95,2)"
28700,2020-01-29,Vietnam,0,0,2,"rgb(217,95,2)"
28701,2020-01-30,Vietnam,0,0,2,"rgb(217,95,2)"
28702,2020-01-31,Vietnam,0,3,5,"rgb(217,95,2)"
28703,2020-02-01,Vietnam,0,0,5,"rgb(217,95,2)"
28704,2020-02-02,Vietnam,0,2,7,"rgb(217,95,2)"
28705,2020-02-03,Vietnam,0,1,8,"rgb(217,95,2)"
28706,2020-02-04,Vietnam,0,1,9,"rgb(217,95,2)"
28707,2020-02-05,Vietnam,0,1,10,"rgb(217,95,2)"
28708,2020-02-06,Vietnam,0,0,10,"rgb(217,95,2)"
28709,2020-02-07,Vietnam,0,2,12,"rgb(217,95,2)"
28710,2020-02-08,Vietnam,0,1,13,"rgb(217,95,2)"
28711,2020-02-09,Vietnam,0,1,14,"rgb(217,95,2)"
28712,2020-02-10,Vietnam,0,0,14,"rgb(217,95,2)"
28713,2020-02-11,Vietnam,0,1,15,"rgb(217,95,2)"
28714,2020-02-12,Vietnam,0,0,15,"rgb(217,95,2)"
28715,2020-02-13,Vietnam,0,1,16,"rgb(217,95,2)"
28716,2020-02-14,Vietnam,0,0,16,"rgb(217,95,2)"
28717,2020-02-15,Vietnam,0,0,16,"rgb(217,95,2)"
28718,2020-02-16,Vietnam,0,0,16,"rgb(217,95,2)"
28719,2020-02-17,Vietnam,0,0,16,"rgb(217,95,2)"
28720,2020-02-18,Vietnam,0,0,16,"rgb(217,95,2)"
28721,2020-02-19,Vietnam,0,0,16,"rgb(217,95,2)"
28722,2020-02-20,Vietnam,0,0,16,"rgb(217,95,2)"
28723,2020-02-21,Vietnam,0,0,16,"rgb(217,95,2)"
28724,2020-02-22,Vietnam,0,0,16,"rgb(217,95,2)"
28725,2020-02-23,Vietnam,0,0,16,"rgb(217,95,2)"
28726,2020-02-24,Vietnam,0,0,16,"rgb(217,95,2)"
28727,2020-02-25,Vietnam,0,0,16,"rgb(217,95,2)"
28728,2020-02-26,Vietnam,0,0,16,"rgb(217,95,2)"
28729,2020-02-27,Vietnam,0,0,16,"rgb(217,95,2)"
28730,2020-02-28,Vietnam,0,0,16,"rgb(217,95,2)"
28731,2020-02-29,Vietnam,0,0,16,"rgb(217,95,2)"
28732,2020-03-01,Vietnam,0,0,16,"rgb(217,95,2)"
28733,2020-03-02,Vietnam,0,0,16,"rgb(217,95,2)"
28734,2020-03-07,Vietnam,0,1,17,"rgb(217,95,2)"
28735,2020-03-08,Vietnam,0,4,21,"rgb(217,95,2)"
28736,2020-03-09,Vietnam,0,9,30,"rgb(217,95,2)"
28737,2020-03-10,Vietnam,0,4,34,"rgb(217,95,2)"
28738,2020-03-11,Vietnam,0,4,38,"rgb(217,95,2)"
28739,2020-03-12,Vietnam,0,1,39,"rgb(217,95,2)"
28740,2020-03-13,Vietnam,0,5,44,"rgb(217,95,2)"
28741,2020-03-14,Vietnam,0,9,53,"rgb(217,95,2)"
28742,2020-03-15,Vietnam,0,0,53,"rgb(217,95,2)"
28743,2020-03-16,Vietnam,0,4,57,"rgb(217,95,2)"
28744,2020-03-17,Vietnam,0,4,61,"rgb(217,95,2)"
28745,2020-03-18,Vietnam,0,7,68,"rgb(217,95,2)"
28746,2020-03-19,Vietnam,0,8,76,"rgb(217,95,2)"
28747,2020-03-20,Vietnam,0,11,87,"rgb(217,95,2)"
28748,2020-03-21,Vietnam,0,1,88,"rgb(217,95,2)"
28749,2020-03-22,Vietnam,0,7,95,"rgb(217,95,2)"
28750,2020-03-23,Vietnam,0,26,121,"rgb(217,95,2)"
28751,2020-03-24,Vietnam,0,11,132,"rgb(217,95,2)"
28752,2020-03-25,Vietnam,0,5,137,"rgb(217,95,2)"
28753,2020-03-26,Vietnam,0,16,153,"rgb(217,95,2)"
28754,2020-03-27,Vietnam,0,10,163,"rgb(217,95,2)"
28755,2020-03-28,Vietnam,0,8,171,"rgb(217,95,2)"
28756,2020-03-29,Vietnam,0,17,188,"rgb(217,95,2)"
28757,2020-03-30,Vietnam,0,15,203,"rgb(217,95,2)"
28758,2020-03-31,Vietnam,0,3,206,"rgb(217,95,2)"
28759,2020-04-01,Vietnam,0,6,212,"rgb(217,95,2)"
28760,2020-04-02,Vietnam,0,21,233,"rgb(217,95,2)"
28761,2020-04-03,Vietnam,0,3,236,"rgb(217,95,2)"
28762,2020-04-04,Vietnam,0,4,240,"rgb(217,95,2)"
28763,2020-04-05,Vietnam,0,1,241,"rgb(217,95,2)"
28764,2020-04-06,Vietnam,0,4,245,"rgb(217,95,2)"
28765,2020-04-07,Vietnam,0,6,251,"rgb(217,95,2)"
28766,2020-04-08,Vietnam,0,0,251,"rgb(217,95,2)"
28767,2020-04-09,Vietnam,0,4,255,"rgb(217,95,2)"
28768,2020-04-10,Vietnam,0,2,257,"rgb(217,95,2)"
28769,2020-04-11,Vietnam,0,1,258,"rgb(217,95,2)"
28770,2020-04-12,Vietnam,0,4,262,"rgb(217,95,2)"
28771,2020-04-13,Vietnam,0,2,264,"rgb(217,95,2)"
28772,2020-04-14,Vietnam,0,3,267,"rgb(217,95,2)"
28773,2020-04-15,Vietnam,0,1,268,"rgb(217,95,2)"
28774,2020-04-16,Vietnam,0,0,268,"rgb(217,95,2)"
28775,2020-04-17,Vietnam,0,0,268,"rgb(217,95,2)"
28776,2020-04-18,Vietnam,0,0,268,"rgb(217,95,2)"
28777,2020-04-19,Vietnam,0,0,268,"rgb(217,95,2)"
28778,2020-04-20,Vietnam,0,0,268,"rgb(217,95,2)"
28779,2020-04-21,Vietnam,0,0,268,"rgb(217,95,2)"
28780,2020-04-22,Vietnam,0,0,268,"rgb(217,95,2)"
28781,2020-04-23,Vietnam,0,0,268,"rgb(217,95,2)"
28782,2020-04-24,Vietnam,0,2,270,"rgb(217,95,2)"
28783,2020-04-25,Vietnam,0,0,270,"rgb(217,95,2)"
28784,2020-04-26,Vietnam,0,0,270,"rgb(217,95,2)"
28785,2020-04-27,Vietnam,0,0,270,"rgb(217,95,2)"
28786,2020-04-28,Vietnam,0,0,270,"rgb(217,95,2)"
28787,2020-04-29,Vietnam,0,0,270,"rgb(217,95,2)"
28788,2020-04-30,Vietnam,0,0,270,"rgb(217,95,2)"
28789,2020-05-01,Vietnam,0,0,270,"rgb(217,95,2)"
28790,2020-05-02,Vietnam,0,0,270,"rgb(217,95,2)"
28791,2020-05-03,Vietnam,0,0,270,"rgb(217,95,2)"
28792,2020-05-04,Vietnam,0,1,271,"rgb(217,95,2)"
28793,2020-05-05,Vietnam,0,0,271,"rgb(217,95,2)"
28794,2020-05-06,Vietnam,0,0,271,"rgb(217,95,2)"
28795,2020-05-07,Vietnam,0,0,271,"rgb(217,95,2)"
28796,2020-05-08,Vietnam,0,17,288,"rgb(217,95,2)"
28797,2020-05-09,Vietnam,0,0,288,"rgb(217,95,2)"
28798,2020-05-10,Vietnam,0,0,288,"rgb(217,95,2)"
28799,2020-05-11,Vietnam,0,0,288,"rgb(217,95,2)"
28800,2020-05-12,Vietnam,0,0,288,"rgb(217,95,2)"
28801,2020-05-13,Vietnam,0,0,288,"rgb(217,95,2)"
28802,2020-05-14,Vietnam,0,0,288,"rgb(217,95,2)"
28803,2020-05-15,Vietnam,0,24,312,"rgb(217,95,2)"
28804,2020-05-16,Vietnam,0,1,313,"rgb(217,95,2)"
28805,2020-05-17,Vietnam,0,5,318,"rgb(217,95,2)"
28806,2020-05-18,Vietnam,0,2,320,"rgb(217,95,2)"
28807,2020-05-19,Vietnam,0,4,324,"rgb(217,95,2)"
28808,2020-05-20,Vietnam,0,0,324,"rgb(217,95,2)"
28809,2020-05-21,Vietnam,0,0,324,"rgb(217,95,2)"
28810,2020-05-22,Vietnam,0,0,324,"rgb(217,95,2)"
28811,2020-05-23,Vietnam,0,0,324,"rgb(217,95,2)"
28812,2020-05-24,Vietnam,0,0,324,"rgb(217,95,2)"
28813,2020-05-25,Vietnam,0,1,325,"rgb(217,95,2)"
28814,2020-05-26,Vietnam,0,1,326,"rgb(217,95,2)"
28815,2020-05-27,Vietnam,0,1,327,"rgb(217,95,2)"
28816,2020-05-28,Vietnam,0,0,327,"rgb(217,95,2)"
28817,2020-05-29,Vietnam,0,0,327,"rgb(217,95,2)"
28818,2020-05-30,Vietnam,0,0,327,"rgb(217,95,2)"
28819,2020-05-31,Vietnam,0,0,327,"rgb(217,95,2)"
28820,2020-06-01,Vietnam,0,1,328,"rgb(217,95,2)"
28821,2020-06-02,Vietnam,0,0,328,"rgb(217,95,2)"
28822,2020-06-03,Vietnam,0,0,328,"rgb(217,95,2)"
28823,2020-06-04,Vietnam,0,0,328,"rgb(217,95,2)"
28824,2020-06-05,Vietnam,0,0,328,"rgb(217,95,2)"
28825,2020-06-06,Vietnam,0,1,329,"rgb(217,95,2)"
28826,2020-06-07,Vietnam,0,0,329,"rgb(217,95,2)"
28827,2020-06-08,Vietnam,0,2,331,"rgb(217,95,2)"
28828,2020-06-09,Vietnam,0,1,332,"rgb(217,95,2)"
28829,2020-06-10,Vietnam,0,0,332,"rgb(217,95,2)"
28830,2020-06-11,Vietnam,0,0,332,"rgb(217,95,2)"
28831,2020-06-12,Vietnam,0,0,332,"rgb(217,95,2)"
28832,2020-06-13,Vietnam,0,1,333,"rgb(217,95,2)"
28833,2020-06-14,Vietnam,0,1,334,"rgb(217,95,2)"
28834,2020-06-15,Vietnam,0,0,334,"rgb(217,95,2)"
28835,2020-06-16,Vietnam,0,0,334,"rgb(217,95,2)"
28836,2020-06-17,Vietnam,0,1,335,"rgb(217,95,2)"
28837,2020-06-18,Vietnam,0,0,335,"rgb(217,95,2)"
28838,2020-06-19,Vietnam,0,7,342,"rgb(217,95,2)"
28839,2020-06-20,Vietnam,0,7,349,"rgb(217,95,2)"
28840,2020-06-21,Vietnam,0,0,349,"rgb(217,95,2)"
28841,2020-06-22,Vietnam,0,0,349,"rgb(217,95,2)"
28842,2020-06-23,Vietnam,0,0,349,"rgb(217,95,2)"
28843,2020-06-24,Vietnam,0,0,349,"rgb(217,95,2)"
28844,2020-06-25,Vietnam,0,3,352,"rgb(217,95,2)"
28845,2020-06-26,Vietnam,0,0,352,"rgb(217,95,2)"
28846,2020-06-27,Vietnam,0,1,353,"rgb(217,95,2)"
28847,2020-06-28,Vietnam,0,1,354,"rgb(217,95,2)"
28848,2020-06-29,Vietnam,0,1,355,"rgb(217,95,2)"
28849,2020-06-30,Vietnam,0,0,355,"rgb(217,95,2)"
28850,2020-07-01,Vietnam,0,0,355,"rgb(217,95,2)"
28851,2020-07-02,Vietnam,0,0,355,"rgb(217,95,2)"
28852,2020-07-03,Vietnam,0,0,355,"rgb(217,95,2)"
28853,2020-07-04,Vietnam,0,0,355,"rgb(217,95,2)"
28854,2020-07-05,Vietnam,0,0,355,"rgb(217,95,2)"
28855,2020-07-06,Vietnam,0,0,355,"rgb(217,95,2)"
28856,2020-07-07,Vietnam,0,14,369,"rgb(217,95,2)"
28857,2020-07-08,Vietnam,0,0,369,"rgb(217,95,2)"
28858,2020-07-09,Vietnam,0,0,369,"rgb(217,95,2)"
28859,2020-07-10,Vietnam,0,0,369,"rgb(217,95,2)"
28860,2020-07-11,Vietnam,0,1,370,"rgb(217,95,2)"
28861,2020-07-12,Vietnam,0,0,370,"rgb(217,95,2)"
28862,2020-07-13,Vietnam,0,2,372,"rgb(217,95,2)"
28863,2020-03-14,Kosovo,0,2,2,"rgb(117,112,179)"
28864,2020-03-15,Kosovo,0,3,5,"rgb(117,112,179)"
28865,2020-03-16,Kosovo,0,8,13,"rgb(117,112,179)"
28866,2020-03-17,Kosovo,0,3,16,"rgb(117,112,179)"
28867,2020-03-18,Kosovo,0,3,19,"rgb(117,112,179)"
28868,2020-03-19,Kosovo,0,1,20,"rgb(117,112,179)"
28869,2020-03-20,Kosovo,0,1,21,"rgb(117,112,179)"
28870,2020-03-21,Kosovo,0,3,24,"rgb(117,112,179)"
28871,2020-03-22,Kosovo,0,7,31,"rgb(117,112,179)"
28872,2020-03-23,Kosovo,1,2,33,"rgb(117,112,179)"
28873,2020-03-24,Kosovo,0,28,61,"rgb(117,112,179)"
28874,2020-03-25,Kosovo,0,2,63,"rgb(117,112,179)"
28875,2020-03-26,Kosovo,0,8,71,"rgb(117,112,179)"
28876,2020-03-27,Kosovo,0,15,86,"rgb(117,112,179)"
28877,2020-03-28,Kosovo,0,6,92,"rgb(117,112,179)"
28878,2020-03-29,Kosovo,0,3,95,"rgb(117,112,179)"
28879,2020-03-30,Kosovo,0,3,98,"rgb(117,112,179)"
28880,2020-03-31,Kosovo,0,12,110,"rgb(117,112,179)"
28881,2020-04-01,Kosovo,0,7,117,"rgb(117,112,179)"
28882,2020-04-02,Kosovo,0,13,130,"rgb(117,112,179)"
28883,2020-04-03,Kosovo,0,8,138,"rgb(117,112,179)"
28884,2020-04-04,Kosovo,0,9,147,"rgb(117,112,179)"
28885,2020-04-05,Kosovo,0,8,155,"rgb(117,112,179)"
28886,2020-04-06,Kosovo,0,10,165,"rgb(117,112,179)"
28887,2020-04-07,Kosovo,2,26,191,"rgb(117,112,179)"
28888,2020-04-08,Kosovo,2,19,210,"rgb(117,112,179)"
28889,2020-04-09,Kosovo,1,14,224,"rgb(117,112,179)"
28890,2020-04-10,Kosovo,1,3,227,"rgb(117,112,179)"
28891,2020-04-11,Kosovo,0,23,250,"rgb(117,112,179)"
28892,2020-04-12,Kosovo,0,33,283,"rgb(117,112,179)"
28893,2020-04-13,Kosovo,0,79,362,"rgb(117,112,179)"
28894,2020-04-14,Kosovo,1,18,380,"rgb(117,112,179)"
28895,2020-04-15,Kosovo,0,15,395,"rgb(117,112,179)"
28896,2020-04-16,Kosovo,1,41,436,"rgb(117,112,179)"
28897,2020-04-17,Kosovo,2,30,466,"rgb(117,112,179)"
28898,2020-04-18,Kosovo,1,36,502,"rgb(117,112,179)"
28899,2020-04-19,Kosovo,0,31,533,"rgb(117,112,179)"
28900,2020-04-20,Kosovo,2,28,561,"rgb(117,112,179)"
28901,2020-04-21,Kosovo,0,37,598,"rgb(117,112,179)"
28902,2020-04-22,Kosovo,3,6,604,"rgb(117,112,179)"
28903,2020-04-23,Kosovo,0,26,630,"rgb(117,112,179)"
28904,2020-04-24,Kosovo,1,39,669,"rgb(117,112,179)"
28905,2020-04-25,Kosovo,0,34,703,"rgb(117,112,179)"
28906,2020-04-26,Kosovo,0,28,731,"rgb(117,112,179)"
28907,2020-04-27,Kosovo,2,33,764,"rgb(117,112,179)"
28908,2020-04-28,Kosovo,1,22,786,"rgb(117,112,179)"
28909,2020-04-29,Kosovo,0,12,798,"rgb(117,112,179)"
28910,2020-04-30,Kosovo,0,10,808,"rgb(117,112,179)"
28911,2020-05-01,Kosovo,3,12,820,"rgb(117,112,179)"
28912,2020-05-02,Kosovo,0,9,829,"rgb(117,112,179)"
28913,2020-05-03,Kosovo,1,11,840,"rgb(117,112,179)"
28914,2020-05-04,Kosovo,0,11,851,"rgb(117,112,179)"
28915,2020-05-05,Kosovo,1,4,855,"rgb(117,112,179)"
28916,2020-05-06,Kosovo,0,1,856,"rgb(117,112,179)"
28917,2020-05-07,Kosovo,0,4,860,"rgb(117,112,179)"
28918,2020-05-08,Kosovo,1,1,861,"rgb(117,112,179)"
28919,2020-05-09,Kosovo,1,1,862,"rgb(117,112,179)"
28920,2020-05-10,Kosovo,0,8,870,"rgb(117,112,179)"
28921,2020-05-11,Kosovo,0,14,884,"rgb(117,112,179)"
28922,2020-05-12,Kosovo,0,11,895,"rgb(117,112,179)"
28923,2020-05-13,Kosovo,1,24,919,"rgb(117,112,179)"
28924,2020-05-14,Kosovo,0,8,927,"rgb(117,112,179)"
28925,2020-05-15,Kosovo,0,18,945,"rgb(117,112,179)"
28926,2020-05-16,Kosovo,0,10,955,"rgb(117,112,179)"
28927,2020-05-17,Kosovo,0,23,978,"rgb(117,112,179)"
28928,2020-05-18,Kosovo,0,7,985,"rgb(117,112,179)"
28929,2020-05-19,Kosovo,0,3,988,"rgb(117,112,179)"
28930,2020-05-20,Kosovo,0,1,989,"rgb(117,112,179)"
28931,2020-05-21,Kosovo,0,14,1003,"rgb(117,112,179)"
28932,2020-05-22,Kosovo,0,1,1004,"rgb(117,112,179)"
28933,2020-05-23,Kosovo,0,21,1025,"rgb(117,112,179)"
28934,2020-05-24,Kosovo,0,7,1032,"rgb(117,112,179)"
28935,2020-05-25,Kosovo,0,0,1032,"rgb(117,112,179)"
28936,2020-05-26,Kosovo,1,6,1038,"rgb(117,112,179)"
28937,2020-05-27,Kosovo,0,9,1047,"rgb(117,112,179)"
28938,2020-05-28,Kosovo,0,1,1048,"rgb(117,112,179)"
28939,2020-05-29,Kosovo,0,4,1052,"rgb(117,112,179)"
28940,2020-05-30,Kosovo,0,12,1064,"rgb(117,112,179)"
28941,2020-05-31,Kosovo,0,6,1070,"rgb(117,112,179)"
28942,2020-06-01,Kosovo,0,13,1083,"rgb(117,112,179)"
28943,2020-06-02,Kosovo,0,27,1110,"rgb(117,112,179)"
28944,2020-06-03,Kosovo,0,13,1123,"rgb(117,112,179)"
28945,2020-06-04,Kosovo,0,19,1142,"rgb(117,112,179)"
28946,2020-06-05,Kosovo,0,5,1147,"rgb(117,112,179)"
28947,2020-06-06,Kosovo,0,11,1158,"rgb(117,112,179)"
28948,2020-06-07,Kosovo,0,36,1194,"rgb(117,112,179)"
28949,2020-06-08,Kosovo,1,40,1234,"rgb(117,112,179)"
28950,2020-06-09,Kosovo,0,29,1263,"rgb(117,112,179)"
28951,2020-06-10,Kosovo,0,6,1269,"rgb(117,112,179)"
28952,2020-06-11,Kosovo,0,29,1298,"rgb(117,112,179)"
28953,2020-06-12,Kosovo,0,28,1326,"rgb(117,112,179)"
28954,2020-06-13,Kosovo,0,58,1384,"rgb(117,112,179)"
28955,2020-06-14,Kosovo,1,53,1437,"rgb(117,112,179)"
28956,2020-06-15,Kosovo,1,49,1486,"rgb(117,112,179)"
28957,2020-06-16,Kosovo,0,129,1615,"rgb(117,112,179)"
28958,2020-06-17,Kosovo,1,141,1756,"rgb(117,112,179)"
28959,2020-06-18,Kosovo,0,77,1833,"rgb(117,112,179)"
28960,2020-06-19,Kosovo,0,83,1916,"rgb(117,112,179)"
28961,2020-06-20,Kosovo,0,82,1998,"rgb(117,112,179)"
28962,2020-06-21,Kosovo,1,75,2073,"rgb(117,112,179)"
28963,2020-06-22,Kosovo,1,96,2169,"rgb(117,112,179)"
28964,2020-06-23,Kosovo,1,47,2216,"rgb(117,112,179)"
28965,2020-06-24,Kosovo,1,52,2268,"rgb(117,112,179)"
28966,2020-06-25,Kosovo,2,95,2363,"rgb(117,112,179)"
28967,2020-06-26,Kosovo,2,69,2432,"rgb(117,112,179)"
28968,2020-06-27,Kosovo,2,62,2494,"rgb(117,112,179)"
28969,2020-06-28,Kosovo,4,96,2590,"rgb(117,112,179)"
28970,2020-06-29,Kosovo,1,87,2677,"rgb(117,112,179)"
28971,2020-06-30,Kosovo,0,122,2799,"rgb(117,112,179)"
28972,2020-07-01,Kosovo,2,79,2878,"rgb(117,112,179)"
28973,2020-07-02,Kosovo,3,113,2991,"rgb(117,112,179)"
28974,2020-07-03,Kosovo,1,73,3064,"rgb(117,112,179)"
28975,2020-07-04,Kosovo,0,0,3064,"rgb(117,112,179)"
28976,2020-07-05,Kosovo,0,0,3064,"rgb(117,112,179)"
28977,2020-07-06,Kosovo,11,292,3356,"rgb(117,112,179)"
28978,2020-07-07,Kosovo,9,152,3508,"rgb(117,112,179)"
28979,2020-07-08,Kosovo,4,195,3703,"rgb(117,112,179)"
28980,2020-07-09,Kosovo,3,183,3886,"rgb(117,112,179)"
28981,2020-07-10,Kosovo,4,214,4100,"rgb(117,112,179)"
28982,2020-07-11,Kosovo,8,207,4307,"rgb(117,112,179)"
28983,2020-07-12,Kosovo,7,408,4715,"rgb(117,112,179)"
28984,2020-07-13,Kosovo,1,216,4931,"rgb(117,112,179)"
28985,2020-04-10,Yemen,0,1,1,"rgb(231,41,138)"
28986,2020-04-11,Yemen,0,0,1,"rgb(231,41,138)"
28987,2020-04-12,Yemen,0,0,1,"rgb(231,41,138)"
28988,2020-04-13,Yemen,0,0,1,"rgb(231,41,138)"
28989,2020-04-14,Yemen,0,0,1,"rgb(231,41,138)"
28990,2020-04-15,Yemen,0,0,1,"rgb(231,41,138)"
28991,2020-04-16,Yemen,0,0,1,"rgb(231,41,138)"
28992,2020-04-17,Yemen,0,0,1,"rgb(231,41,138)"
28993,2020-04-18,Yemen,0,0,1,"rgb(231,41,138)"
28994,2020-04-19,Yemen,0,0,1,"rgb(231,41,138)"
28995,2020-04-20,Yemen,0,0,1,"rgb(231,41,138)"
28996,2020-04-21,Yemen,0,0,1,"rgb(231,41,138)"
28997,2020-04-22,Yemen,0,0,1,"rgb(231,41,138)"
28998,2020-04-23,Yemen,0,0,1,"rgb(231,41,138)"
28999,2020-04-24,Yemen,0,0,1,"rgb(231,41,138)"
29000,2020-04-25,Yemen,0,0,1,"rgb(231,41,138)"
29001,2020-04-26,Yemen,0,0,1,"rgb(231,41,138)"
29002,2020-04-27,Yemen,0,0,1,"rgb(231,41,138)"
29003,2020-04-28,Yemen,0,0,1,"rgb(231,41,138)"
29004,2020-04-29,Yemen,0,0,1,"rgb(231,41,138)"
29005,2020-04-30,Yemen,0,5,6,"rgb(231,41,138)"
29006,2020-05-01,Yemen,2,0,6,"rgb(231,41,138)"
29007,2020-05-02,Yemen,0,1,7,"rgb(231,41,138)"
29008,2020-05-03,Yemen,0,3,10,"rgb(231,41,138)"
29009,2020-05-04,Yemen,0,0,10,"rgb(231,41,138)"
29010,2020-05-05,Yemen,0,2,12,"rgb(231,41,138)"
29011,2020-05-06,Yemen,1,9,21,"rgb(231,41,138)"
29012,2020-05-07,Yemen,2,4,25,"rgb(231,41,138)"
29013,2020-05-08,Yemen,1,1,26,"rgb(231,41,138)"
29014,2020-05-09,Yemen,1,8,34,"rgb(231,41,138)"
29015,2020-05-10,Yemen,0,0,34,"rgb(231,41,138)"
29016,2020-05-11,Yemen,1,17,51,"rgb(231,41,138)"
29017,2020-05-12,Yemen,1,5,56,"rgb(231,41,138)"
29018,2020-05-13,Yemen,2,11,67,"rgb(231,41,138)"
29019,2020-05-14,Yemen,1,3,70,"rgb(231,41,138)"
29020,2020-05-15,Yemen,1,17,87,"rgb(231,41,138)"
29021,2020-05-16,Yemen,2,19,106,"rgb(231,41,138)"
29022,2020-05-17,Yemen,4,18,124,"rgb(231,41,138)"
29023,2020-05-18,Yemen,1,4,128,"rgb(231,41,138)"
29024,2020-05-19,Yemen,0,2,130,"rgb(231,41,138)"
29025,2020-05-20,Yemen,8,37,167,"rgb(231,41,138)"
29026,2020-05-21,Yemen,1,13,180,"rgb(231,41,138)"
29027,2020-05-22,Yemen,4,13,193,"rgb(231,41,138)"
29028,2020-05-23,Yemen,0,12,205,"rgb(231,41,138)"
29029,2020-05-24,Yemen,6,7,212,"rgb(231,41,138)"
29030,2020-05-25,Yemen,3,10,222,"rgb(231,41,138)"
29031,2020-05-26,Yemen,3,15,237,"rgb(231,41,138)"
29032,2020-05-27,Yemen,4,12,249,"rgb(231,41,138)"
29033,2020-05-28,Yemen,4,6,255,"rgb(231,41,138)"
29034,2020-05-29,Yemen,4,23,278,"rgb(231,41,138)"
29035,2020-05-30,Yemen,9,9,287,"rgb(231,41,138)"
29036,2020-05-31,Yemen,11,23,310,"rgb(231,41,138)"
29037,2020-06-01,Yemen,3,13,323,"rgb(231,41,138)"
29038,2020-06-02,Yemen,4,31,354,"rgb(231,41,138)"
29039,2020-06-03,Yemen,3,45,399,"rgb(231,41,138)"
29040,2020-06-04,Yemen,1,4,403,"rgb(231,41,138)"
29041,2020-06-05,Yemen,15,50,453,"rgb(231,41,138)"
29042,2020-06-06,Yemen,8,16,469,"rgb(231,41,138)"
29043,2020-06-07,Yemen,1,4,473,"rgb(231,41,138)"
29044,2020-06-08,Yemen,0,13,486,"rgb(231,41,138)"
29045,2020-06-09,Yemen,0,10,496,"rgb(231,41,138)"
29046,2020-06-10,Yemen,15,28,524,"rgb(231,41,138)"
29047,2020-06-11,Yemen,2,36,560,"rgb(231,41,138)"
29048,2020-06-12,Yemen,7,31,591,"rgb(231,41,138)"
29049,2020-06-13,Yemen,3,41,632,"rgb(231,41,138)"
29050,2020-06-14,Yemen,21,73,705,"rgb(231,41,138)"
29051,2020-06-15,Yemen,4,23,728,"rgb(231,41,138)"
29052,2020-06-16,Yemen,44,116,844,"rgb(231,41,138)"
29053,2020-06-17,Yemen,7,45,889,"rgb(231,41,138)"
29054,2020-06-18,Yemen,29,13,902,"rgb(231,41,138)"
29055,2020-06-19,Yemen,4,4,906,"rgb(231,41,138)"
29056,2020-06-20,Yemen,3,13,919,"rgb(231,41,138)"
29057,2020-06-21,Yemen,3,4,923,"rgb(231,41,138)"
29058,2020-06-22,Yemen,2,18,941,"rgb(231,41,138)"
29059,2020-06-23,Yemen,1,26,967,"rgb(231,41,138)"
29060,2020-06-24,Yemen,4,25,992,"rgb(231,41,138)"
29061,2020-06-25,Yemen,13,23,1015,"rgb(231,41,138)"
29062,2020-06-26,Yemen,14,61,1076,"rgb(231,41,138)"
29063,2020-06-27,Yemen,5,13,1089,"rgb(231,41,138)"
29064,2020-06-28,Yemen,3,14,1103,"rgb(231,41,138)"
29065,2020-06-29,Yemen,6,15,1118,"rgb(231,41,138)"
29066,2020-06-30,Yemen,2,10,1128,"rgb(231,41,138)"
29067,2020-07-01,Yemen,8,30,1158,"rgb(231,41,138)"
29068,2020-07-02,Yemen,6,32,1190,"rgb(231,41,138)"
29069,2020-07-03,Yemen,7,31,1221,"rgb(231,41,138)"
29070,2020-07-04,Yemen,10,19,1240,"rgb(231,41,138)"
29071,2020-07-05,Yemen,2,8,1248,"rgb(231,41,138)"
29072,2020-07-06,Yemen,1,17,1265,"rgb(231,41,138)"
29073,2020-07-07,Yemen,7,25,1290,"rgb(231,41,138)"
29074,2020-07-08,Yemen,3,7,1297,"rgb(231,41,138)"
29075,2020-07-09,Yemen,3,21,1318,"rgb(231,41,138)"
29076,2020-07-10,Yemen,10,38,1356,"rgb(231,41,138)"
29077,2020-07-11,Yemen,3,24,1380,"rgb(231,41,138)"
29078,2020-07-12,Yemen,1,9,1389,"rgb(231,41,138)"
29079,2020-07-13,Yemen,52,76,1465,"rgb(231,41,138)"
29080,2020-03-06,South Africa,0,1,1,"rgb(102,166,30)"
29081,2020-03-08,South Africa,0,1,2,"rgb(102,166,30)"
29082,2020-03-09,South Africa,0,1,3,"rgb(102,166,30)"
29083,2020-03-10,South Africa,0,4,7,"rgb(102,166,30)"
29084,2020-03-12,South Africa,0,6,13,"rgb(102,166,30)"
29085,2020-03-13,South Africa,0,4,17,"rgb(102,166,30)"
29086,2020-03-14,South Africa,0,7,24,"rgb(102,166,30)"
29087,2020-03-15,South Africa,0,0,24,"rgb(102,166,30)"
29088,2020-03-16,South Africa,0,27,51,"rgb(102,166,30)"
29089,2020-03-17,South Africa,0,11,62,"rgb(102,166,30)"
29090,2020-03-18,South Africa,0,23,85,"rgb(102,166,30)"
29091,2020-03-19,South Africa,0,31,116,"rgb(102,166,30)"
29092,2020-03-20,South Africa,0,34,150,"rgb(102,166,30)"
29093,2020-03-21,South Africa,0,55,205,"rgb(102,166,30)"
29094,2020-03-22,South Africa,0,35,240,"rgb(102,166,30)"
29095,2020-03-23,South Africa,0,34,274,"rgb(102,166,30)"
29096,2020-03-24,South Africa,0,128,402,"rgb(102,166,30)"
29097,2020-03-25,South Africa,0,155,557,"rgb(102,166,30)"
29098,2020-03-26,South Africa,0,152,709,"rgb(102,166,30)"
29099,2020-03-27,South Africa,2,218,927,"rgb(102,166,30)"
29100,2020-03-28,South Africa,0,243,1170,"rgb(102,166,30)"
29101,2020-03-29,South Africa,0,17,1187,"rgb(102,166,30)"
29102,2020-03-30,South Africa,0,93,1280,"rgb(102,166,30)"
29103,2020-03-31,South Africa,1,46,1326,"rgb(102,166,30)"
29104,2020-04-01,South Africa,2,27,1353,"rgb(102,166,30)"
29105,2020-04-02,South Africa,0,27,1380,"rgb(102,166,30)"
29106,2020-04-03,South Africa,0,82,1462,"rgb(102,166,30)"
29107,2020-04-04,South Africa,2,43,1505,"rgb(102,166,30)"
29108,2020-04-05,South Africa,2,80,1585,"rgb(102,166,30)"
29109,2020-04-06,South Africa,2,70,1655,"rgb(102,166,30)"
29110,2020-04-07,South Africa,1,31,1686,"rgb(102,166,30)"
29111,2020-04-08,South Africa,1,63,1749,"rgb(102,166,30)"
29112,2020-04-09,South Africa,5,96,1845,"rgb(102,166,30)"
29113,2020-04-10,South Africa,0,89,1934,"rgb(102,166,30)"
29114,2020-04-11,South Africa,6,69,2003,"rgb(102,166,30)"
29115,2020-04-12,South Africa,1,25,2028,"rgb(102,166,30)"
29116,2020-04-13,South Africa,0,145,2173,"rgb(102,166,30)"
29117,2020-04-14,South Africa,2,99,2272,"rgb(102,166,30)"
29118,2020-04-15,South Africa,0,143,2415,"rgb(102,166,30)"
29119,2020-04-16,South Africa,7,91,2506,"rgb(102,166,30)"
29120,2020-04-17,South Africa,14,99,2605,"rgb(102,166,30)"
29121,2020-04-18,South Africa,2,178,2783,"rgb(102,166,30)"
29122,2020-04-19,South Africa,2,251,3034,"rgb(102,166,30)"
29123,2020-04-20,South Africa,2,124,3158,"rgb(102,166,30)"
29124,2020-04-21,South Africa,4,142,3300,"rgb(102,166,30)"
29125,2020-04-22,South Africa,0,165,3465,"rgb(102,166,30)"
29126,2020-04-23,South Africa,7,170,3635,"rgb(102,166,30)"
29127,2020-04-24,South Africa,10,318,3953,"rgb(102,166,30)"
29128,2020-04-25,South Africa,4,267,4220,"rgb(102,166,30)"
29129,2020-04-26,South Africa,7,141,4361,"rgb(102,166,30)"
29130,2020-04-27,South Africa,1,185,4546,"rgb(102,166,30)"
29131,2020-04-28,South Africa,3,247,4793,"rgb(102,166,30)"
29132,2020-04-29,South Africa,3,203,4996,"rgb(102,166,30)"
29133,2020-04-30,South Africa,10,354,5350,"rgb(102,166,30)"
29134,2020-05-01,South Africa,0,297,5647,"rgb(102,166,30)"
29135,2020-05-02,South Africa,13,304,5951,"rgb(102,166,30)"
29136,2020-05-03,South Africa,7,385,6336,"rgb(102,166,30)"
29137,2020-05-04,South Africa,8,447,6783,"rgb(102,166,30)"
29138,2020-05-05,South Africa,7,437,7220,"rgb(102,166,30)"
29139,2020-05-06,South Africa,10,352,7572,"rgb(102,166,30)"
29140,2020-05-07,South Africa,5,236,7808,"rgb(102,166,30)"
29141,2020-05-08,South Africa,8,424,8232,"rgb(102,166,30)"
29142,2020-05-09,South Africa,17,663,8895,"rgb(102,166,30)"
29143,2020-05-10,South Africa,8,525,9420,"rgb(102,166,30)"
29144,2020-05-11,South Africa,8,595,10015,"rgb(102,166,30)"
29145,2020-05-12,South Africa,12,637,10652,"rgb(102,166,30)"
29146,2020-05-13,South Africa,0,698,11350,"rgb(102,166,30)"
29147,2020-05-14,South Africa,13,724,12074,"rgb(102,166,30)"
29148,2020-05-15,South Africa,19,665,12739,"rgb(102,166,30)"
29149,2020-05-16,South Africa,9,785,13524,"rgb(102,166,30)"
29150,2020-05-17,South Africa,14,831,14355,"rgb(102,166,30)"
29151,2020-05-18,South Africa,3,1160,15515,"rgb(102,166,30)"
29152,2020-05-19,South Africa,22,918,16433,"rgb(102,166,30)"
29153,2020-05-20,South Africa,26,767,17200,"rgb(102,166,30)"
29154,2020-05-21,South Africa,27,803,18003,"rgb(102,166,30)"
29155,2020-05-22,South Africa,30,1134,19137,"rgb(102,166,30)"
29156,2020-05-23,South Africa,28,988,20125,"rgb(102,166,30)"
29157,2020-05-24,South Africa,10,1218,21343,"rgb(102,166,30)"
29158,2020-05-25,South Africa,22,1240,22583,"rgb(102,166,30)"
29159,2020-05-26,South Africa,52,1032,23615,"rgb(102,166,30)"
29160,2020-05-27,South Africa,43,649,24264,"rgb(102,166,30)"
29161,2020-05-28,South Africa,28,1673,25937,"rgb(102,166,30)"
29162,2020-05-29,South Africa,25,1466,27403,"rgb(102,166,30)"
29163,2020-05-30,South Africa,34,1837,29240,"rgb(102,166,30)"
29164,2020-05-31,South Africa,32,1727,30967,"rgb(102,166,30)"
29165,2020-06-01,South Africa,40,1716,32683,"rgb(102,166,30)"
29166,2020-06-02,South Africa,22,1674,34357,"rgb(102,166,30)"
29167,2020-06-03,South Africa,50,1455,35812,"rgb(102,166,30)"
29168,2020-06-04,South Africa,37,1713,37525,"rgb(102,166,30)"
29169,2020-06-05,South Africa,56,3267,40792,"rgb(102,166,30)"
29170,2020-06-06,South Africa,60,2642,43434,"rgb(102,166,30)"
29171,2020-06-07,South Africa,44,2539,45973,"rgb(102,166,30)"
29172,2020-06-08,South Africa,46,2312,48285,"rgb(102,166,30)"
29173,2020-06-09,South Africa,82,2594,50879,"rgb(102,166,30)"
29174,2020-06-10,South Africa,82,2112,52991,"rgb(102,166,30)"
29175,2020-06-11,South Africa,48,2430,55421,"rgb(102,166,30)"
29176,2020-06-12,South Africa,79,3147,58568,"rgb(102,166,30)"
29177,2020-06-13,South Africa,65,3359,61927,"rgb(102,166,30)"
29178,2020-06-14,South Africa,69,3809,65736,"rgb(102,166,30)"
29179,2020-06-15,South Africa,57,4302,70038,"rgb(102,166,30)"
29180,2020-06-16,South Africa,88,3495,73533,"rgb(102,166,30)"
29181,2020-06-17,South Africa,57,2801,76334,"rgb(102,166,30)"
29182,2020-06-18,South Africa,49,4078,80412,"rgb(102,166,30)"
29183,2020-06-19,South Africa,63,3478,83890,"rgb(102,166,30)"
29184,2020-06-20,South Africa,94,3825,87715,"rgb(102,166,30)"
29185,2020-06-21,South Africa,46,4966,92681,"rgb(102,166,30)"
29186,2020-06-22,South Africa,53,4621,97302,"rgb(102,166,30)"
29187,2020-06-23,South Africa,61,4288,101590,"rgb(102,166,30)"
29188,2020-06-24,South Africa,111,4518,106108,"rgb(102,166,30)"
29189,2020-06-25,South Africa,103,5688,111796,"rgb(102,166,30)"
29190,2020-06-26,South Africa,87,6579,118375,"rgb(102,166,30)"
29191,2020-06-27,South Africa,48,6215,124590,"rgb(102,166,30)"
29192,2020-06-28,South Africa,73,7210,131800,"rgb(102,166,30)"
29193,2020-06-29,South Africa,43,6334,138134,"rgb(102,166,30)"
29194,2020-06-30,South Africa,73,6130,144264,"rgb(102,166,30)"
29195,2020-07-01,South Africa,128,6945,151209,"rgb(102,166,30)"
29196,2020-07-02,South Africa,92,8124,159333,"rgb(102,166,30)"
29197,2020-07-03,South Africa,95,8728,168061,"rgb(102,166,30)"
29198,2020-07-04,South Africa,108,9063,177124,"rgb(102,166,30)"
29199,2020-07-05,South Africa,74,10853,187977,"rgb(102,166,30)"
29200,2020-07-06,South Africa,173,8773,196750,"rgb(102,166,30)"
29201,2020-07-07,South Africa,111,8971,205721,"rgb(102,166,30)"
29202,2020-07-08,South Africa,192,10134,215855,"rgb(102,166,30)"
29203,2020-07-09,South Africa,100,8810,224665,"rgb(102,166,30)"
29204,2020-07-10,South Africa,118,13674,238339,"rgb(102,166,30)"
29205,2020-07-11,South Africa,140,12348,250687,"rgb(102,166,30)"
29206,2020-07-12,South Africa,111,13497,264184,"rgb(102,166,30)"
29207,2020-07-13,South Africa,108,12058,276242,"rgb(102,166,30)"
29208,2020-03-19,Zambia,0,2,2,"rgb(230,171,2)"
29209,2020-03-20,Zambia,0,0,2,"rgb(230,171,2)"
29210,2020-03-21,Zambia,0,0,2,"rgb(230,171,2)"
29211,2020-03-22,Zambia,0,0,2,"rgb(230,171,2)"
29212,2020-03-23,Zambia,0,1,3,"rgb(230,171,2)"
29213,2020-03-24,Zambia,0,0,3,"rgb(230,171,2)"
29214,2020-03-25,Zambia,0,0,3,"rgb(230,171,2)"
29215,2020-03-26,Zambia,0,9,12,"rgb(230,171,2)"
29216,2020-03-27,Zambia,0,2,14,"rgb(230,171,2)"
29217,2020-03-28,Zambia,0,2,16,"rgb(230,171,2)"
29218,2020-03-29,Zambia,0,12,28,"rgb(230,171,2)"
29219,2020-03-30,Zambia,0,1,29,"rgb(230,171,2)"
29220,2020-03-31,Zambia,0,6,35,"rgb(230,171,2)"
29221,2020-04-01,Zambia,0,0,35,"rgb(230,171,2)"
29222,2020-04-02,Zambia,0,1,36,"rgb(230,171,2)"
29223,2020-04-03,Zambia,1,3,39,"rgb(230,171,2)"
29224,2020-04-04,Zambia,0,0,39,"rgb(230,171,2)"
29225,2020-04-05,Zambia,0,0,39,"rgb(230,171,2)"
29226,2020-04-06,Zambia,0,0,39,"rgb(230,171,2)"
29227,2020-04-07,Zambia,0,0,39,"rgb(230,171,2)"
29228,2020-04-08,Zambia,0,0,39,"rgb(230,171,2)"
29229,2020-04-09,Zambia,0,0,39,"rgb(230,171,2)"
29230,2020-04-10,Zambia,0,0,39,"rgb(230,171,2)"
29231,2020-04-11,Zambia,1,1,40,"rgb(230,171,2)"
29232,2020-04-12,Zambia,0,0,40,"rgb(230,171,2)"
29233,2020-04-13,Zambia,0,3,43,"rgb(230,171,2)"
29234,2020-04-14,Zambia,0,2,45,"rgb(230,171,2)"
29235,2020-04-15,Zambia,0,0,45,"rgb(230,171,2)"
29236,2020-04-16,Zambia,0,3,48,"rgb(230,171,2)"
29237,2020-04-17,Zambia,0,0,48,"rgb(230,171,2)"
29238,2020-04-18,Zambia,0,4,52,"rgb(230,171,2)"
29239,2020-04-19,Zambia,0,5,57,"rgb(230,171,2)"
29240,2020-04-20,Zambia,1,4,61,"rgb(230,171,2)"
29241,2020-04-21,Zambia,0,4,65,"rgb(230,171,2)"
29242,2020-04-22,Zambia,0,0,65,"rgb(230,171,2)"
29243,2020-04-23,Zambia,0,9,74,"rgb(230,171,2)"
29244,2020-04-24,Zambia,0,2,76,"rgb(230,171,2)"
29245,2020-04-25,Zambia,0,8,84,"rgb(230,171,2)"
29246,2020-04-26,Zambia,0,0,84,"rgb(230,171,2)"
29247,2020-04-27,Zambia,0,4,88,"rgb(230,171,2)"
29248,2020-04-28,Zambia,0,1,89,"rgb(230,171,2)"
29249,2020-04-29,Zambia,0,6,95,"rgb(230,171,2)"
29250,2020-04-30,Zambia,0,2,97,"rgb(230,171,2)"
29251,2020-05-01,Zambia,0,9,106,"rgb(230,171,2)"
29252,2020-05-02,Zambia,0,3,109,"rgb(230,171,2)"
29253,2020-05-03,Zambia,0,10,119,"rgb(230,171,2)"
29254,2020-05-04,Zambia,0,5,124,"rgb(230,171,2)"
29255,2020-05-05,Zambia,0,13,137,"rgb(230,171,2)"
29256,2020-05-06,Zambia,1,2,139,"rgb(230,171,2)"
29257,2020-05-07,Zambia,0,7,146,"rgb(230,171,2)"
29258,2020-05-08,Zambia,0,7,153,"rgb(230,171,2)"
29259,2020-05-09,Zambia,0,14,167,"rgb(230,171,2)"
29260,2020-05-10,Zambia,3,85,252,"rgb(230,171,2)"
29261,2020-05-11,Zambia,0,15,267,"rgb(230,171,2)"
29262,2020-05-12,Zambia,0,0,267,"rgb(230,171,2)"
29263,2020-05-13,Zambia,0,174,441,"rgb(230,171,2)"
29264,2020-05-14,Zambia,0,5,446,"rgb(230,171,2)"
29265,2020-05-15,Zambia,0,208,654,"rgb(230,171,2)"
29266,2020-05-16,Zambia,0,14,668,"rgb(230,171,2)"
29267,2020-05-17,Zambia,0,11,679,"rgb(230,171,2)"
29268,2020-05-18,Zambia,0,74,753,"rgb(230,171,2)"
29269,2020-05-19,Zambia,0,8,761,"rgb(230,171,2)"
29270,2020-05-20,Zambia,0,11,772,"rgb(230,171,2)"
29271,2020-05-21,Zambia,0,60,832,"rgb(230,171,2)"
29272,2020-05-22,Zambia,0,34,866,"rgb(230,171,2)"
29273,2020-05-23,Zambia,0,54,920,"rgb(230,171,2)"
29274,2020-05-24,Zambia,0,0,920,"rgb(230,171,2)"
29275,2020-05-25,Zambia,0,0,920,"rgb(230,171,2)"
29276,2020-05-26,Zambia,0,0,920,"rgb(230,171,2)"
29277,2020-05-27,Zambia,0,0,920,"rgb(230,171,2)"
29278,2020-05-28,Zambia,0,137,1057,"rgb(230,171,2)"
29279,2020-05-29,Zambia,0,0,1057,"rgb(230,171,2)"
29280,2020-05-30,Zambia,0,0,1057,"rgb(230,171,2)"
29281,2020-05-31,Zambia,0,0,1057,"rgb(230,171,2)"
29282,2020-06-01,Zambia,0,0,1057,"rgb(230,171,2)"
29283,2020-06-02,Zambia,0,32,1089,"rgb(230,171,2)"
29284,2020-06-03,Zambia,0,0,1089,"rgb(230,171,2)"
29285,2020-06-04,Zambia,0,0,1089,"rgb(230,171,2)"
29286,2020-06-05,Zambia,0,22,1111,"rgb(230,171,2)"
29287,2020-06-06,Zambia,0,0,1111,"rgb(230,171,2)"
29288,2020-06-07,Zambia,0,43,1154,"rgb(230,171,2)"
29289,2020-06-08,Zambia,0,0,1154,"rgb(230,171,2)"
29290,2020-06-09,Zambia,3,46,1200,"rgb(230,171,2)"
29291,2020-06-10,Zambia,0,0,1200,"rgb(230,171,2)"
29292,2020-06-11,Zambia,0,52,1252,"rgb(230,171,2)"
29293,2020-06-12,Zambia,0,0,1252,"rgb(230,171,2)"
29294,2020-06-13,Zambia,0,69,1321,"rgb(230,171,2)"
29295,2020-06-14,Zambia,0,36,1357,"rgb(230,171,2)"
29296,2020-06-15,Zambia,1,1,1358,"rgb(230,171,2)"
29297,2020-06-16,Zambia,0,24,1382,"rgb(230,171,2)"
29298,2020-06-17,Zambia,0,23,1405,"rgb(230,171,2)"
29299,2020-06-18,Zambia,0,7,1412,"rgb(230,171,2)"
29300,2020-06-19,Zambia,0,4,1416,"rgb(230,171,2)"
29301,2020-06-20,Zambia,0,14,1430,"rgb(230,171,2)"
29302,2020-06-21,Zambia,0,0,1430,"rgb(230,171,2)"
29303,2020-06-22,Zambia,0,0,1430,"rgb(230,171,2)"
29304,2020-06-23,Zambia,0,0,1430,"rgb(230,171,2)"
29305,2020-06-24,Zambia,7,47,1477,"rgb(230,171,2)"
29306,2020-06-25,Zambia,0,12,1489,"rgb(230,171,2)"
29307,2020-06-26,Zambia,0,8,1497,"rgb(230,171,2)"
29308,2020-06-27,Zambia,3,34,1531,"rgb(230,171,2)"
29309,2020-06-28,Zambia,0,0,1531,"rgb(230,171,2)"
29310,2020-06-29,Zambia,1,26,1557,"rgb(230,171,2)"
29311,2020-06-30,Zambia,0,11,1568,"rgb(230,171,2)"
29312,2020-07-01,Zambia,2,26,1594,"rgb(230,171,2)"
29313,2020-07-02,Zambia,6,38,1632,"rgb(230,171,2)"
29314,2020-07-03,Zambia,0,0,1632,"rgb(230,171,2)"
29315,2020-07-04,Zambia,0,0,1632,"rgb(230,171,2)"
29316,2020-07-05,Zambia,0,0,1632,"rgb(230,171,2)"
29317,2020-07-06,Zambia,0,0,1632,"rgb(230,171,2)"
29318,2020-07-07,Zambia,0,0,1632,"rgb(230,171,2)"
29319,2020-07-08,Zambia,12,263,1895,"rgb(230,171,2)"
29320,2020-07-09,Zambia,0,0,1895,"rgb(230,171,2)"
29321,2020-07-10,Zambia,0,0,1895,"rgb(230,171,2)"
29322,2020-07-11,Zambia,0,0,1895,"rgb(230,171,2)"
29323,2020-07-12,Zambia,0,0,1895,"rgb(230,171,2)"
29324,2020-07-13,Zambia,0,0,1895,"rgb(230,171,2)"
29325,2020-03-21,Zimbabwe,0,1,1,"rgb(166,118,29)"
29326,2020-03-22,Zimbabwe,0,1,2,"rgb(166,118,29)"
29327,2020-03-23,Zimbabwe,0,0,2,"rgb(166,118,29)"
29328,2020-03-24,Zimbabwe,1,0,2,"rgb(166,118,29)"
29329,2020-03-25,Zimbabwe,0,0,2,"rgb(166,118,29)"
29330,2020-03-26,Zimbabwe,0,1,3,"rgb(166,118,29)"
29331,2020-03-27,Zimbabwe,0,0,3,"rgb(166,118,29)"
29332,2020-03-28,Zimbabwe,0,2,5,"rgb(166,118,29)"
29333,2020-03-29,Zimbabwe,0,2,7,"rgb(166,118,29)"
29334,2020-03-30,Zimbabwe,0,0,7,"rgb(166,118,29)"
29335,2020-03-31,Zimbabwe,0,0,7,"rgb(166,118,29)"
29336,2020-04-01,Zimbabwe,0,1,8,"rgb(166,118,29)"
29337,2020-04-02,Zimbabwe,0,0,8,"rgb(166,118,29)"
29338,2020-04-03,Zimbabwe,0,0,8,"rgb(166,118,29)"
29339,2020-04-04,Zimbabwe,0,1,9,"rgb(166,118,29)"
29340,2020-04-05,Zimbabwe,0,0,9,"rgb(166,118,29)"
29341,2020-04-06,Zimbabwe,0,0,9,"rgb(166,118,29)"
29342,2020-04-07,Zimbabwe,0,0,9,"rgb(166,118,29)"
29343,2020-04-08,Zimbabwe,0,1,10,"rgb(166,118,29)"
29344,2020-04-09,Zimbabwe,1,1,11,"rgb(166,118,29)"
29345,2020-04-10,Zimbabwe,1,0,11,"rgb(166,118,29)"
29346,2020-04-11,Zimbabwe,0,0,11,"rgb(166,118,29)"
29347,2020-04-12,Zimbabwe,0,3,14,"rgb(166,118,29)"
29348,2020-04-13,Zimbabwe,0,0,14,"rgb(166,118,29)"
29349,2020-04-14,Zimbabwe,0,3,17,"rgb(166,118,29)"
29350,2020-04-15,Zimbabwe,0,0,17,"rgb(166,118,29)"
29351,2020-04-16,Zimbabwe,0,6,23,"rgb(166,118,29)"
29352,2020-04-17,Zimbabwe,0,1,24,"rgb(166,118,29)"
29353,2020-04-18,Zimbabwe,0,0,24,"rgb(166,118,29)"
29354,2020-04-19,Zimbabwe,0,1,25,"rgb(166,118,29)"
29355,2020-04-20,Zimbabwe,0,0,25,"rgb(166,118,29)"
29356,2020-04-21,Zimbabwe,0,0,25,"rgb(166,118,29)"
29357,2020-04-22,Zimbabwe,0,3,28,"rgb(166,118,29)"
29358,2020-04-23,Zimbabwe,0,0,28,"rgb(166,118,29)"
29359,2020-04-24,Zimbabwe,0,1,29,"rgb(166,118,29)"
29360,2020-04-25,Zimbabwe,1,0,29,"rgb(166,118,29)"
29361,2020-04-26,Zimbabwe,0,2,31,"rgb(166,118,29)"
29362,2020-04-27,Zimbabwe,0,0,31,"rgb(166,118,29)"
29363,2020-04-28,Zimbabwe,0,1,32,"rgb(166,118,29)"
29364,2020-04-29,Zimbabwe,0,0,32,"rgb(166,118,29)"
29365,2020-04-30,Zimbabwe,0,2,34,"rgb(166,118,29)"
29366,2020-05-01,Zimbabwe,0,0,34,"rgb(166,118,29)"
29367,2020-05-02,Zimbabwe,0,0,34,"rgb(166,118,29)"
29368,2020-05-03,Zimbabwe,0,0,34,"rgb(166,118,29)"
29369,2020-05-04,Zimbabwe,0,0,34,"rgb(166,118,29)"
29370,2020-05-05,Zimbabwe,0,0,34,"rgb(166,118,29)"
29371,2020-05-06,Zimbabwe,0,0,34,"rgb(166,118,29)"
29372,2020-05-07,Zimbabwe,0,0,34,"rgb(166,118,29)"
29373,2020-05-08,Zimbabwe,0,0,34,"rgb(166,118,29)"
29374,2020-05-09,Zimbabwe,0,1,35,"rgb(166,118,29)"
29375,2020-05-10,Zimbabwe,0,1,36,"rgb(166,118,29)"
29376,2020-05-11,Zimbabwe,0,0,36,"rgb(166,118,29)"
29377,2020-05-12,Zimbabwe,0,1,37,"rgb(166,118,29)"
29378,2020-05-13,Zimbabwe,0,0,37,"rgb(166,118,29)"
29379,2020-05-14,Zimbabwe,0,0,37,"rgb(166,118,29)"
29380,2020-05-15,Zimbabwe,0,0,37,"rgb(166,118,29)"
29381,2020-05-16,Zimbabwe,0,5,42,"rgb(166,118,29)"
29382,2020-05-17,Zimbabwe,0,2,44,"rgb(166,118,29)"
29383,2020-05-18,Zimbabwe,0,2,46,"rgb(166,118,29)"
29384,2020-05-19,Zimbabwe,0,0,46,"rgb(166,118,29)"
29385,2020-05-20,Zimbabwe,0,0,46,"rgb(166,118,29)"
29386,2020-05-21,Zimbabwe,0,2,48,"rgb(166,118,29)"
29387,2020-05-22,Zimbabwe,0,3,51,"rgb(166,118,29)"
29388,2020-05-23,Zimbabwe,0,5,56,"rgb(166,118,29)"
29389,2020-05-24,Zimbabwe,0,0,56,"rgb(166,118,29)"
29390,2020-05-25,Zimbabwe,0,0,56,"rgb(166,118,29)"
29391,2020-05-26,Zimbabwe,0,0,56,"rgb(166,118,29)"
29392,2020-05-27,Zimbabwe,0,0,56,"rgb(166,118,29)"
29393,2020-05-28,Zimbabwe,0,76,132,"rgb(166,118,29)"
29394,2020-05-29,Zimbabwe,0,17,149,"rgb(166,118,29)"
29395,2020-05-30,Zimbabwe,0,11,160,"rgb(166,118,29)"
29396,2020-05-31,Zimbabwe,0,14,174,"rgb(166,118,29)"
29397,2020-06-01,Zimbabwe,0,4,178,"rgb(166,118,29)"
29398,2020-06-02,Zimbabwe,0,25,203,"rgb(166,118,29)"
29399,2020-06-03,Zimbabwe,0,3,206,"rgb(166,118,29)"
29400,2020-06-04,Zimbabwe,0,16,222,"rgb(166,118,29)"
29401,2020-06-05,Zimbabwe,0,15,237,"rgb(166,118,29)"
29402,2020-06-06,Zimbabwe,0,28,265,"rgb(166,118,29)"
29403,2020-06-07,Zimbabwe,0,14,279,"rgb(166,118,29)"
29404,2020-06-08,Zimbabwe,0,3,282,"rgb(166,118,29)"
29405,2020-06-09,Zimbabwe,0,5,287,"rgb(166,118,29)"
29406,2020-06-10,Zimbabwe,0,27,314,"rgb(166,118,29)"
29407,2020-06-11,Zimbabwe,0,6,320,"rgb(166,118,29)"
29408,2020-06-12,Zimbabwe,0,12,332,"rgb(166,118,29)"
29409,2020-06-13,Zimbabwe,0,11,343,"rgb(166,118,29)"
29410,2020-06-14,Zimbabwe,0,13,356,"rgb(166,118,29)"
29411,2020-06-15,Zimbabwe,0,27,383,"rgb(166,118,29)"
29412,2020-06-16,Zimbabwe,0,4,387,"rgb(166,118,29)"
29413,2020-06-17,Zimbabwe,0,7,394,"rgb(166,118,29)"
29414,2020-06-18,Zimbabwe,0,7,401,"rgb(166,118,29)"
29415,2020-06-19,Zimbabwe,0,62,463,"rgb(166,118,29)"
29416,2020-06-20,Zimbabwe,0,16,479,"rgb(166,118,29)"
29417,2020-06-21,Zimbabwe,2,7,486,"rgb(166,118,29)"
29418,2020-06-22,Zimbabwe,0,3,489,"rgb(166,118,29)"
29419,2020-06-23,Zimbabwe,0,23,512,"rgb(166,118,29)"
29420,2020-06-24,Zimbabwe,0,13,525,"rgb(166,118,29)"
29421,2020-06-25,Zimbabwe,0,5,530,"rgb(166,118,29)"
29422,2020-06-26,Zimbabwe,0,21,551,"rgb(166,118,29)"
29423,2020-06-27,Zimbabwe,0,10,561,"rgb(166,118,29)"
29424,2020-06-28,Zimbabwe,0,6,567,"rgb(166,118,29)"
29425,2020-06-29,Zimbabwe,0,0,567,"rgb(166,118,29)"
29426,2020-06-30,Zimbabwe,1,7,574,"rgb(166,118,29)"
29427,2020-07-01,Zimbabwe,0,17,591,"rgb(166,118,29)"
29428,2020-07-02,Zimbabwe,0,14,605,"rgb(166,118,29)"
29429,2020-07-03,Zimbabwe,0,12,617,"rgb(166,118,29)"
29430,2020-07-04,Zimbabwe,0,8,625,"rgb(166,118,29)"
29431,2020-07-05,Zimbabwe,1,73,698,"rgb(166,118,29)"
29432,2020-07-06,Zimbabwe,0,18,716,"rgb(166,118,29)"
29433,2020-07-07,Zimbabwe,1,18,734,"rgb(166,118,29)"
29434,2020-07-08,Zimbabwe,0,53,787,"rgb(166,118,29)"
29435,2020-07-09,Zimbabwe,0,98,885,"rgb(166,118,29)"
29436,2020-07-10,Zimbabwe,3,41,926,"rgb(166,118,29)"
29437,2020-07-11,Zimbabwe,1,16,942,"rgb(166,118,29)"
29438,2020-07-12,Zimbabwe,5,40,982,"rgb(166,118,29)"
29439,2020-07-13,Zimbabwe,0,3,985,"rgb(166,118,29)"
